time,open,high,low,close,Long Stop,Long Stop Start,Buy Label,Short Stop,Short Stop Start,Sell Label,Basis,Upper,Lower,ATR Trailing Stoploss,VWAP,Upper Band #1,Lower Band #1,Volume,Volume MA,RSI,RSI-based MA,Regular Bullish,Regular Bullish Label,Regular Bearish,Regular Bearish Label,ATR,ADX,OnBalanceVolume,Histogram,MACD,Signal
2021-09-24T13:30:00-04:00,255.53974483,258.23974213,254.77974559,258.10974226,244.1114637174107,NaN,NaN,NaN,NaN,NaN,245.05135530199982,259.2400201411628,230.86269046283687,248.431081623598,254.61068519232109,256.4828297610096,252.73854062363256,846012,781965.6,67.5147509732488,56.72097933091713,NaN,NaN,NaN,NaN,4.0564542076400185,14.683427579659062,743171496,0.5462861176143943,2.2883729680018803,1.742086850387486
2021-09-27T09:30:00-04:00,257.8364092,265.62306809,256.44641059,264.31973606,247.94865499934653,NaN,NaN,NaN,NaN,NaN,245.8208878667998,259.9323933322479,231.7093824013517,253.1878109348784,262.12973824666665,262.12973824666665,262.12973824666665,1387701,791466.3,73.76684917478272,57.696568714234225,NaN,NaN,NaN,NaN,4.4221830142371585,16.53347287876566,744559197,1.1239973382561015,3.1470835232076126,2.023086184951511
2021-09-27T13:30:00-04:00,264.36306935,266.32973406,263.26307045,263.68973669,251.88695852846712,NaN,NaN,NaN,NaN,NaN,246.56115379419987,260.45955236525015,232.66275522314956,254.84819653090273,262.72642636024415,263.7339076829904,261.7189450374979,486762,784659.8,72.24771087278918,58.385156706530886,NaN,NaN,NaN,NaN,4.3253601996487925,18.33901399468022,744072435,1.368524562864137,3.733741888531682,2.3652173256675453
2021-09-28T09:30:00-04:00,262.33640471,265.2130685,258.369742,259.98640706,251.88695852846712,NaN,NaN,NaN,NaN,NaN,247.02042000239985,261.1435504037315,232.8972896010682,254.84819653090273,261.18973918666666,261.18973918666666,261.18973918666666,1029210,774730.3,63.91517825072715,58.49441887331936,NaN,NaN,NaN,NaN,4.505214935388168,18.66386023865998,743043225,1.192148090792715,3.855402439158439,2.663254348365724
2021-09-28T13:30:00-04:00,259.89974048,261.67640537,255.49307821,259.23974114,251.88695852846712,NaN,NaN,NaN,NaN,NaN,247.49588619439982,261.6317948213006,233.35997756749902,254.84819653090273,260.2591416333328,261.42319151771255,259.095091748953,657786,786192.6,62.35370749305805,58.36248945805352,NaN,NaN,NaN,NaN,4.625080094289014,18.28170067043581,742385439,0.9471735060375197,3.8472212309126235,2.9000477248751038
2021-09-29T09:30:00-04:00,260.12140692,264.49640255,256.94307676,257.75974261,251.88695852846712,NaN,NaN,NaN,NaN,NaN,247.94348574739982,261.93299037225876,233.9539811225409,254.84819653090273,259.7330739733333,259.7330739733333,259.7330739733333,1122507,789956.7,59.26316762800092,59.454775019793445,NaN,NaN,NaN,NaN,4.834240501125515,18.39737723753707,741262932,0.6230865517673387,3.678905914584277,3.0558193628169383
2021-09-29T13:30:00-04:00,257.79974257,261.78640526,257.29307641,260.43973994,251.88695852846712,NaN,NaN,NaN,NaN,NaN,248.42895192939986,262.4346692518989,234.4232346069008,254.84819653090273,259.7702191551759,259.8210363213235,259.71940198902826,599754,799084.4,62.85359856296233,60.81580135929702,NaN,NaN,NaN,NaN,4.80988966890226,18.504791192702534,741862686,0.5304637476050251,3.7188990473232195,3.1884352997181944
2021-09-30T09:30:00-04:00,260.15640689,262.98640406,258.74307496,261.07640597,251.88695852846712,NaN,NaN,NaN,NaN,NaN,248.90415145499983,262.98159635158163,234.82670655841804,254.84819653090273,260.93529499666664,260.93529499666664,260.93529499666664,1108266,808873.9,63.67273090265228,61.840804647867024,NaN,NaN,NaN,NaN,4.769421056837812,18.81134809231243,742970952,0.4561639648165845,3.758640255738925,3.3024762909223404
2021-09-30T13:30:00-04:00,260.99973938,262.97640407,258.35640868,258.37307533,251.88695852846712,NaN,NaN,NaN,NaN,NaN,249.33108436199984,263.2354645402393,235.4267041837604,254.84819653090273,260.624641725034,261.09845878415814,260.15082466590985,476403,811043.1,57.84041673576589,62.4435631238457,NaN,NaN,NaN,NaN,4.758747794920824,18.98734815638179,742494549,0.18305313965126002,3.5312927154864155,3.3482395758351555
2021-10-01T09:30:00-04:00,259.43307428,260.07307364,254.55307915,256.9697434,251.88695852846712,NaN,NaN,NaN,NaN,NaN,249.76661726039987,263.22954227268866,236.30369224811105,254.84819653090273,257.1986320633334,257.1986320633334,257.1986320633334,1102446,821750.9,55.02283625843723,62.47842387452176,NaN,NaN,NaN,NaN,4.813122558855052,18.145887674691547,741392103,-0.11780600901152294,3.200982064570752,3.318788073582275
2021-10-01T13:30:00-04:00,256.90974346,259.08307462,255.64974472,258.34640869,251.88695852846712,NaN,NaN,NaN,NaN,NaN,250.25895010199986,263.12733627720644,237.39056392679328,254.84819653090273,257.3686246503897,257.60347423208526,257.1337750686941,577614,812161.2,57.22421873757784,62.52125309137703,NaN,NaN,NaN,NaN,4.7145659403654046,17.364531513122035,741969717,-0.24260430382479914,3.0155326938012763,3.2581369976260754
2021-10-04T09:30:00-04:00,265.4130683,268.83973155,258.73307497,260.49973988,251.88695852846712,NaN,NaN,NaN,NaN,NaN,250.72428297079986,263.3554071080783,238.09315883352147,254.84819653090273,262.6908488,262.6908488,262.6908488,1313382,818559.9,60.48230235433656,62.709316590569166,NaN,NaN,NaN,NaN,5.127334291767879,18.33959421994063,743283099,-0.2003909858901758,3.007648265263356,3.2080392511535316
2021-10-04T13:30:00-04:00,260.92973945,262.75640429,259.25307446,260.48973989,251.88695852846712,NaN,NaN,NaN,NaN,NaN,251.18934917319987,263.5082577235062,238.87044062289357,253.9119162255894,262.34208560432864,263.0675427705812,261.6166284380761,303549,812238.4,60.459272000670246,62.917305643089946,NaN,NaN,NaN,NaN,5.011333973070172,19.245009590557892,742979550,-0.1933129268978253,2.96639809253125,3.1597110194290754
2021-10-05T09:30:00-04:00,261.46973891,265.67306804,258.17640886,258.99307471,251.88695852846712,NaN,NaN,NaN,NaN,NaN,251.55468214159987,263.692872505864,239.41649177733572,253.9119162255894,260.9475172033333,260.9475172033333,260.9475172033333,802038,805267.8,56.96322976762191,62.39856926518793,NaN,NaN,NaN,NaN,5.188857202136588,20.488270386043908,742177512,-0.30306291111704153,2.7808823805327734,3.083945291649815
2021-10-05T13:30:00-04:00,258.83974153,262.16307155,258.35640868,260.20640684,251.88695852846712,NaN,NaN,NaN,NaN,NaN,251.88661514359984,264.04529053598907,239.72793975121064,253.9119162255894,260.7199099269534,261.0497346451687,260.39008520873807,381945,800825.9,59.03148306928763,61.792621557762125,NaN,NaN,NaN,NaN,5.0901290355554005,21.64272683899521,742559457,-0.3066487350057878,2.70063437289258,3.0072831078983677
2021-10-06T09:30:00-04:00,258.56307514,262.12307159,257.81974255,260.06640698,251.88695852846712,NaN,NaN,NaN,NaN,NaN,252.17614818779987,264.4104750297855,239.94182134581422,253.9119162255894,260.00307370666667,260.00307370666667,260.00307370666667,731775,795763.3,58.681058474150014,60.7150650791455,NaN,NaN,NaN,NaN,5.033929035872871,22.54748730899772,741827682,-0.3291725166032231,2.595817462144339,2.924989978747562
2021-10-06T13:30:00-04:00,260.06307365,261.45307226,259.47640757,260.83307288,251.88695852846712,NaN,NaN,NaN,NaN,NaN,252.48728121059986,264.794938495832,240.17962392536768,253.9119162255894,260.1968231980973,260.471953777727,259.92169261846766,362895,788655.2,60.07864712534915,59.84584624004265,NaN,NaN,NaN,NaN,4.815553011167666,23.387622031142904,742190577,-0.3037739679363094,2.5452725188271756,2.849046486763485
2021-10-07T09:30:00-04:00,261.81973856,263.23307048,261.13973924,262.52307119,251.88695852846712,NaN,NaN,NaN,NaN,NaN,252.83561419619986,265.27314948639923,240.39807890600045,253.9119162255894,262.29862697,262.29862697,262.29862697,671703,786607.2,63.04591932107715,59.78375631649622,NaN,NaN,NaN,NaN,4.643013338941405,24.457871368632393,742862280,-0.19005278530639824,2.611480505130487,2.8015332904368853
2021-10-07T13:30:00-04:00,262.47640457,268.30973208,262.09307162,264.34306937,251.88695852846712,NaN,NaN,NaN,NaN,NaN,253.22914713659986,265.8516539291013,240.6066403440984,256.90958245533324,263.6205310736202,264.92879270293076,262.31226944430966,685785,788063.4,65.97865537117512,60.04268116493315,NaN,NaN,NaN,NaN,4.755416704731306,26.154250616522607,743548065,-0.018204682369587832,2.7787774374749006,2.7969821198444884
2021-10-08T09:30:00-04:00,265.24973513,265.24973513,260.65973972,261.55973882,251.88695852846712,NaN,NaN,NaN,NaN,NaN,253.55534681099988,266.1791456710178,240.93154795098195,256.90958245533324,262.48973788999996,262.48973788999996,262.48973788999996,1011297,781373.6,58.3518335828774,59.97758587599576,NaN,NaN,NaN,NaN,4.743600897964782,27.23950998412909,742536768,-0.1126645065912859,2.6561514866053813,2.768815993196667
2021-10-08T13:30:00-04:00,261.53973884,264.51640253,261.43973894,261.76640528,251.88695852846712,NaN,NaN,NaN,NaN,NaN,253.9110797891999,266.4375508709544,241.38460870744544,256.90958245533324,262.5192477783719,262.5595107903303,262.4789847664135,543252,762895.9,58.73327690774167,59.68327718633714,NaN,NaN,NaN,NaN,4.62453394739587,28.24725082547797,743080020,-0.17801783104060798,2.5462937043959073,2.7243115354365153
2021-10-11T09:30:00-04:00,262.39640465,267.07639998,261.95307176,264.04306967,251.88695852846712,NaN,NaN,NaN,NaN,NaN,254.33281270139992,266.77521046505717,241.8904149377427,256.90958245533324,264.35751380333335,264.35751380333335,264.35751380333335,622743,745197.2,62.7776534176473,59.61934308026536,NaN,NaN,NaN,NaN,4.673495429724737,29.549506936049948,743702763,-0.08919366541412233,2.6128194536688625,2.702013119082985
2021-10-11T13:30:00-04:00,264.05973632,266.44306728,263.85306986,263.89640315,251.88695852846712,NaN,NaN,NaN,NaN,NaN,254.71901231579992,267.1260374490086,242.31198718259125,256.90958245533324,264.4895393869041,264.6680295748677,264.31104919894045,340719,734461.5,62.3536880348214,59.94171960162647,NaN,NaN,NaN,NaN,4.524674143315825,30.758744753009637,743362044,-0.0628383723874153,2.6234651535987155,2.6863035259861308
2021-10-12T09:30:00-04:00,266.99973339,270.44972994,265.68306803,269.99973039,254.1475005107122,NaN,NaN,NaN,NaN,NaN,255.10487859719993,268.1712727044719,242.03848448992795,258.9746113049812,268.71084278666666,268.71084278666666,268.71084278666666,1009428,741549,71.10028679516381,61.090108925678365,NaN,NaN,NaN,NaN,4.669577903793264,32.40547336026921,744371472,0.3219842755061699,3.088783870368843,2.766799594862673
2021-10-12T13:30:00-04:00,269.81639724,270.7563963,267.77973261,268.60973178,255.57593449908896,NaN,NaN,NaN,NaN,NaN,255.45807824459993,269.00211500905846,241.91404148014138,260.087969546985,268.82155472990803,268.9801071274482,268.66300233236785,492174,750211.1,67.26716778548527,61.807462429100326,NaN,NaN,NaN,NaN,4.548655459950888,33.97142566932306,743879298,0.4323738604056433,3.3072669203697274,2.874893059964084
2021-10-13T09:30:00-04:00,270.1563969,270.63306309,268.61639844,269.89973049,256.2790615375394,NaN,NaN,NaN,NaN,NaN,255.8476778555999,269.90071688092314,241.79463883027665,261.086656032588,269.71639734,269.71639734,269.71639734,609012,747452,68.94069316648591,62.411633201396704,NaN,NaN,NaN,NaN,4.368275163525825,35.425524242015925,744488310,0.5350130141336846,3.5436593276311896,3.008646313497505
2021-10-13T13:30:00-04:00,269.91639714,271.79306193,269.37973101,270.3563967,257.5182579910604,NaN,NaN,NaN,NaN,NaN,256.2292108079999,270.79206053629,241.6663610797098,262.94927082407037,270.05878338341705,270.4517182211961,269.665848545638,462399,741593.2,69.53450821261936,63.05986435939308,NaN,NaN,NaN,NaN,4.228636288988267,36.92813326214379,744950709,0.5730130974981216,3.724912685370157,3.1518995878720353
2021-10-14T09:30:00-04:00,271.82972856,273.41306032,271.21306251,272.8230609,259.422111464194,NaN,NaN,NaN,NaN,NaN,256.64007706419994,271.87759511327585,241.40255901512404,264.80969562525627,272.48306124333334,272.48306124333334,272.48306124333334,647805,737629.5,72.5835696979924,64.17560292584811,NaN,NaN,NaN,NaN,4.144923955489104,38.5275375774372,745598514,0.6954739999056092,4.021242087754047,3.3257680878484375
2021-10-14T13:30:00-04:00,272.8230609,273.24639382,272.21639484,272.62972776,260.28594224332153,NaN,NaN,NaN,NaN,NaN,257.0613433101999,272.8685013811453,241.25418523925455,265.84870257420505,272.5457933978834,272.6433496655657,272.4482371302011,267864,736078.2,71.97554126876594,65.10017851152513,NaN,NaN,NaN,NaN,3.9224293143827365,40.0126987273525,745330650,0.6931137626242903,4.1921602911288005,3.4990465285045103
2021-10-15T09:30:00-04:00,274.85305888,278.49638857,274.13639293,277.69638937,263.6366418295342,NaN,NaN,NaN,NaN,NaN,257.5967427755999,274.3231607857689,240.87032476543095,269.64490516836406,276.77639029,276.77639029,276.77639029,1281633,731195.3,77.33420792177193,66.43254632921243,NaN,NaN,NaN,NaN,4.0613029926411155,41.96676930676217,746612283,0.9467426108824251,4.682474792107541,3.7357321812251163
2021-10-15T13:30:00-04:00,277.66305607,281.06638601,277.18972321,281.0097194,266.4960220768281,NaN,NaN,NaN,NaN,NaN,258.30867539799993,275.90764554455154,240.70970525144833,272.0468678886912,277.8757850917804,279.3132490953883,276.43832108817253,749682,727984.3,80.02420092125934,67.85722874320601,NaN,NaN,NaN,NaN,4.048114407452462,44.0014363563113,747361965,1.2334734720466152,5.277574021283385,4.04410054923677
2021-10-18T09:30:00-04:00,283.90638317,290.64970977,283.88638319,290.36637672,273.8956531024268,NaN,NaN,NaN,NaN,NaN,259.2497411249999,278.49571792293386,240.00376432706594,278.614100087953,288.30082322666664,288.30082322666664,288.30082322666664,1119870,719056.6,85.32193151912436,69.44837247163795,NaN,NaN,NaN,NaN,4.447534119063002,46.47121789503025,748481835,1.9087808218498052,6.430076576549027,4.521295754699222
2021-10-18T13:30:00-04:00,290.64304311,291.7197087,289.29971112,290.086377,277.41515292504374,NaN,NaN,NaN,NaN,NaN,260.0973402786,280.90469264042827,239.28998791677168,280.8812221643624,289.03380379714395,290.0229341754579,288.04467341883,614958,723329.8,84.59887564952561,70.77838820580584,NaN,NaN,NaN,NaN,4.302710080558504,48.81356567228504,747866877,2.172900222680621,7.237421033049998,5.064520810369377
2021-10-19T09:30:00-04:00,292.43304132,292.54637454,287.54971287,291.45970896,277.41515292504374,NaN,NaN,NaN,NaN,NaN,260.98207272839994,283.23612959300004,238.72801586379987,281.3772544764899,290.51859879,290.51859879,290.51859879,766500,714572.8,85.25873088310362,72.70030944153629,NaN,NaN,NaN,NaN,4.352278051232895,50.30520853315383,748633377,2.2660086938951025,7.897031677738255,5.6310229838431525
2021-10-19T13:30:00-04:00,291.49637559,291.62637546,287.60971281,287.89304586,277.41515292504374,NaN,NaN,NaN,NaN,NaN,261.7755386028,284.96240096933013,238.58867623626986,281.3772544764899,290.1014413754969,290.7659095963388,289.436973154655,302109,702716.9,76.13538703852099,73.94331730802053,NaN,NaN,NaN,NaN,4.328305522573403,51.69030547538915,748331268,1.92662629136297,8.039305848046865,6.112679556683895
2021-10-20T09:30:00-04:00,288.44971197,289.74637734,285.83971457,287.74971267,277.41515292504374,NaN,NaN,NaN,NaN,NaN,262.52467118819993,286.58315541230735,238.46618696409254,281.3772544764899,287.7786015266667,287.7786015266667,287.7786015266667,432654,679721.8,75.78442149561972,74.87237217073285,NaN,NaN,NaN,NaN,4.298188183103872,52.262326225488785,747898614,1.5480357205494597,8.04772420737072,6.4996884868212605
2021-10-20T13:30:00-04:00,287.90637918,289.086378,287.66971275,288.57304518,277.41515292504374,NaN,NaN,NaN,NaN,NaN,263.2590704549999,288.19547138820116,238.32266952179867,281.3772544764899,288.0766685075715,288.407130044473,287.7462069706701,351987,671462.9,76.45581143470807,75.87966669929618,NaN,NaN,NaN,NaN,4.092365116453599,52.7934883505813,748250601,1.2228786328830514,8.028286777925075,6.805408145042024
2021-10-21T09:30:00-04:00,285.46638161,299.99970043,285.46638161,297.41303635,278.66232451725887,NaN,NaN,NaN,NaN,NaN,264.19280285599996,290.6331270599425,237.7524786520574,285.31310561718624,294.2930394633334,294.2930394633334,294.2930394633334,1888464,697469.5,82.17137521742958,76.670458729458,NaN,NaN,NaN,NaN,4.838147523849772,54.14000379751817,750139065,1.4570751286443162,8.626752055847419,7.169676927203103
2021-10-21T13:30:00-04:00,297.17636992,298.55636854,296.42637067,297.89970253,283.7697768701107,NaN,NaN,NaN,NaN,NaN,265.104668612,292.9498523323093,237.25948489169073,285.74209375474896,295.09138342052813,296.5142951683584,293.6684716726979,594474,701405.2,82.42433480134501,77.75311351630513,NaN,NaN,NaN,NaN,4.644708262860503,55.39033956967384,750733539,1.4931759917935405,9.036146916945029,7.542970925151488
2021-10-22T09:30:00-04:00,298.43303533,303.33303044,297.03637006,301.56636554,286.2281807694239,NaN,NaN,NaN,NaN,NaN,266.09153429319997,295.4945995312555,236.68846905514445,289.9332804217992,300.64525534666666,300.64525534666666,300.64525534666666,1759182,723296.4,84.2387941713166,78.84583501665018,NaN,NaN,NaN,NaN,4.7627048426561815,56.816261333256726,752492721,1.6027586017860056,9.546419177383996,7.94366057559799
2021-10-22T13:30:00-04:00,301.65969878,303.33303044,301.20969923,303.23803053,288.65968743854097,NaN,NaN,NaN,NaN,NaN,267.08969996299993,298.0398990589343,236.13950086706558,291.55156482043935,301.30125782262866,302.22200261092667,300.38051303433065,892983,733808.7,84.99914566541024,79.95045197756382,NaN,NaN,NaN,NaN,4.574178154609312,58.14033154229797,753385704,1.6216845216137905,9.97076622761523,8.349081706001439
2021-10-25T09:30:00-04:00,316.84301695,332.813001,314.77635235,331.16633598,306.7687613688346,NaN,NaN,NaN,NaN,NaN,268.8423648795999,303.9094377575609,233.77529200163897,308.60034326935147,326.25189644333335,326.25189644333335,326.25189644333335,3264039,798830.6,91.9694374128828,81.33515681434172,NaN,NaN,NaN,NaN,6.359949034280073,60.22103330912226,756649743,3.2547377631671033,12.417503909960317,9.162766146793214
2021-10-25T13:30:00-04:00,331.62966885,348.07631909,330.8463363,341.61299221,320.8597745222967,NaN,NaN,NaN,NaN,NaN,270.80622958519996,310.63351870294747,230.97894046745245,320.0912015104812,331.41875350200934,338.1463542804958,324.69115272352286,1925253,852887.4,93.23558076582414,82.85373106413158,NaN,NaN,NaN,NaN,7.136380016831497,62.34619502258624,758574996,4.690831171092261,15.02630511065854,10.33547393956628
2021-10-26T09:30:00-04:00,341.56299226,364.95963557,333.96299985,337.06633009,327.47847571969226,NaN,NaN,NaN,NaN,NaN,272.62049444019993,315.9384157992833,229.30257308111658,327.073223646385,345.32965517,345.3296589846973,345.32965135530276,2957871,924748.5,86.81971422660415,83.53126722876245,NaN,NaN,NaN,NaN,8.840683995629245,64.46414824863774,755617125,4.960661678501985,16.53630103769376,11.575639359191776
2021-10-26T13:30:00-04:00,337.00299682,347.55631961,336.39633076,339.33299449,327.47847571969226,NaN,NaN,NaN,NaN,NaN,274.4792259173999,320.9942904590067,227.96416137579308,327.073223646385,344.5784020943369,346.19604082186225,342.9607633668116,637953,933282.1,87.28930772071357,84.05020342872346,NaN,NaN,NaN,NaN,9.006348628084298,66.43081910139986,756255078,4.908860462992829,17.71171493793281,12.802854474939982
2021-10-27T09:30:00-04:00,346.05965444,356.92631026,344.38965611,348.46965203,327.47847571969226,NaN,NaN,NaN,NaN,NaN,276.4624906035999,326.8131698914719,226.11181131572795,327.073223646385,349.9285394666667,349.9285394666667,349.9285394666667,1925847,973084.5,88.99184485503146,84.31234009557397,NaN,NaN,NaN,NaN,9.61970342393542,68.32274804675941,758180925,5.085420846597158,19.15963053318643,14.074209686589272
2021-10-27T13:30:00-04:00,348.166319,350.53964997,343.67965682,346.05965444,327.47847571969226,NaN,NaN,NaN,NaN,NaN,278.3718886969999,331.7999433134664,224.94383408053343,327.073223646385,349.1396686734901,350.5098964887507,347.76944085822953,638334,982265.8,85.72992145046851,84.39312908135561,NaN,NaN,NaN,NaN,9.422581261511464,69.95142725647693,757542591,4.647387011276566,19.88344345068498,15.236056439408413
2021-10-28T09:30:00-04:00,356.07297778,360.08297377,351.51631566,357.66630952,331.23459649448256,NaN,NaN,NaN,NaN,NaN,280.4983532403999,337.7786597896119,223.21804669118796,327.073223646385,356.42186631666664,356.42186631666664,356.42186631666664,1842126,1021279.9,88.00941811777147,84.58960674097473,NaN,NaN,NaN,NaN,9.751205409260649,71.53897163468696,759384717,4.731017576541163,21.149828410084865,16.418810833543702
2021-10-28T13:30:00-04:00,357.88297597,359.24964127,355.509645,359.04297481,333.4211885240515,NaN,NaN,NaN,NaN,NaN,282.6549510869999,343.3785898185842,221.93131235541563,330.37104358226975,356.72413626920246,357.32889387192523,356.1193786664797,460200,1013760.4,88.24918357074291,85.45487792184773,NaN,NaN,NaN,NaN,9.321833327884889,73.01311998588197,759844917,4.47359623402982,22.01080612608098,17.53720989205116
2021-10-29T09:30:00-04:00,361.26630592,368.61963191,357.93297592,367.30963322,338.9495986968219,NaN,NaN,NaN,NaN,NaN,284.8905488545999,349.5575403010712,220.2235574081286,340.1734257648158,364.62074701666666,364.62074701666666,364.62074701666666,1704177,1036856.4,89.59469523228852,86.4413260458955,NaN,NaN,NaN,NaN,9.419320660893112,74.44846380751062,761549094,4.445411649046328,23.093974453359067,18.64856280431274
2021-10-29T13:30:00-04:00,367.22296664,371.73629547,364.33296953,371.42296245,343.80414216355734,NaN,NaN,NaN,NaN,NaN,287.1568132583999,355.73470857029605,218.57891794650374,345.2776675838527,366.40238643645563,368.6205691757757,364.18420369713556,1099410,1055395,90.19622995721993,87.4227845117892,NaN,NaN,NaN,NaN,9.275321037972175,75.80140892148523,762648504,4.287197947449073,24.00756023862408,19.720362291175007
2021-11-01T09:30:00-04:00,381.74295214,397.6462696,372.96962757,391.02627621,358.60293865248644,NaN,NaN,NaN,NaN,NaN,289.6909440613999,363.84367232417935,215.5382157986204,363.3677137160821,387.21405779333327,387.21405779333327,387.21405779333327,2749233,1126278,92.43948232036077,88.15622073342715,NaN,NaN,NaN,NaN,10.485891474545591,77.18422767309644,765397737,5.034541572257581,26.013539256496983,20.978997684239403
2021-11-01T13:30:00-04:00,390.76627647,403.24959733,387.51627971,403.10626414,367.7463402726007,NaN,NaN,NaN,NaN,NaN,292.4792746103999,372.7443711549903,212.21417806580948,367.9600938128657,390.6800374060628,395.70230008624236,385.65777472588326,1309377,1158566.6,93.43617985329283,88.94278109428056,NaN,NaN,NaN,NaN,10.860707627792333,78.48857636191305,766707114,5.81869818072132,28.252370410141054,22.433672229419734
2021-11-02T09:30:00-04:00,386.45128077,402.74959783,381.99961855,388.77961178,367.7463402726007,NaN,NaN,NaN,NaN,NaN,295.0551387047999,379.15854469865724,210.95173271094254,367.9600938128657,391.17627605333337,391.17627605333337,391.17627605333337,2037504,1192835.8,79.97112939640586,88.63794789607265,NaN,NaN,NaN,NaN,11.592560339378597,78.88131393605717,764669610,4.886349586244403,28.54160921222524,23.655259625980836
2021-11-02T13:30:00-04:00,388.38294551,396.33293757,386.38628084,390.65960991,367.7463402726007,NaN,NaN,NaN,NaN,NaN,297.68353608019993,385.2868852493481,210.08018691105175,367.9600938128657,391.1656031188599,391.1860905456638,391.14511569205604,552957,1194861.9,80.37088179602333,88.30735761968786,NaN,NaN,NaN,NaN,11.474995795851557,79.24599882633385,765222567,3.9501376322188975,28.592931666254458,24.64279403403556
2021-11-03T09:30:00-04:00,392.44294146,396.78627045,384.41628281,392.44627479,367.7463402726007,NaN,NaN,NaN,NaN,NaN,300.3772667237999,391.1308200181427,209.6237134294571,367.9600938128657,391.21627601666665,391.21627601666665,391.21627601666665,1114284,1211704.3,80.76381961152526,87.50695634816233,NaN,NaN,NaN,NaN,11.538923784719305,79.27311128172069,766336851,3.045622504254915,28.449822164354202,25.404199660099287
2021-11-03T13:30:00-04:00,392.58294132,405.11292881,388.43294546,404.33292959,367.7463402726007,NaN,NaN,NaN,NaN,NaN,303.2551305167999,397.8068144743707,208.70344655922912,368.7841300137418,395.3887858619928,399.4248853566027,391.3526863673829,1190877,1235986.9,83.17669837378814,86.78846474873119,NaN,NaN,NaN,NaN,11.9061423250965,79.44002254995446,767527728,2.846006681968067,28.96170801255937,26.115701330591303
2021-11-04T09:30:00-04:00,411.4995891,414.35625291,405.66626159,411.85958874,379.46597552878944,NaN,NaN,NaN,NaN,NaN,306.2707941721999,404.7843197075663,207.7572686368335,380.2815522129934,410.62736774666655,410.6273731414632,410.6273623518699,1404402,1261206.8,84.50229483550747,86.62293479222429,NaN,NaN,NaN,NaN,11.771655253303894,79.7320015045311,768932130,2.813940918010182,29.63312747810403,26.819186560093847
2021-11-04T13:30:00-04:00,411.95625531,413.3329206,408.70292522,409.83292409,381.22970007884453,NaN,NaN,NaN,NaN,NaN,309.2999911473999,410.9989805168862,207.6010017779136,383.7581623523947,410.62626510931244,410.6281846943901,410.6243455242348,463386,1267724.2,82.61464483945781,86.28903030070602,NaN,NaN,NaN,NaN,11.261536690925046,80.00312481949511,768468744,2.272488877798189,29.659797657341585,27.387308779543396
2021-11-05T09:30:00-04:00,409.38292454,413.24958735,402.8462644,407.74292618,381.22970007884453,NaN,NaN,NaN,NaN,NaN,312.3154548029999,416.5388537344501,208.09205587154975,384.38811927691575,407.94625931,407.94625931,407.94625931,1271064,1267371.9,80.61470972586915,85.69066350576584,NaN,NaN,NaN,NaN,11.200235709430402,79.32178144621666,767197680,1.430925956212235,29.17596622480869,27.745040268596455
2021-11-05T13:30:00-04:00,407.73625952,410.66625659,405.69959489,407.16292676,381.22970007884453,NaN,NaN,NaN,NaN,NaN,315.2917851643999,421.65791471232666,208.9256556164732,385.0937512815326,407.9053006884616,407.955845500646,407.8547558762772,834651,1270204.2,80.03566936340891,85.28393121383301,NaN,NaN,NaN,NaN,10.754980423042513,78.6891054567438,766363029,0.5384786735605971,28.418138610547203,27.879659936986606
2021-11-08T09:30:00-05:00,383.22628399,398.95960162,377.77628944,395.48960508,NaN,NaN,NaN,420.2223330588337,420.2223330588337,420.2223330588337,317.9915824683999,425.5041848017875,210.47898013501225,385.0937512815326,390.7418320466668,390.7418320466668,390.7418320466668,1400268,1279550.8,69.2538931532221,83.94425085922232,NaN,NaN,NaN,NaN,12.085813058539474,74.66277806703016,764962761,-1.0482555919870542,26.569340447002787,27.61759603898984
2021-11-08T13:30:00-05:00,395.75293815,396.33293757,386.66628056,387.52961303,NaN,NaN,NaN,420.2223330588337,NaN,NaN,320.53237993119984,428.49285009073253,212.57190977166715,385.0937512815326,390.60336562633785,390.84654750440853,390.36018374826716,453981,1274184.9,63.01962589223272,82.14213959647158,NaN,NaN,NaN,NaN,11.91301619792951,70.9240454908675,764508780,-2.7476110471799373,24.183082230014918,26.930693277194855
2021-11-09T09:30:00-05:00,391.19294271,391.19294271,341.29632586,347.85965264,NaN,NaN,NaN,403.3313305741439,NaN,NaN,322.3097114897999,429.0786348098273,215.5407881697725,385.0937512815326,360.11630707,360.11630707,360.11630707,2984307,1348111.8,42.490613982523456,78.77756236434551,NaN,NaN,NaN,NaN,14.626130530220257,67.29853665370663,761524473,-6.4458659990241856,18.87336077841462,25.319226777438807
2021-11-09T13:30:00-05:00,347.55298628,353.54631363,337.22966326,341.16632599,NaN,NaN,NaN,383.0139235896374,NaN,NaN,323.92890987279986,429.32822623805225,218.5295935075475,385.0937512815326,355.4048268001821,362.7413266057639,348.0683269946003,1230780,1379067.5,40.11609413326189,75.20040980549138,NaN,NaN,NaN,NaN,14.74688194734738,64.11698266266276,760293693,-9.08394063626492,13.964300982107659,23.04824161837258
2021-11-10T09:30:00-05:00,336.80633035,359.33297452,329.29300452,350.00298384,NaN,NaN,NaN,383.0139235896374,NaN,NaN,325.7276414099999,429.76700508688907,221.6882777331107,385.0937512815326,346.20965429333336,346.2096581080306,346.2096504786361,1215315,1405156.2,44.52387145842288,71.7778661724958,NaN,NaN,NaN,NaN,15.839245379679708,61.51486202947892,761509008,-9.90743109160531,10.663952753865942,20.571383845471253
2021-11-10T13:30:00-05:00,349.58631759,358.39964212,337.50299632,355.90297795,NaN,NaN,NaN,383.0139235896374,NaN,NaN,327.62903951139987,430.32114051328153,224.9369385095182,385.0937512815326,348.20257789509503,350.38926719819705,346.015888591993,1009476,1427072.5,47.312345553352266,68.48330657964291,NaN,NaN,NaN,NaN,16.200488266845444,59.09860715580821,762518484,-9.715236585425423,8.427338113689473,18.142574699114896
2021-11-11T09:30:00-05:00,367.58963294,367.72629947,351.70631547,353.49631368,NaN,NaN,NaN,383.0139235896374,NaN,NaN,329.44850436119987,430.67524045285575,228.221768269544,385.0937512815326,357.6429762066667,357.6429762066667,357.6429762066667,1039326,1398767.9,46.29023362478438,66.07752831024139,NaN,NaN,NaN,NaN,16.187595104927915,56.12501073516467,761479158,-9.404474118627054,6.3869820508310795,15.791456169458133
2021-11-11T13:30:00-05:00,353.3763138,357.02964349,352.12631505,354.33631284,NaN,NaN,NaN,383.0139235896374,NaN,NaN,331.24836923059985,430.96972538471573,231.527013076484,385.0937512815326,356.79827840565656,358.1923827172022,355.40417409411094,381561,1391670.8,46.72285991379584,63.67409817579657,NaN,NaN,NaN,NaN,15.381576057433064,53.36381405885281,761860719,-8.80705705902557,4.782634845676171,13.589691904701741
2021-11-12T09:30:00-05:00,349.16631801,351.45964905,339.91632724,341.8563253,NaN,NaN,NaN,383.0139235896374,NaN,NaN,332.8543009601999,430.6014988137067,235.10710310669313,385.0937512815326,344.41076719666665,344.41076719666665,344.41076719666665,1293888,1376161,41.38875025929301,60.8615932220657,NaN,NaN,NaN,NaN,15.312891024759276,51.43856454436747,760566831,-8.89126541228102,2.475610139350465,11.366875551631486
2021-11-12T13:30:00-05:00,341.87632528,345.58298825,340.63299319,344.45965604,NaN,NaN,NaN,382.2432475759725,NaN,NaN,334.5081659753999,430.1641602392294,238.8521717115704,363.8082787132261,344.077311024366,344.49322622863946,343.66139582009254,831696,1374118.1,42.85435064748376,57.98142552732967,NaN,NaN,NaN,NaN,14.572684170133616,49.650832852345374,761398527,-8.415441900370608,0.8475731761682255,9.263015076538833
2021-11-15T09:30:00-05:00,339.20966128,341.14299268,326.22634091,329.79967068,NaN,NaN,NaN,373.5274094934283,NaN,NaN,335.8232979955999,429.3524280040037,242.2941679871961,363.3785507395809,332.38966809,332.38966809,332.38966809,1193391,1305096.5,37.211476485587006,54.60350993090679,NaN,NaN,NaN,NaN,14.834157810124077,48.66950167556141,760205136,-8.696068728637895,-1.6070708342585363,7.088997894379359
2021-11-15T13:30:00-05:00,329.65633749,343.90298993,327.84967262,337.83966265,NaN,NaN,NaN,373.5274094934283,NaN,NaN,337.30216318559985,428.5457766227683,246.0585497484314,339.8811248206647,333.7207038783805,335.65469077584,331.786716980921,565269,1259763.7,41.74218769062915,51.68404870599045,NaN,NaN,NaN,NaN,14.921240631543787,47.50636150432817,760770405,-7.967633431617559,-2.870543895142589,5.09708953647497
2021-11-16T09:30:00-05:00,334.43633271,352.32964818,334.05966642,349.35965115,NaN,NaN,NaN,373.5274094934283,NaN,NaN,338.8893616007998,428.133865309987,249.64485789161262,316.5504756478083,345.24965525,345.24965525,345.24965525,1042554,1195919.8,47.5789612644992,49.32435238732118,NaN,NaN,NaN,NaN,15.160436426433517,45.68295494720273,761812959,-6.404678228285628,-2.908758248882066,3.4959199794035625
2021-11-16T13:30:00-05:00,349.35965115,352.32964818,346.0329878,351.50298234,NaN,NaN,NaN,373.5274094934283,NaN,NaN,340.54722661199986,427.55974031864923,253.5347129053505,317.31716845120457,346.53127296078435,348.6260696956333,344.4364762259354,390240,1187662.7,48.610568568708146,47.07970233055683,NaN,NaN,NaN,NaN,14.52730956597398,43.98979171558625,762203199,-4.984393616161989,-2.7345720407989234,2.2498215753630655
2021-11-17T09:30:00-05:00,354.66297918,373.02629418,352.07298177,361.95630523,NaN,NaN,NaN,373.5274094934283,NaN,NaN,342.38835810679984,427.21170911312595,257.56500710047374,334.25465447696365,362.3518603933333,362.3518603933333,362.3518603933333,1211922,1163865.2,53.42466251760865,45.94904299944158,NaN,NaN,NaN,NaN,15.027024014118693,40.8717877972925,763415121,-3.186301134967068,-1.7330548433457693,1.4532462916212985
2021-11-17T13:30:00-05:00,362.08297177,367.56963296,361.03630615,363.30630389,NaN,NaN,NaN,373.5274094934283,NaN,NaN,344.2473562505999,426.7161014749671,261.77861102623274,334.25465447696365,362.8122393570426,363.5425494658594,362.0819292482258,481605,1158640.9,54.023678792953305,45.306475349493056,NaN,NaN,NaN,NaN,14.420331356681643,37.97649844459116,763896726,-1.8193556403885172,-0.8209482588643482,0.9984073815241691
2021-11-18T09:30:00-05:00,368.96629823,370.62296325,359.56964095,361.33630585,NaN,NaN,NaN,373.5274094934283,NaN,NaN,346.01762114959985,426.0414099014315,265.9938323977682,337.66912196605676,363.84297001666664,363.84297001666664,363.84297001666664,642297,1118646.6,52.95340801480635,46.0538177803704,NaN,NaN,NaN,NaN,14.17983070977581,35.504088251845694,763254429,-1.0020300196660814,-0.2541301430584326,0.7478998766076488
2021-11-18T13:30:00-05:00,361.11297274,367.33296653,358.38297547,365.49963503,NaN,NaN,NaN,373.5274094934283,NaN,NaN,347.8750192949999,425.26693316337025,270.48310542662955,337.66912196605676,363.80278893442653,363.85360396386704,363.751973904986,401601,1116693.3,54.98316529615718,47.11575143486292,NaN,NaN,NaN,NaN,13.806270734791823,33.11566191294317,763656030,-0.17834260386082534,0.5249716217816172,0.7033142256424425
2021-11-19T09:30:00-05:00,366.66630053,372.73296114,364.39963613,371.55962898,NaN,NaN,NaN,373.5274094934283,NaN,NaN,349.7522840871999,424.7608535365082,274.74371463789157,343.8958437892763,369.56407541666664,369.56407541666664,369.56407541666664,532020,1077621.4,57.834752864547276,48.06652867815752,NaN,NaN,NaN,NaN,13.415346040163838,31.302971398098826,764188050,0.7276003999743251,1.6128147256103489,0.8852143256360238
2021-11-19T13:30:00-05:00,371.4396291,379.5162877,371.25962928,378.66628855,337.51846733390886,337.51846733390886,337.51846733390886,NaN,NaN,NaN,351.70541547019985,424.5055868874347,278.90524405296503,352.3182646094211,373.6693271769271,377.06661103903133,370.27204331482284,776862,1066869.8,60.95810300950664,49.0412256393114,NaN,NaN,NaN,NaN,13.046868353009279,30.098569327721986,764964912,1.7027459897468735,3.0136468128196157,1.3109008230727421
2021-11-22T09:30:00-05:00,387.44294645,400.64959993,378.50628871,394.49960607,350.410251231913,NaN,NaN,NaN,NaN,NaN,353.7880800571999,425.39830416796724,282.1778559464326,367.81952584753685,391.2184982366667,391.2184982366667,391.2184982366667,1079385,1011208.2,66.8498330149456,50.50976845289437,NaN,NaN,NaN,NaN,13.696614272080046,30.17796920254396,766044297,3.223181697304665,5.339877944703574,2.1166962473989086
2021-11-22T13:30:00-05:00,394.55293935,396.90960366,384.54961601,385.42961513,351.6568135713715,NaN,NaN,NaN,NaN,NaN,355.69494481979984,425.4727496423444,285.9171399972553,367.81952584753685,390.6153756184304,391.61368334716576,389.617067889695,393966,980694.5,61.15640913903547,51.54073625469721,NaN,NaN,NaN,NaN,13.60114094193147,30.251697657735793,765650331,3.409073684155474,6.378038352593251,2.968964668437777
2021-11-23T09:30:00-05:00,388.99961156,393.4362738,358.50630868,360.00964051,351.6568135713715,NaN,NaN,NaN,NaN,NaN,357.0659434507999,424.3921610981845,289.73972580341535,367.81952584753685,370.6507409966667,370.6507409966667,370.6507409966667,1080669,948800,48.65054184569618,52.059435653726,NaN,NaN,NaN,NaN,15.124628383222078,28.269342256004766,764569662,1.6975670257273014,5.090923450596904,3.3933564248696024
2021-11-23T13:30:00-05:00,359.40297445,371.44962909,354.40631277,369.66629754,351.6568135713715,NaN,NaN,NaN,NaN,NaN,358.70140848439985,423.1376632806241,294.2651536881756,367.81952584753685,368.4214121120998,371.1120201699869,365.7308040542127,741891,955097.8,52.61470739520644,52.75660399284906,NaN,NaN,NaN,NaN,15.261677521563357,26.33351996230206,765311553,1.1211672501855268,4.794815487601511,3.6736482374159842
2021-11-24T09:30:00-05:00,360.32964019,375.7396248,354.30631287,374.72629248,351.6568135713715,NaN,NaN,NaN,NaN,NaN,360.4409400805999,421.7413426316258,299.140537529574,367.81952584753685,368.25741005000003,368.25741005000003,368.25741005000003,583647,937409.9,54.592808639958754,53.99812771816132,NaN,NaN,NaN,NaN,15.702508550737402,24.649132475729857,765895200,0.9905427039566388,4.911826617361783,3.921283913405144
2021-11-24T13:30:00-05:00,374.84962569,377.33295655,370.64962989,371.94962859,351.6568135713715,NaN,NaN,NaN,NaN,NaN,362.10847174879984,419.93591465406024,304.28102884353945,367.81952584753685,370.21384882189176,372.67532698186574,367.7523706619178,368715,910004.5,53.27844834587559,54.82214633639321,NaN,NaN,NaN,NaN,15.058281272827585,23.191067355206847,765526485,0.6437940840647602,4.726026518486094,4.082232434421334
2021-11-26T09:30:00-05:00,366.31963421,369.0962981,360.40964011,360.99963952,351.6568135713715,NaN,NaN,NaN,NaN,NaN,363.3802038121999,418.1780354754541,308.5823721489457,367.81952584753685,363.5018592433334,363.5018592433334,363.5018592433334,647502,884774.5,48.33617945805139,54.876233350218364,NaN,NaN,NaN,NaN,14.80697464476847,21.94327241569158,764878983,-0.34330963810372594,3.6530953867916764,3.9964050248954024
2021-11-29T09:30:00-05:00,366.84963368,380.73295315,366.83296703,377.33628988,351.6568135713715,NaN,NaN,NaN,NaN,NaN,364.9689355591999,416.595209722186,313.3426613962138,367.81952584753685,374.96740335333334,374.96740335333334,374.96740335333334,559692,887984.7,55.03748485995429,55.33529879959309,NaN,NaN,NaN,NaN,15.158856000856435,20.757664897584355,765438675,0.0621221295554335,4.074057686839694,4.011935557284261
2021-11-29T13:30:00-05:00,377.08962346,379.17295471,374.05629315,378.7829551,351.6568135713715,NaN,NaN,NaN,NaN,NaN,366.5132673503998,414.98395582594634,318.0425788748533,367.81952584753685,375.72475149193616,376.82989270149693,374.6196102823754,262848,854377.5,55.58686634365781,55.489741930025176,NaN,NaN,NaN,NaN,14.441556397938118,19.6567436307705,765701523,0.3687291063243494,4.472846940189697,4.104117833865348
2021-11-30T09:30:00-05:00,381.63628558,389.16961139,372.66629454,375.33295854,351.6568135713715,NaN,NaN,NaN,NaN,NaN,367.9551659105999,412.97753661785873,322.932795203341,367.81952584753685,379.0562881566666,379.0562957860611,379.05628052727207,711216,850263,53.89559988509491,55.480593436606725,NaN,NaN,NaN,NaN,14.588825001656824,19.272990689364725,764990307,0.28398785082696154,4.45910264739905,4.175114796572088
2021-11-30T13:30:00-05:00,375.72629148,382.23295165,375.72629148,381.67295221,351.6568135713715,NaN,NaN,NaN,NaN,NaN,368.9652982351999,412.89379885965275,325.03679761074704,364.46555056902946,379.279853372931,379.645353432631,378.91435331323095,266094,812457.2,56.51404628961336,55.734924741950074,NaN,NaN,NaN,NaN,14.039622723681338,18.916648672345076,765256401,0.5825264211812176,4.90327282304861,4.3207464018673924
2021-12-01T09:30:00-05:00,387.91961264,390.51627672,378.60962194,380.96628625,351.6568135713715,NaN,NaN,NaN,NaN,NaN,369.75236411599985,413.09870515863685,326.40602307336286,358.8990274002093,383.3640616366667,383.3640616366667,383.3640616366667,502410,814071.5,56.13138274923621,55.81694027431286,NaN,NaN,NaN,NaN,13.887267870561242,19.095195141962424,764753991,0.6546184249937967,5.139019433109638,4.484401008115841
2021-12-01T13:30:00-05:00,380.85295303,381.26628595,363.70297016,364.53630266,351.6568135713715,NaN,NaN,NaN,NaN,NaN,370.3017635673998,412.6621738687298,327.9413532660698,358.8990274002093,377.25093158480433,383.9839409879179,370.5179221816908,414159,728399.9,47.99447217276617,55.11406308204278,NaN,NaN,NaN,NaN,14.149842721949724,18.05668090564973,764339832,-0.42391848048507885,3.954502907509493,4.378421387994572
2021-12-02T09:30:00-05:00,366.33296753,370.71962982,352.66298118,358.20297565,351.6568135713715,NaN,NaN,NaN,NaN,NaN,370.67916319059987,412.258243505904,329.10008287529575,358.8990274002093,360.52852888333337,360.52852888333337,360.52852888333337,895164,717212.7,45.27022847410097,53.993500615228086,NaN,NaN,NaN,NaN,14.428900287524746,17.18616066299677,763444668,-1.5217973768668633,2.4761746669109925,3.997972043777856
2021-12-02T13:30:00-05:00,358.51630867,363.5963036,356.48964403,361.519639,351.6568135713715,NaN,NaN,NaN,NaN,NaN,370.9401629299999,412.1202333063734,329.76009255362635,358.8990274002093,360.5303190308762,360.53327362903667,360.5273644327158,328611,687655.9,46.967877493511985,52.573360935125685,NaN,NaN,NaN,NaN,13.905883093415834,16.377820437676164,763773279,-1.9549385078347363,1.5542989089844355,3.509237416819172
2021-12-03T09:30:00-05:00,361.59630559,363.33297053,335.58299824,342.22632494,NaN,NaN,NaN,392.31106745006787,392.31106745006787,392.31106745006787,370.8634963399998,412.2423589185037,329.4846337614959,358.8990274002093,347.0474312366667,347.0474312366667,347.0474312366667,1056405,689220.2,39.32608691119396,51.01405220456558,NaN,NaN,NaN,NaN,14.894746607457561,16.83511740642898,762716874,-3.387189148708225,-0.7247490190661097,2.6624401296421154
2021-12-03T13:30:00-05:00,342.0996584,342.23965826,333.51966696,338.37966211,NaN,NaN,NaN,379.9739679857466,NaN,NaN,370.4777633917999,412.69266370397355,328.26286307962624,358.8990274002093,343.3322165204643,347.76371815033275,338.9007148905959,742500,679326,37.99861914983902,50.25320058343293,NaN,NaN,NaN,NaN,14.453692656924877,17.363094147592747,761974374,-4.377092044613626,-2.8089249261249165,1.568167118488709
2021-12-06T09:30:00-05:00,333.33300048,337.56966292,316.93635019,337.39966309,NaN,NaN,NaN,370.3580224027581,NaN,NaN,370.0448971573999,413.15430241927527,326.9354918955245,358.8990274002093,330.6352253999999,330.63523079479654,330.6352200052033,974907,699104.2,37.649933825407224,49.18428818559012,NaN,NaN,NaN,NaN,14.952951175715961,18.60860335129699,760999467,-4.844927532663364,-4.487992297340497,0.3569352353228674
2021-12-06T13:30:00-05:00,336.95299687,340.17632698,334.20966627,336.13299769,NaN,NaN,NaN,370.3580224027581,NaN,NaN,369.4213644467998,413.5605587122395,325.28217018136013,358.8990274002093,332.00500688011124,334.5784138245242,329.4315999356983,276216,665181.8,37.1751029144951,47.940166348057005,NaN,NaN,NaN,NaN,14.311073285307677,19.542958895596783,760723251,-4.9682683830422,-5.853400243479882,-0.8851318604376825
2021-12-07T09:30:00-05:00,348.0663191,351.15298269,342.3329915,348.36298547,NaN,NaN,NaN,370.3580224027581,NaN,NaN,368.9601649071999,413.48626472276743,324.43406509163236,358.8990274002093,347.28298655333333,347.28298655333333,347.28298655333333,549225,655766.1,44.45860647451645,47.310177642959914,NaN,NaN,NaN,NaN,14.361709836357125,19.51947006490025,761272476,-3.9965723733840255,-5.880847327167714,-1.884274953783689
2021-12-07T13:30:00-05:00,348.52965197,352.47298137,347.30965319,350.51631666,NaN,NaN,NaN,370.3580224027581,NaN,NaN,368.14996571619986,412.51446566244937,323.78546576995035,358.8990274002093,348.3319939725895,349.69371520471975,346.9702727404592,325935,626850.9,45.65328576226528,47.11854237897519,NaN,NaN,NaN,NaN,13.704682575188759,19.394454804425497,761598411,-3.0234260705259652,-5.663557541941145,-2.64013147141518
2021-12-08T09:30:00-05:00,351.28964922,355.66631151,344.47298936,355.66631151,NaN,NaN,NaN,370.3580224027581,NaN,NaN,367.20116666359996,410.55228986403546,323.85004346316447,347.19082859916745,351.93520412666663,351.9352079413639,351.93520031196937,401466,621390.8,48.50608444950544,46.65201377822884,NaN,NaN,NaN,NaN,13.525299687675277,19.020882061797913,761999877,-1.9022536156114889,-5.017948490929541,-3.1156948753180522
2021-12-08T13:30:00-05:00,355.83297802,357.32630986,352.64964786,355.99964452,NaN,NaN,NaN,370.3580224027581,NaN,NaN,366.5455673183999,409.5617064420949,323.5294281947049,334.43093961933397,353.1684356477005,354.79932212551034,351.53754916989067,229557,594290.9,48.693810183085894,46.159652623902275,NaN,NaN,NaN,NaN,12.89325413855561,18.536612899304597,762229434,-1.050127434319589,-4.428354168217538,-3.3782267338979493
2021-12-09T09:30:00-05:00,353.509647,354.01631316,340.60965988,340.82965966,NaN,NaN,NaN,370.3580224027581,NaN,NaN,365.54896831339994,408.59314393948114,322.50479268731874,331.01202165446716,345.15187756666666,345.15187756666666,345.15187756666666,906108,611486.5,41.31239298719652,45.26085213119524,NaN,NaN,NaN,NaN,13.071592031515925,18.815885121044555,761323326,-1.3982961825812006,-5.12609696212445,-3.7278007795432493
2021-12-09T13:30:00-05:00,340.77132639,341.47299235,334.11966636,334.42299939,NaN,NaN,NaN,370.3580224027581,NaN,NaN,364.3885028053999,407.5977981271914,321.1792074836084,330.75854692589866,341.26177340851655,345.48730768995944,337.03623912707366,767961,596687.8,38.647850960999584,43.98469532200854,NaN,NaN,NaN,NaN,12.663144457121932,19.425510623966996,760555365,-1.9180930555485318,-6.1254170989789145,-4.207324043430383
2021-12-10T09:30:00-05:00,336.31299751,340.03966045,327.62967284,339.41299441,NaN,NaN,NaN,370.3580224027581,NaN,NaN,363.09010410179997,405.31044692973387,320.86976127386606,330.75854692589866,335.69410923333334,335.69410923333334,335.69410923333334,916647,611189.2,41.796638726386874,42.96078503466216,NaN,NaN,NaN,NaN,12.64506182518465,20.322451332231044,761472012,-1.7865348630805382,-6.440492622281056,-4.653957759200518
2021-12-10T13:30:00-05:00,339.33632782,339.99966049,335.90633125,338.80966168,NaN,NaN,NaN,370.3580224027581,NaN,NaN,361.62910556059995,402.0135761123413,321.2446350088586,330.75854692589866,336.48046984004685,337.656261436234,335.3046782438597,410001,603446,41.51917654390321,42.49826391831481,NaN,NaN,NaN,NaN,12.034223783385746,21.15532484704766,761062011,-1.6064976679207614,-6.66207984410147,-5.0555821761807085
2021-12-13T09:30:00-05:00,333.43633371,334.89633225,319.16968129,320.04968041,NaN,NaN,NaN,365.5860794642432,NaN,NaN,359.8334406869999,399.46205472275244,320.20482665124734,330.75854692589866,324.7052313166667,324.7052313166667,324.7052313166667,904968,620224.9,33.968313065949076,41.69098424630396,NaN,NaN,NaN,NaN,12.577492112429619,22.706790172424185,760157043,-2.5605659797706934,-8.256289650894075,-5.695723671123382
2021-12-13T13:30:00-05:00,320.12968033,325.07634206,317.33301646,321.99634514,NaN,NaN,NaN,359.06124759541393,NaN,NaN,358.1185090661999,396.71344718607213,319.5235709463277,330.75854692589866,323.6242377833829,325.1507584082738,322.097717158492,453810,617617.9,35.28355599564189,40.856389853598955,NaN,NaN,NaN,NaN,12.232194504398931,24.22322955272576,760610853,-2.8481699936726894,-9.255936163214244,-6.407766169541555
2021-12-14T09:30:00-05:00,314.66968579,319.15301464,309.99969045,312.34635477,NaN,NaN,NaN,352.34807523198594,NaN,NaN,356.2221776263999,394.3058194285941,318.13853582420575,330.75854692589866,313.83301995333335,313.83301995333335,313.83301995333335,731877,616118.4,31.89230527615382,40.32540545109608,NaN,NaN,NaN,NaN,12.215370231941865,25.927541352016082,759878976,-3.43655030056821,-10.703454045251817,-7.266903744683607
2021-12-14T13:30:00-05:00,312.2830215,322.0363451,310.71302307,319.48634764,NaN,NaN,NaN,352.34807523198594,NaN,NaN,354.70211247759994,392.4609340742627,316.9432908809372,330.75854692589866,315.4430974827945,317.223528098688,313.66266686690096,598524,600089.7,36.73727458063884,40.23530941043894,NaN,NaN,NaN,NaN,12.15165250323173,27.18890944234726,760477500,-3.103277393774974,-11.146000486902324,-8.04272309312735
2021-12-15T09:30:00-05:00,317.65301614,323.55301025,309.41969103,312.46635465,NaN,NaN,NaN,352.34807523198594,NaN,NaN,353.20084731,391.58327265930654,314.8184219606934,330.75854692589866,315.14635197666666,315.14635197666666,315.14635197666666,634899,608120.8,34.163994401013426,39.98631373726795,NaN,NaN,NaN,NaN,12.293200125858034,28.18673348866784,759842601,-3.1063850448804597,-11.925704399227925,-8.819319354347465
2021-12-15T13:30:00-05:00,312.62302116,326.11634102,311.66635545,325.06634207,NaN,NaN,NaN,352.34807523198594,NaN,NaN,352.74498109859996,391.90390194241417,313.58606025478576,325.0671104927189,317.88424479409406,320.7812832301718,314.9872063580163,567060,591000.5,42.014818994418675,40.33200774297678,NaN,NaN,NaN,NaN,12.44725622901103,28.81219800551123,760409661,-2.0609852109075106,-11.395550867981854,-9.334565657074343
2021-12-16T09:30:00-05:00,331.50300231,331.51966896,309.70969074,314.00301978,NaN,NaN,NaN,352.34807523198594,NaN,NaN,352.2017149743999,392.71826066058134,311.6851692882185,315.8139447435521,318.41079315999997,318.41079315999997,318.41079315999997,1203996,606404,37.75733283226388,39.85334533995874,NaN,NaN,NaN,NaN,13.116022085510242,28.77200149131084,759205665,-1.9186425266870568,-11.732868815433164,-9.814226288746108
2021-12-16T13:30:00-05:00,314.08968636,315.27968518,307.66635945,308.49635862,NaN,NaN,NaN,350.03661052472046,NaN,NaN,351.37158247,393.69486087418005,309.04830406582,315.8139447435521,315.5774875066439,319.3775494083196,311.77742560496813,669315,609259.6,35.81211521414092,39.15040458652128,NaN,NaN,NaN,NaN,12.722972345830938,28.86384039368825,758536350,-1.9907943011613547,-12.3027191651978,-10.311924864036445
2021-12-17T09:30:00-05:00,304.69302908,320.11968034,303.33303044,315.78635134,NaN,NaN,NaN,350.03661052472046,NaN,NaN,350.56924993779995,394.0243641969455,307.1141356786544,315.8139447435521,313.07968737333334,313.07968737333334,313.07968737333334,1281240,639677.1,40.204108385075024,38.557406296204825,NaN,NaN,NaN,NaN,13.013235028271584,28.387962159232977,759817590,-1.3724147534407027,-12.027443305837323,-10.65502855239662
2021-12-17T13:30:00-05:00,315.90301789,318.13634899,310.38635673,310.38635673,NaN,NaN,NaN,350.03661052472046,NaN,NaN,349.70705079879997,394.58311549041565,304.8309861071843,305.7277694578417,313.0453918979641,313.0963459838385,312.99443781208976,580425,637441.2,38.123218654898274,37.80236404419143,NaN,NaN,NaN,NaN,12.637289116252186,27.946075227238794,759237165,-1.1603573629406192,-12.105475256072395,-10.945117893131776
2021-12-20T09:30:00-05:00,303.43636367,307.02969341,297.86636923,300.40636669,NaN,NaN,NaN,340.7901274272766,NaN,NaN,348.6284518758,395.55326269676283,301.7036410548372,297.86982902627335,301.76747644333335,301.76747644333335,301.76747644333335,426909,633015.1,34.56274093314023,37.320246040330254,NaN,NaN,NaN,NaN,12.628910429377031,28.388296156777464,758810256,-1.50373114712826,-12.824781827042102,-11.321050679913842
2021-12-20T13:30:00-05:00,300.25303351,301.5063656,299.06636803,300.11303365,NaN,NaN,NaN,337.21836731330944,NaN,NaN,347.7935860427999,396.6175616626549,298.9696104229449,296.04130796051646,301.26248419017554,301.9850553039608,300.5399130763903,208518,631204.1,34.46086760871975,37.02117580088169,NaN,NaN,NaN,NaN,11.90113093942153,28.798929877063372,758601738,-1.5556310825538482,-13.265589533106152,-11.709958450552303
2021-12-21T09:30:00-05:00,305.82969461,307.58635953,295.47637162,306.81302696,NaN,NaN,NaN,337.21836731330944,NaN,NaN,347.0406534612,397.19019240341,296.89111451899004,296.04130796051646,303.29191937,303.29191937,303.29191937,874923,636661,38.89136946664238,36.8136565680428,NaN,NaN,NaN,NaN,11.916049294462848,28.418203129265677,759476661,-0.9722768281062404,-12.925304485685103,-11.953027657578863
2021-12-21T13:30:00-05:00,307.0063601,313.09635402,307.0063601,312.99968745,NaN,NaN,NaN,337.21836731330944,NaN,NaN,346.7046537966,397.53227958607465,295.8770280071253,296.04130796051646,306.26675049960295,310.0326714251311,302.50082957407477,545949,645989.5,42.74053110167712,36.900896179312376,NaN,NaN,NaN,NaN,11.513711992001214,27.429419104641863,760022610,-0.051881634100830354,-12.017879700204901,-11.96599806610407
2021-12-22T09:30:00-05:00,322.01634512,338.43632872,319.11301468,331.83966864,290.86225011388296,290.86225011388296,290.86225011388296,NaN,NaN,NaN,346.58465391639993,397.52364017215666,295.6456676606432,305.9201334820997,329.7963373466667,329.7963373466667,329.7963373466667,1350660,674264.5,52.543697224959445,38.2277093335274,NaN,NaN,NaN,NaN,12.5082069404297,26.580984345493373,761373270,1.839139269648916,-9.667073979042925,-11.506213248691841
2021-12-22T13:30:00-05:00,331.76633538,336.66633049,329.69967078,336.2896642,296.04387188779737,NaN,NaN,NaN,NaN,NaN,346.3232541773999,397.33668277967257,295.30982557512726,307.1700444446798,331.0177505188594,332.9949973284963,329.04050370922243,515406,677639.4,54.524146405127716,39.60203721991924,NaN,NaN,NaN,NaN,12.11238213825615,25.79315206914121,761888676,3.3168720878917206,-7.360123138827191,-10.676995226718912
2021-12-23T09:30:00-05:00,335.59966489,356.33297752,332.51966796,355.66631151,305.72806672312475,NaN,NaN,NaN,NaN,NaN,346.4065207607999,397.4670653660246,295.34597615557516,320.8292939037438,348.17298566333335,348.17298566333335,348.17298566333335,1661742,703192,61.966923313808174,41.750224222608836,NaN,NaN,NaN,NaN,12.948162668380709,26.216007349251125,763550418,5.403122965571843,-3.9230915197541094,-9.326214485325952
2021-12-23T13:30:00-05:00,355.72631145,357.60297625,352.83298101,355.86631132,317.62828035389185,NaN,NaN,NaN,NaN,NaN,346.28472088259986,397.2252275719891,295.34421419321063,326.815031736995,350.7793534799548,354.26244897491216,347.29625798499745,930474,723254.1,62.03598892594733,43.55727524727372,NaN,NaN,NaN,NaN,12.364007852067799,26.67272379104613,764480892,6.52529280209649,-1.1695984827053394,-7.694891284801829
2021-12-27T09:30:00-05:00,357.98964253,372.33296154,357.16631002,370.55296332,326.62310785007855,NaN,NaN,NaN,NaN,NaN,346.42965407119993,397.6037516547302,295.25555648766965,339.46928081959607,366.68407829333336,366.68407829333336,366.68407829333336,785067,714209.5,66.80329744196672,45.88865403591324,NaN,NaN,NaN,NaN,12.657053735491525,27.775222311570918,765265959,7.894001159327811,2.172610164357934,-5.721390994969877
2021-12-27T13:30:00-05:00,370.81962972,370.97962956,362.5863046,364.56630263,329.2449188341659,NaN,NaN,NaN,NaN,NaN,346.4942540067999,397.75154569469004,295.2369623189098,340.4920225036768,366.50592546186925,366.7927690905984,366.2190818331401,302832,699553.9,63.3131664747278,47.40996457022104,NaN,NaN,NaN,NaN,12.352501680099271,28.798970937772506,764963127,8.008170586641674,4.288822238332216,-3.7193483483094583
2021-12-28T09:30:00-05:00,369.77629743,372.6062946,359.62964089,363.74963678,329.2449188341659,NaN,NaN,NaN,NaN,NaN,346.45925404179997,397.6669541398517,295.2515539437482,341.7278820999415,365.32852409,365.32852409,365.32852409,840474,695072.8,62.83092813656483,49.200935663385394,NaN,NaN,NaN,NaN,12.397083967949323,29.427146216932737,764122653,7.641719119090173,5.832800550553259,-1.808918568536915
2021-12-28T13:30:00-05:00,363.72630347,366.19963433,361.49297236,362.72963779,329.2449188341659,NaN,NaN,NaN,NaN,NaN,346.28265421799995,397.2029794777916,295.3623289582083,341.7278820999415,364.8059337746173,365.6402077725969,363.9716597766377,329784,696858.4,62.1937592836481,51.085338811207336,NaN,NaN,NaN,NaN,11.847768110952941,30.010451833295804,763792869,6.96284050766781,6.894632066047848,-0.0682084416199622
2021-12-29T09:30:00-05:00,366.21296765,367.79963273,354.9429789,361.79297206,329.2449188341659,NaN,NaN,NaN,NaN,NaN,345.94518788819994,396.2221568245726,295.66821895182727,341.7278820999415,361.5118612300001,361.5118612300001,361.5118612300001,826473,706100,61.5762213082704,52.6119183057213,NaN,NaN,NaN,NaN,11.919831376599157,29.810483290539537,762966396,6.113174965807869,7.573260265639874,1.460085299832005
2021-12-29T13:30:00-05:00,361.99963852,365.69296817,360.92963959,361.92630526,329.2449188341659,NaN,NaN,NaN,NaN,NaN,345.2937218719999,393.85198729145515,296.7354564525446,341.7278820999415,361.902244623925,362.5103946991446,361.2940945487054,340557,706587.4,61.63461887248509,54.291304035548926,NaN,NaN,NaN,NaN,11.408652605413499,29.624798215123,763306953,5.2553560260372,8.029280332378505,2.7739243063413053
2021-12-30T09:30:00-05:00,353.7763134,365.07963545,351.88631529,363.26630393,329.2449188341659,NaN,NaN,NaN,NaN,NaN,344.8504556479999,392.32770391516357,297.3732073808363,341.7278820999415,360.0774182233333,360.0774182233333,360.0774182233333,754848,718366.8,62.25548681646471,56.26935731292924,NaN,NaN,NaN,NaN,11.536128859312532,28.472841045719054,764061801,4.502423532587234,8.401953722075348,3.8995301894881136
2021-12-30T13:30:00-05:00,363.29297057,363.57963695,356.15964436,356.69297716,329.2449188341659,NaN,NaN,NaN,NaN,NaN,344.7841223809999,392.1856735899983,297.3825711720015,341.7278820999415,359.5973437743022,360.21185351170425,358.98283403690016,460701,726071.6,57.3523243663809,57.904461367047894,NaN,NaN,NaN,NaN,11.242119125790207,27.403166531272532,763601100,3.3394299205845224,8.073817590218766,4.734387669634244
2021-12-31T09:30:00-05:00,357.76797608,360.52297333,354.33631284,356.0529778,329.2449188341659,NaN,NaN,NaN,NaN,NaN,344.51185598619986,391.4931256370439,297.53058633535585,341.7278820999415,356.97075465666666,356.97075465666666,356.97075465666666,649284,717510.8,56.882584982275695,59.18954818959313,NaN,NaN,NaN,NaN,10.88101493751948,26.210565439289308,762951816,2.3514238482592313,7.673667479958283,5.322243631699052
2021-12-31T13:30:00-05:00,355.66631151,356.22964429,351.57964893,352.29298155,329.2449188341659,NaN,NaN,NaN,NaN,NaN,344.0631897675999,390.3043531601279,297.8220263750719,341.7278820999415,355.33605614714554,357.12996766317724,353.54214463111384,539148,709883.7,54.080144798541745,59.999520596512035,NaN,NaN,NaN,NaN,10.435942110553801,24.79876698640076,762412668,1.3204192034131674,6.972767635965511,5.652348432552343
2022-01-03T09:30:00-05:00,382.5829513,392.76627447,378.86962168,391.92960864,348.33042734227314,NaN,NaN,NaN,NaN,NaN,344.46278936859994,391.9884636864674,296.9371150507325,355.94875011134775,387.8551682633333,387.8551682633333,387.8551682633333,1160112,717999.2,70.55113115587602,61.28576587729179,NaN,NaN,NaN,NaN,12.581467168371388,25.857395280101414,763572780,3.0829724701450694,9.50606402023368,6.4230915500886105
2022-01-03T13:30:00-05:00,391.9362753,400.27626697,391.70960886,399.99960058,359.04121474603346,NaN,NaN,NaN,NaN,NaN,345.24278858979994,395.05368823190435,295.43188894769554,366.5389184280782,391.58712332041017,396.2160033564898,386.95824328433054,754086,729468.7,72.69831688802897,62.58392091178473,NaN,NaN,NaN,NaN,12.294695092773432,27.154300202744018,764326866,4.482542133182269,12.026269216566448,7.543727083384178
2022-01-04T09:30:00-05:00,396.64627059,402.66293125,374.91295896,386.94961361,359.04121474603346,NaN,NaN,NaN,NaN,NaN,345.43505506439993,395.8109934856636,295.0591166431363,366.5389184280782,388.17516794,388.17516794,388.17516794,1233675,740425.6,64.50740545817735,62.765383922096824,NaN,NaN,NaN,NaN,13.398643464003898,26.824272109752545,763093191,4.22318861700791,12.822712854644067,8.599524237636157
2022-01-04T13:30:00-05:00,386.79628043,386.79628043,378.56962198,383.23628398,359.04121474603346,NaN,NaN,NaN,NaN,NaN,345.52412164199995,396.15071028928566,294.89753299471425,366.5389184280782,386.3625271006545,388.8795527947443,383.8455014065647,639807,746625.5,62.35455355123717,62.78813853818895,NaN,NaN,NaN,NaN,13.040168333003617,26.51781745197475,762453384,3.5238680888490794,13.004359348697506,9.480491259848426
2022-01-05T09:30:00-05:00,382.20628501,390.11294378,377.33295655,379.46628775,359.04121474603346,NaN,NaN,NaN,NaN,NaN,345.6067882261999,396.4408757427112,294.7727007096886,366.5389184280782,382.3040626933334,382.3040626933334,382.3040626933334,650727,743920.5,60.15937430330876,62.31357259971339,NaN,NaN,NaN,NaN,13.02158396850336,26.416010982260797,761802657,2.5737963606061687,12.697736710606137,10.123940349999968
2022-01-05T13:30:00-05:00,379.20628801,381.85628536,360.53630665,362.69297116,359.04121474603346,NaN,NaN,NaN,NaN,NaN,345.2271886052,395.2553969197723,295.19898029062773,366.5389184280782,374.853316553143,381.8079004124573,367.89873269382866,746889,748866,51.476328538076764,61.468084175666895,NaN,NaN,NaN,NaN,13.614326450038837,24.9576112616786,761055768,0.680655238142915,10.97475939767861,10.294104159535696
2022-01-06T09:30:00-05:00,358.50630868,361.74630544,340.21299361,353.52964698,NaN,NaN,NaN,391.8267186282864,391.8267186282864,391.8267186282864,344.6784558197999,393.7187353220161,295.63817631758377,366.5389184280782,351.8296486766667,351.8296486766667,351.8296486766667,1073922,763500.1,47.44731085871904,60.36925437010648,NaN,NaN,NaN,NaN,14.247587242893205,24.0025389594215,759981846,-1.2202413381142634,8.768802486892866,9.98904382500713
2022-01-06T13:30:00-05:00,353.82298002,361.47963904,353.32631385,354.89964561,NaN,NaN,NaN,391.8267186282864,NaN,NaN,344.48572267879996,393.2874800300346,295.6839653275653,366.5389184280782,353.0181732404019,355.0723615439072,350.96398493689657,359508,756581.7,48.101343597998486,59.36265324970293,NaN,NaN,NaN,NaN,13.812282810543689,23.115686107325626,760341354,-2.351357512140714,7.049846934831237,9.401204446971951
2022-01-07T09:30:00-05:00,359.3196412,360.25964026,341.26632589,342.65965784,NaN,NaN,NaN,391.6323543765275,NaN,NaN,344.17485632259996,392.8209115347203,295.5288011104796,366.5389184280782,348.06187466333336,348.06187466333336,348.06187466333336,1131207,754155.4,42.957486009231445,58.03274358548587,NaN,NaN,NaN,NaN,14.182356493361997,22.93932599061686,759210147,-3.803893581487573,4.646337470112485,8.450231051600058
2022-01-07T13:30:00-05:00,342.59632457,346.3663208,336.74133041,342.37299146,NaN,NaN,NaN,381.87799690054896,NaN,NaN,343.79192337179995,392.18659823991,295.3972485036899,366.5389184280782,345.26329522474686,348.36443670808006,342.16215374141365,921243,762553,42.84193300308898,56.690408880529,NaN,NaN,NaN,NaN,13.856830343121855,23.000927379706955,758288904,-4.610242184433595,2.6874283210580643,7.297670505491659
2022-01-10T09:30:00-05:00,333.5463336,343.83632333,326.66634047,340.69965979,NaN,NaN,NaN,376.0839476175695,NaN,NaN,343.7613900688,392.1619035589309,295.3608765786691,366.5389184280782,337.0674411966667,337.0674411966667,337.0674411966667,852528,748262.6,42.12954094410703,55.25284131821773,NaN,NaN,NaN,NaN,14.093484094327437,23.531856124618862,757436376,-5.04728894078724,0.9885593295076092,6.035848270294849
2022-01-10T13:30:00-05:00,340.41299341,352.98631419,338.19966229,352.75964775,NaN,NaN,NaN,376.0839476175695,NaN,NaN,344.04898978159997,392.4890486519926,295.6089309112073,361.7980662714626,341.5514876132346,346.9212319617007,336.1817432647685,594486,748731.3,48.744673393821806,54.63800910589208,NaN,NaN,NaN,NaN,14.142996080446904,23.293968266387182,758030862,-4.342021573403349,0.6083213035406629,4.950342876944012
2022-01-11T09:30:00-05:00,351.21298263,358.57964194,346.27298756,353.90297994,NaN,NaN,NaN,376.0839476175695,NaN,NaN,344.3790561186,392.85827366949513,295.8998385677048,354.2174399267361,352.91853648,352.91853648,352.91853648,725640,758689,49.33595143193679,54.09896385229645,NaN,NaN,NaN,NaN,14.011828816129269,22.65143592058612,758756502,-3.6445242468367995,0.39468756839801244,4.039211815234812
2022-01-11T13:30:00-05:00,354.73964577,355.64964486,351.2096493,354.82631235,NaN,NaN,NaN,376.0839476175695,NaN,NaN,344.75292241179994,393.26031612635524,296.24552869724465,354.2174399267361,353.1552376368642,353.5737474468548,352.73672782687356,232119,759475.7,49.839205715576135,53.79603963208462,NaN,NaN,NaN,NaN,13.328126440691463,22.05479874234227,758988621,-2.994194257772191,0.2964689930195732,3.290663250791764
2022-01-12T09:30:00-05:00,359.60297425,367.77629942,357.58297627,366.05963447,NaN,NaN,NaN,376.0839476175695,NaN,NaN,345.10685539179997,393.97137876650663,296.2423320170933,342.47989292238884,363.8063033866667,363.8063033866667,363.8063033866667,942723,761735.7,55.61555208396346,52.72921255551944,NaN,NaN,NaN,NaN,13.30111648564207,20.603465635790283,759931344,-1.7427353830636303,1.1122440219622263,2.8549794050258566
2022-01-12T13:30:00-05:00,366.14963438,371.539629,364.45963607,368.93296493,NaN,NaN,NaN,376.0839476175695,NaN,NaN,345.47518835719995,394.7729841081748,296.1773926062251,342.7331750152054,365.49083231812995,367.67033264831133,363.31133198794856,563154,762309.2,56.98019585935831,51.60648962490011,NaN,NaN,NaN,NaN,12.856750517381922,19.26525059410243,760494498,-0.7096472016044557,1.9679204030202868,2.6775676046247425
2022-01-13T09:30:00-05:00,369.68796418,371.45962908,350.62964988,353.84298,NaN,NaN,NaN,376.0839476175695,NaN,NaN,345.4387217269999,394.7089989975145,296.1684444564853,342.7331750152054,358.64408632000004,358.64408632000004,358.64408632000004,1142241,755361.9,48.539608681689806,50.465932712293856,NaN,NaN,NaN,NaN,13.426266851854644,18.650523479624372,759352257,-1.0123451227903741,1.412136201136775,2.424481323927149
2022-01-13T13:30:00-05:00,353.77964673,357.33297652,342.20632496,344.11298972,NaN,NaN,NaN,376.0839476175695,NaN,NaN,345.200988631,394.37976568190584,296.0222115800941,342.7331750152054,354.57035976935,359.78936407060803,349.3513554680919,695931,761379.4,44.01238541193931,49.15577784520115,NaN,NaN,NaN,NaN,13.547722902436453,18.556031569659233,758656326,-1.7920502934745137,0.18441845708400706,1.9764687505585208
2022-01-14T09:30:00-05:00,339.73299409,349.47298437,337.99966249,341.48299234,NaN,NaN,NaN,376.0839476175695,NaN,NaN,345.2140552846,394.38852658453993,296.0395839846601,342.7331750152054,342.98521306666663,342.98521306666663,342.98521306666663,903723,736112.1,42.84905134396157,47.919326205247785,NaN,NaN,NaN,NaN,13.399551400833849,18.696197104866112,757752603,-2.372671528415728,-0.9893706599611392,1.3833008684545889
2022-01-14T13:30:00-05:00,341.36299246,350.41631676,340.13299369,349.86631731,NaN,NaN,NaN,376.0839476175695,NaN,NaN,345.522921643,394.61633022592207,296.42951306007797,342.7331750152054,344.4749280349386,346.33811208685785,342.6117439830194,577737,724354.2,47.60327241180873,47.64267933908578,NaN,NaN,NaN,NaN,13.176963662917144,18.746856677949378,758330340,-2.089821383160113,-1.2289758604955523,0.8608455226645606
2022-01-18T09:30:00-05:00,341.79632536,356.78297707,338.68632847,344.8663223,NaN,NaN,NaN,376.0839476175695,NaN,NaN,345.6319882008,394.6948374575038,296.56913894409615,342.7331750152054,346.7785426133334,346.7785426133334,346.7785426133334,669558,720503.9,45.18878710875485,47.48135621408834,NaN,NaN,NaN,NaN,13.528369729851637,18.257452933652505,757660782,-2.1299206666078354,-1.8015553105952335,0.32836535601260175
2022-01-18T13:30:00-05:00,344.74298909,351.16631601,342.27299156,343.62965687,NaN,NaN,NaN,376.0839476175695,NaN,NaN,345.7283881046,394.7561681965883,296.7006080126117,342.7331750152054,346.44289921038273,346.9457128067097,345.94008561405576,298353,720354.6,44.586424867192676,47.23029059045935,NaN,NaN,NaN,NaN,13.197295067005092,17.80300659966255,757362429,-2.1253149026880047,-2.3282782723474043,-0.20296336965939954
2022-01-19T09:30:00-05:00,347.23465327,351.49631568,331.9463352,337.1229967,NaN,NaN,NaN,376.0839476175695,NaN,NaN,346.0698544303999,394.6129215186148,297.526787342185,342.7331750152054,340.1885491933333,340.1885491933333,340.1885491933333,783558,718457.4,41.455317973464204,47.122992873618834,NaN,NaN,NaN,NaN,13.651058310790441,18.046834921044823,756578871,-2.424405052982241,-3.2334696858872007,-0.8090646329049598
2022-01-19T13:30:00-05:00,336.99633016,338.81966167,331.66633548,331.67633547,NaN,NaN,NaN,374.70008872731876,NaN,NaN,346.26345423699996,394.4971623867063,298.02974608729363,342.7331750152054,338.5026721198836,341.24123514004333,335.76410909972384,296946,717362.8,38.98715564994428,46.8476516341085,NaN,NaN,NaN,NaN,13.18693458787684,18.29057823431491,756281925,-2.8249947533143227,-4.340308074547863,-1.5153133212335406
2022-01-20T09:30:00-05:00,336.47633068,347.1996533,334.67633247,343.46965703,NaN,NaN,NaN,374.70008872731876,NaN,NaN,346.88592028219995,394.1462165073377,299.62562405706217,342.7331750152054,341.7818809333333,341.7818809333333,341.7818809333333,866292,718690.1,46.42498528538408,47.15446908705685,NaN,NaN,NaN,NaN,13.35381910517135,17.733490010440015,757148217,-2.161548670807572,-4.217249159743005,-2.0557004889354333
2022-01-20T13:30:00-05:00,343.33965716,344.6663225,331.3796691,332.15633499,NaN,NaN,NaN,374.70008872731876,NaN,NaN,347.13932002919995,393.94291691782587,300.33572314057403,337.99947629216433,339.62137758744046,342.3923502150339,336.850404959847,526635,724892.7,41.2322022311648,46.617864004009924,NaN,NaN,NaN,NaN,13.349021554801967,17.45177507990631,756621582,-2.335649919916019,-4.975262888830457,-2.639612968914438
2022-01-21T09:30:00-05:00,332.19633495,334.41966606,317.28301651,318.94634818,NaN,NaN,NaN,366.1638110585456,NaN,NaN,347.2689198997999,393.7223355749416,300.81550422465824,323.0015285097315,323.54967691666667,323.54967691666667,323.54967691666667,1167972,738663.5,36.14793043043195,45.675862503902444,NaN,NaN,NaN,NaN,13.619566411601827,18.083478095587164,755453610,-3.141300231371494,-6.566238258128806,-3.4249380267573115
2022-01-21T13:30:00-05:00,318.793015,321.54634559,313.59635352,314.32301946,NaN,NaN,NaN,357.13552416656626,NaN,NaN,347.0540534475999,394.0129012720344,300.09520562316544,322.3721591591425,320.94761472124287,324.353888970859,317.54134047162677,681567,746025.7,34.54252975636659,44.58324279253033,NaN,NaN,NaN,NaN,13.214596815773126,18.87671131434804,754772043,-3.74541962141522,-8.106712553526336,-4.361292932111116
2022-01-24T09:30:00-05:00,301.86303191,305.08302869,283.99971641,295.34303842,NaN,NaN,NaN,336.4421714587678,NaN,NaN,346.68085382039993,394.9624127952967,298.39929484550316,322.3721591591425,294.8085945066667,294.8085945066667,294.8085945066667,1267224,766623.7,28.87332124262558,42.673083446720476,NaN,NaN,NaN,NaN,14.436647261075043,20.894856400007438,753504819,-5.099225839901905,-10.735325231988497,-5.636099392086592
2022-01-24T13:30:00-05:00,294.63303913,310.77635634,291.69637539,310.21969023,NaN,NaN,NaN,336.4421714587678,NaN,NaN,346.7153204525998,394.89013801721876,298.5405028879809,322.3721591591425,298.3450176368633,302.90732437522513,293.7827108985015,761400,774032.1,37.52794495521749,41.28363695356756,NaN,NaN,NaN,NaN,14.768313953141112,22.244723817320295,754266219,-4.67967909920161,-11.485698266088605,-6.806019166886995
2022-01-25T09:30:00-05:00,304.51302926,310.62635649,301.30303247,306.99969344,NaN,NaN,NaN,336.4421714587678,NaN,NaN,346.5395872945999,395.22580619382876,297.8533683953711,319.190999456314,306.3096941333333,306.3096941333333,306.3096941333333,778788,761321.3,36.49290058362146,40.423157803705536,NaN,NaN,NaN,NaN,14.379386100773887,23.498172133396515,753487431,-4.314842313966792,-12.199572059345485,-7.884729745378693
2022-01-25T13:30:00-05:00,306.73302704,316.85635027,305.2396952,306.20969423,NaN,NaN,NaN,336.4421714587678,NaN,NaN,346.45605404459985,395.40373565502927,297.50837243417044,316.1410721970512,307.34510911130633,308.8162174102757,305.87400081233693,385797,749045,36.228893755186625,39.86719411393749,NaN,NaN,NaN,NaN,14.182048170004322,24.06772153153904,753101634,-3.838510848981434,-12.682868306605485,-8.844357457624051
2022-01-26T09:30:00-05:00,317.63968282,321.38967908,312.99968745,319.90301389,NaN,NaN,NaN,336.4421714587678,NaN,NaN,346.8459869885999,394.61654866744306,299.0754253097568,313.9493080799128,318.09746014,318.09746014,318.09746014,789867,734251.4,43.8161545094199,39.93627291147022,NaN,NaN,NaN,NaN,14.253329361432582,24.178068453070466,753891501,-2.3842264439488456,-11.824640512560109,-9.440414068611263
2022-01-26T13:30:00-05:00,319.66968079,328.72633842,302.06303171,313.06968738,NaN,NaN,NaN,336.4421714587678,NaN,NaN,347.10512006319993,393.99123231737315,300.2190078090267,313.9493080799128,316.22984931941227,317.96396544679857,314.49573319202597,916158,743463.1,41.18293842562972,39.47767762674315,NaN,NaN,NaN,NaN,15.13975631490168,24.83191671993241,752975343,-1.697744544030387,-11.562594748649246,-9.86485020461886
2022-01-27T09:30:00-05:00,311.11968933,311.5830222,284.43304931,284.88304886,NaN,NaN,NaN,336.4421714587678,NaN,NaN,346.6665205011999,395.42499375726305,297.90804724513674,311.4227196239302,293.63304012333333,293.63304012333333,293.63304012333333,1443636,769893.4,32.50528951741771,38.571713513076205,NaN,NaN,NaN,NaN,16.1038192974087,26.165981673410815,751531707,-2.887341879075974,-13.474027553463827,-10.586685674387853
2022-01-27T13:30:00-05:00,284.96304878,288.99971142,276.33472406,276.36305737,NaN,NaN,NaN,327.7808810462342,NaN,NaN,345.9337878995999,397.7022225721276,294.1653532270722,299.25645898414416,288.89913936072986,295.1799876346942,282.6182910867655,820086,772333.3,30.418839684806144,37.559743142905745,NaN,NaN,NaN,NaN,15.858188444736651,27.68806609807793,750711621,-3.9288083701101293,-15.497696137025514,-11.568887766915385
2022-01-28T09:30:00-05:00,277.18972321,285.74971466,264.01640303,277.97638909,NaN,NaN,NaN,320.90973449595083,NaN,NaN,344.85652230859995,399.8919103080539,289.821134309146,289.4407838943153,275.91416892666666,275.91416892666666,275.91416892666666,1444476,784685.1,31.317854720354802,36.83563862482651,NaN,NaN,NaN,NaN,16.27784010082689,29.488426207629054,752156097,-4.167194360524272,-16.777880717570724,-12.610686357046452
2022-01-28T13:30:00-05:00,278.27972212,282.42305132,271.16972922,282.05305169,NaN,NaN,NaN,320.90973449595083,NaN,NaN,343.7717900583999,401.51136180207567,286.03221831472416,285.92656011805445,276.75188325026977,277.97872649883936,275.5250400017002,673479,795150.8,33.65065577575328,36.45446006238429,NaN,NaN,NaN,NaN,15.918945957910681,31.160189166497954,752829576,-3.7230265630169086,-17.264469560817588,-13.54144299780068
2022-01-31T09:30:00-05:00,290.90304285,310.66635645,287.60637948,307.24969319,NaN,NaN,NaN,320.90973449595083,NaN,NaN,342.80345769199994,401.3312134014404,284.2757019825595,285.92656011805445,301.8408097066667,301.8408097066667,301.8408097066667,1090731,793801.6,45.88484811888719,36.41587883620594,NaN,NaN,NaN,NaN,16.825685872345634,30.361845759127647,753920307,-1.5180180404981058,-15.438965548423312,-13.920947507925206
2022-01-31T13:30:00-05:00,307.65969279,312.4830213,306.25636085,311.99968845,NaN,NaN,NaN,320.90973449595083,NaN,NaN,341.92612523459997,400.9572870374077,282.89496343179223,285.92656011805445,304.3517182147839,308.1989117819548,300.504524647613,464613,778580.6,47.83753226902814,36.887688124624745,NaN,NaN,NaN,NaN,16.068612627892374,29.494621053929265,754384920,0.37366381918466196,-13.453867733944378,-13.82753155312904
2022-02-01T09:30:00-05:00,311.4830223,314.56635256,301.72969871,311.07635604,NaN,NaN,NaN,320.90973449595083,NaN,NaN,340.736593089,399.80938808750136,281.66379809049863,285.92656011805445,309.12413577,309.12413577,309.12413577,691677,773218.9,47.47888853272373,37.697042274788444,NaN,NaN,NaN,NaN,15.83775842947149,28.910887060577906,753693243,1.6068833344075575,-11.818927385119594,-13.425810719527151
2022-02-01T13:30:00-05:00,310.82968962,311.66635545,306.16636094,310.18969026,NaN,NaN,NaN,320.90973449595083,NaN,NaN,339.6490608416,398.9287779514964,280.36934373170357,285.92656011805445,309.18995823124243,309.28960220934766,309.0903142531372,301821,763463.4,47.11360727414282,38.59497638320103,NaN,NaN,NaN,NaN,15.099346720937815,28.368848352465925,753391422,2.3614215703802657,-10.474033756551819,-12.835455326932085
2022-02-02T09:30:00-05:00,309.36969108,310.3830234,296.66637043,302.03636507,NaN,NaN,NaN,320.90973449595083,NaN,NaN,338.4147954074,398.20360193330947,278.6259888814905,285.92656011805445,303.0285863,303.0285863,303.0285863,706791,762835.1,43.77823299675445,39.65961293706738,NaN,NaN,NaN,NaN,15.000582881585117,28.340467445134642,752684631,2.3072541282411585,-9.951387666630637,-12.258641794871796
2022-02-02T13:30:00-05:00,302.38636472,303.77303,299.99970043,301.86969857,NaN,NaN,NaN,320.90973449595083,NaN,NaN,337.197596623,397.433148398432,276.96204484756794,276.7552875323235,302.7322056557332,303.2345375099965,302.22987380146986,246042,763299.2,43.71011241071588,40.101196326745836,NaN,NaN,NaN,NaN,14.198636216471893,28.314113745469875,752438589,2.2534763815555525,-9.441796317927356,-11.695272699482908
2022-02-03T09:30:00-05:00,293.99970643,312.23968821,293.60970681,304.62636248,NaN,NaN,NaN,320.90973449595083,NaN,NaN,336.0542644314,396.5486367956647,275.55989206713525,279.15156995774964,303.49191916666666,303.49191916666666,303.49191916666666,1023861,766003.8,45.22820176733205,40.72514641129659,NaN,NaN,NaN,NaN,14.515160872438187,27.55531579966572,753462450,2.3841859956036693,-8.715040204978322,-11.099226200581992
2022-02-03T13:30:00-05:00,304.96302881,306.49969394,295.66637143,297.13303663,NaN,NaN,NaN,320.90973449595083,NaN,NaN,334.75839905879997,395.7542347989983,273.7625633186016,279.15156995774964,302.30534088399736,304.0410513654647,300.56963040253004,478497,763181.9,41.918787410521595,41.13156738667766,NaN,NaN,NaN,NaN,14.252172417978313,26.85071770713329,752983953,1.9641122564963975,-8.644085879961494,-10.608198136457892
2022-02-04T09:30:00-05:00,299.9963671,309.56635755,293.86637323,308.57969187,NaN,NaN,NaN,320.90973449595083,NaN,NaN,333.6646668176,394.53762388704143,272.79170974815855,279.15156995774964,304.00414088333326,304.00414749058274,304.0041342760838,1025556,759292.4,48.159057432574556,41.44177473833156,NaN,NaN,NaN,NaN,14.355587553837006,25.92202000854774,754009509,2.4250678784038584,-7.576863288453069,-10.001931166856927
2022-02-04T13:30:00-05:00,308.92969152,312.15635496,307.10969333,307.60969284,NaN,NaN,NaN,320.90973449595083,NaN,NaN,332.6830011312,393.62187968699794,271.74412257540206,282.9452506686478,306.17001553677557,308.6275919661497,303.71243910740145,796548,762646.3,47.69144551146239,41.90666810160533,NaN,NaN,NaN,NaN,13.690664273562932,24.825167365299603,753212961,2.616142491848171,-6.731753052046713,-9.347895543894884
2022-02-07T09:30:00-05:00,307.74302604,315.6930181,302.55636455,306.49636061,NaN,NaN,NaN,320.90973449595083,NaN,NaN,331.69186878740004,392.6901006710325,270.6936369037676,285.75580789191827,308.24858108666666,308.24858108666666,308.24858108666666,620403,753202.3,47.12585128246943,42.95099394196616,NaN,NaN,NaN,NaN,13.651092079022723,24.137356515346116,752592558,2.612934562777541,-6.081727340422958,-8.6946619032005
2022-02-07T13:30:00-05:00,306.49302728,308.74635837,301.0730327,302.39969804,NaN,NaN,NaN,320.90973449595083,NaN,NaN,330.69400311720005,391.9434225670969,269.4445836673032,285.75580789191827,307.0247202064823,308.9253670798355,305.1240733331291,257238,742519,45.01056550901135,43.99326007226654,NaN,NaN,NaN,NaN,13.224108764092529,23.60672389606238,752335320,2.291777685773571,-5.829939795983535,-8.121717481757106
2022-02-08T09:30:00-05:00,301.84303193,308.39969205,298.26636883,307.5496929,NaN,NaN,NaN,320.90973449595083,NaN,NaN,329.0064048024001,388.02308217071436,269.9897274340858,285.75580789191827,304.73858459333337,304.73858459333337,304.73858459333337,673320,742644.4,48.160707917579856,45.196321014925466,NaN,NaN,NaN,NaN,13.003338368085922,23.322651724803013,753008640,2.3730487924587944,-5.155406491183612,-7.528455283642407
2022-02-08T13:30:00-05:00,307.66302612,308.7163584,304.95636215,307.22302655,NaN,NaN,NaN,320.90973449595083,NaN,NaN,327.1508733218001,382.8640203968249,271.43772624677524,285.75580789191827,305.50963642115613,306.569047939495,304.45022490281724,356664,744588.1,47.972979545314836,46.21934414132272,NaN,NaN,NaN,NaN,12.343099645365497,23.022610818476206,752651976,2.347377215128783,-4.5942337647314275,-6.941610979860211
2022-02-09T09:30:00-05:00,311.6496888,315.33301846,307.50969294,312.07968837,NaN,NaN,NaN,320.90973449595083,NaN,NaN,325.6534748170001,378.823824166411,272.48312546758916,292.3047079018497,311.6407999233333,311.6407999233333,311.6407999233333,743613,743256.6,51.029251138566586,46.58680149987125,NaN,NaN,NaN,NaN,12.040734807125105,22.0023641268735,753395589,2.581459528896797,-3.714786568739214,-6.296246097636011
2022-02-09T13:30:00-05:00,312.27968817,312.39968805,309.00302478,310.66635645,NaN,NaN,NaN,320.90973449595083,NaN,NaN,324.20207626640007,374.91071974455986,273.4934327882403,292.3047079018497,311.3469828503321,311.78644153084724,310.90752416981695,332403,744438.5,50.106784828953316,46.748890968437344,NaN,NaN,NaN,NaN,11.423301125901885,21.0549921989567,753063186,2.560059546565432,-3.096171664429221,-5.656231210994653
2022-02-10T09:30:00-05:00,302.72303105,314.46635266,302.22969821,305.03636207,NaN,NaN,NaN,320.90973449595083,NaN,NaN,322.71347775280003,371.1650839556583,274.26187154994176,292.3047079018497,307.2441376466666,307.2441376466666,307.2441376466666,597549,735480.4,46.50067420350216,46.679018516350084,NaN,NaN,NaN,NaN,11.481397791908893,20.786585662002924,752465637,2.1047175921309345,-3.0253342208309846,-5.130051812961919
2022-02-10T13:30:00-05:00,305.04302873,307.12302665,299.06636803,301.55636555,NaN,NaN,NaN,320.90973449595083,NaN,NaN,321.49074564060004,368.9198393348437,274.0616519463564,292.3047079018497,305.052270803021,307.37921726765813,302.7253243383838,530187,735598.8,44.37481453971105,46.48339046389067,NaN,NaN,NaN,NaN,11.236773565343972,20.80342273299171,751935450,1.5336697576086715,-3.21296461595108,-4.746634373559751
2022-02-11T09:30:00-05:00,303.20969723,305.06969537,293.67970675,293.73304003,NaN,NaN,NaN,320.90973449595083,NaN,NaN,320.29481350160006,367.4468848842141,273.142742118986,292.3047079018497,297.4941473833333,297.4941473833333,297.4941473833333,980157,729338.3,39.95280300797633,46.21014546469223,NaN,NaN,NaN,NaN,11.247717497819403,21.249461141602538,750955293,0.6393583365616058,-3.947436452857744,-4.58679478941935
2022-02-11T13:30:00-05:00,293.76637333,293.76637333,283.56638351,286.66304708,NaN,NaN,NaN,320.90973449595083,NaN,NaN,318.93008153100004,365.94663145606074,271.91353160593934,292.3047079018497,292.4283827981065,297.16549480856656,287.69127078764643,1120878,743982,36.42062207244315,45.68946758338705,NaN,NaN,NaN,NaN,11.172879806546591,22.36004773745842,749834415,-0.3640684576746889,-5.04188036151271,-4.6778119038380215
2022-02-14T09:30:00-05:00,287.31304644,299.56970086,284.53971587,293.52637356,NaN,NaN,NaN,320.90973449595083,NaN,NaN,317.94741584540003,364.99286075143647,270.9019709393636,292.3047079018497,292.54526343000003,292.5452672446973,292.54525961530277,873432,730855.6,41.79985234185207,45.444585481567046,NaN,NaN,NaN,NaN,11.448387319650406,22.645872486920595,750707847,-0.49326368236555584,-5.294391506794966,-4.80112782442941
2022-02-14T13:30:00-05:00,293.46970695,293.46970695,286.41638066,291.92637516,NaN,NaN,NaN,320.90973449595083,NaN,NaN,316.9384835194,364.00907915821614,269.86788788058385,292.3047079018497,291.8099377634845,292.75155528711446,290.8683202398546,532647,723230.5,40.93045166928506,45.37399007147872,NaN,NaN,NaN,NaN,11.138502003961092,22.91128118284976,750175200,-0.6067202430444274,-5.559528128234945,-4.952807885190517
2022-02-15T09:30:00-05:00,299.92470051,307.14302663,297.87303589,306.106361,NaN,NaN,NaN,320.90973449595083,NaN,NaN,316.2466175436,362.915081950736,269.578153136464,292.3047079018497,303.70747450666664,303.70747450666664,303.70747450666664,806148,724142.5,50.714250637984065,45.55650387186512,NaN,NaN,NaN,NaN,11.42979839439244,21.600765447135508,750981348,0.30406003379681046,-4.572732842944504,-4.876792876741314
2022-02-15T13:30:00-05:00,306.21636089,307.59302619,304.42969601,307.4063597,NaN,NaN,NaN,320.90973449595083,NaN,NaN,315.3395517826,360.88349100234814,269.79561256285183,292.3047079018497,304.4283790299099,305.6434507156161,303.21330734420366,283770,720741.6,51.507249371506624,45.829061290439704,NaN,NaN,NaN,NaN,10.839336379078693,20.338471933661097,751265118,0.9864038069272238,-3.643788118082284,-4.630191925009508
2022-02-16T09:30:00-05:00,304.66969577,305.71302806,301.05969938,301.76636534,NaN,NaN,NaN,320.90973449595083,NaN,NaN,314.2968194906,358.63268205170624,269.96095692949376,292.27870796847975,302.84636426,302.84636426,302.84636426,571380,713458.7,47.90593614623357,45.884781637851425,NaN,NaN,NaN,NaN,10.518430946287358,19.486937341864603,750693738,1.0446560591701166,-3.3243718510468625,-4.369027910216979
2022-02-16T13:30:00-05:00,301.60303217,308.72635839,300.44636665,307.95635916,NaN,NaN,NaN,320.90973449595083,NaN,NaN,313.3594204268,356.1841652909461,270.5346755626539,292.25124136978377,304.1206705491858,305.54366159326395,302.6976795051076,458214,698193.9,51.882363511710366,46.37562435232993,NaN,NaN,NaN,NaN,10.358542431552545,18.362837727235256,751151952,1.461267383630008,-2.542443680679469,-4.003711064309477
2022-02-17T09:30:00-05:00,304.02969641,306.0396944,293.55637353,294.33303943,NaN,NaN,NaN,320.90973449595083,NaN,NaN,311.924888526,352.3291270991048,271.5206499528952,287.03256746082087,297.97636911999996,297.97636911999996,297.97636911999996,760224,675413.5,43.93391851336735,46.0737108234576,NaN,NaN,NaN,NaN,10.647216945727363,17.977984937065298,750391728,0.8128818707415624,-2.9876087258825237,-3.800490596624086
2022-02-17T13:30:00-05:00,294.34637275,294.89970553,291.44304231,292.18304157,NaN,NaN,NaN,320.90973449595083,NaN,NaN,310.3898900588,347.7297239252119,273.0500561923881,287.03256746082087,295.9944114760157,298.49402847642193,293.4947944756095,477951,664009,42.81901106833611,45.70557021795912,NaN,NaN,NaN,NaN,10.133605965318266,17.811384399588455,749913777,0.26131428837149917,-3.473847736159712,-3.735162024531211
2022-02-18T09:30:00-05:00,295.2630385,295.44970498,279.24638782,280.13305361,NaN,NaN,NaN,320.90973449595083,NaN,NaN,308.915691531,345.0785807696909,272.75280229230907,287.03256746082087,284.94304880333334,284.94304880333334,284.94304880333334,941037,647227.7,37.13158650164909,44.71287988675073,NaN,NaN,NaN,NaN,10.567156764938389,18.62184302519212,748972740,-0.8330454348563041,-4.776468818101591,-3.943423383245287
2022-02-18T13:30:00-05:00,280.12638695,287.59971282,280.12638695,285.4763816,NaN,NaN,NaN,317.25311351815,NaN,NaN,307.7429593686,343.0572266158448,272.4286921213552,287.03256746082087,284.70455751888306,284.973698842632,284.4354161951341,738909,649408.7,40.88142755156077,44.053925795508405,NaN,NaN,NaN,NaN,10.346168843871359,19.374411748966953,749711649,-1.098349142281883,-5.316359811097641,-4.218010668815758
2022-02-22T09:30:00-05:00,278.1663889,285.1763819,267.97973241,269.21306451,NaN,NaN,NaN,310.83629733073406,NaN,NaN,306.297560812,341.88455002284076,270.7105716011592,287.03256746082087,274.1230596066667,274.1230596066667,274.1230596066667,1062936,648482.2,34.19589107354204,43.17501271479697,NaN,NaN,NaN,NaN,10.856917440023407,20.86325803664861,748648713,-2.206491193824405,-6.976124661096264,-4.769633467271859
2022-02-22T13:30:00-05:00,268.94639811,277.32972307,267.08306664,273.79305994,NaN,NaN,NaN,306.30471362683704,NaN,NaN,304.77609566459995,339.2701365854016,270.2820547437983,287.03256746082087,273.6006136174271,274.2729888082462,272.92823842660795,641751,654386.8,37.30532589465289,42.67004924014996,NaN,NaN,NaN,NaN,10.813327367878875,22.298108900880102,749290464,-2.4496168025016916,-7.8316544703989734,-5.382037667897282
2022-02-23T09:30:00-05:00,276.8663902,278.30305543,260.03307368,260.03307368,NaN,NaN,NaN,304.20782089402627,NaN,NaN,303.0794306922,337.8630634884239,268.2957978959761,287.03256746082087,266.12306759666666,266.12306759666666,266.12306759666666,1174599,670484.2,32.35822493253964,42.12757937761876,NaN,NaN,NaN,NaN,11.345945538030383,24.02712762117828,748115865,-3.302653430506516,-9.510354456030427,-6.207701025523911
2022-02-23T13:30:00-05:00,260.20307351,263.24307047,253.59641344,254.82974554,NaN,NaN,NaN,293.1822353281615,NaN,NaN,301.30343246559994,336.6867807192119,265.92008421198796,287.03256746082087,262.68436429012445,267.0179250015,258.3508035787489,739587,685076.4,30.70027975299469,41.71898349765816,NaN,NaN,NaN,NaN,11.224567787456786,25.95606766493292,747376278,-3.939659533338607,-11.13227544219717,-7.192615908858563
2022-02-24T09:30:00-05:00,233.66643334,257.91640912,233.33310034,252.13308156,NaN,NaN,NaN,282.15940414710866,NaN,NaN,299.60363416279995,336.08922932931125,263.11803899628865,287.03256746082087,247.79419700666668,247.79419700666668,247.79419700666668,1824291,722326.4,29.8467611532094,40.86519126989797,NaN,NaN,NaN,NaN,12.178763572638447,28.527115536255458,745551987,-4.238920244031711,-12.4912662138982,-8.25234596986649
2022-02-24T13:30:00-05:00,252.74308096,267.39306633,251.96308173,266.77973361,NaN,NaN,NaN,282.15940414710866,NaN,NaN,298.3057021255999,334.7523777851254,261.8590264660744,281.4846688416567,253.0534055715396,259.930193779623,246.17661736345622,1066998,749691.6,39.65921886894572,40.77438892701658,NaN,NaN,NaN,NaN,12.410993646021415,29.74659620150665,746618985,-3.194329676620697,-12.24525806564236,-9.050928389021664
2022-02-25T09:30:00-05:00,269.99973039,273.13972726,260.91973946,267.14973324,NaN,NaN,NaN,282.15940414710866,NaN,NaN,296.77930364979994,331.9007148311622,261.6578924684377,273.5273534733254,267.06973332,267.06973332,267.06973332,1440153,763568,39.887957315145606,40.001082261099555,NaN,NaN,NaN,NaN,12.397350371305595,30.235681474795967,748059138,-2.2660204075690906,-11.883453898483026,-9.617433490913935
2022-02-25T13:30:00-05:00,267.26306646,270.20306352,265.96973441,269.87306385,NaN,NaN,NaN,282.15940414710866,NaN,NaN,295.533638227,329.9589153571192,261.10836109688074,270.25016475466026,267.58596317884934,268.3381487603642,266.83377759733446,678336,770229.3,41.64149913155964,39.29638581538905,NaN,NaN,NaN,NaN,11.814205995498053,30.68983208570747,748737474,-1.3039087052170917,-11.2473193724353,-9.943410667218208
2022-02-28T09:30:00-05:00,271.96639509,292.26304149,271.88306184,289.2530445,244.78918488126087,244.78918488126087,244.78918488126087,NaN,NaN,NaN,294.9397721534,328.74794080314524,261.13160350365473,263.7034177047282,284.46638261,284.46638261,284.46638261,1432740,783802.1,52.30430449650558,39.61055498326562,NaN,NaN,NaN,NaN,12.56961825581962,29.004876679625262,750170214,0.6949145864881459,-9.074767434108026,-9.769682020596171
2022-02-28T13:30:00-05:00,289.16304459,290.63970978,284.18638289,290.2530435,250.94390164733994,NaN,NaN,NaN,NaN,NaN,294.4583726342,327.83150100729574,261.0852442611042,259.0065526194615,285.70367650936254,287.5164910556336,283.8908619630915,667431,779498.2,52.78369591317865,39.674935869084784,NaN,NaN,NaN,NaN,12.132740301118217,27.440275231120353,750837645,2.0641956572849214,-7.18943744899002,-9.253633106274942
2022-03-01T09:30:00-05:00,289.83971058,296.39970403,285.58304816,287.29304646,254.70492127450626,NaN,NaN,NaN,NaN,NaN,294.297372795,327.72949439780206,260.86525119219795,265.6848503665692,289.75859955,289.75859955,289.75859955,1046250,793693.1,51.14502824471044,40.19001513560929,NaN,NaN,NaN,NaN,12.03873427032406,25.517930712328234,749791395,2.7096894684681914,-5.866521270689702,-8.576210739157894
2022-03-01T13:30:00-05:00,287.24637984,290.74970967,284.69638238,288.15971226,254.70492127450626,NaN,NaN,NaN,NaN,NaN,293.8561732356,327.01729778539567,260.69504868580435,265.6848503665692,289.23310730867195,290.07988782862867,288.3863267887152,402927,798549.4,51.61863109395775,40.8185594231537,NaN,NaN,NaN,NaN,11.611205200300915,23.804457148824795,750194322,3.1057223474591016,-4.694057804834017,-7.799780152293119
2022-03-02T09:30:00-05:00,291.0197094,295.33303843,281.66638541,287.57304618,254.70492127450626,NaN,NaN,NaN,NaN,NaN,293.4676402904,326.45846318083017,260.4768173999699,266.42087465940426,288.19082334,288.19082334,288.19082334,1098081,812708.1,51.256406695322966,41.827475151273255,NaN,NaN,NaN,NaN,11.758022901707992,22.37991719764827,749096241,3.224810434296974,-3.7687671094219013,-6.993577543718875
2022-03-02T13:30:00-05:00,288.46637862,294.4630393,286.89638019,293.1530406,255.55704067938183,NaN,NaN,NaN,NaN,NaN,293.20650721780004,325.9958462750376,260.4171681605625,267.5499787285234,289.5008327188269,291.12082309938523,287.8808423382686,718056,824754.5,54.52507377752276,42.802021310270554,NaN,NaN,NaN,NaN,11.45863977372885,21.057130100127207,749814297,3.550263967804555,-2.555747583963182,-6.106011551767737
2022-03-03T09:30:00-05:00,292.73304102,295.41970501,282.86305088,285.42638165,255.55704067938183,NaN,NaN,NaN,NaN,NaN,292.5169745730001,324.47108362904413,260.56286551695604,267.61092948781874,287.90304584666666,287.90304584666666,287.90304584666666,994776,833126.6,49.56829236631495,43.900049974040044,NaN,NaN,NaN,NaN,11.537069370605357,19.658576683452967,748819521,3.1307112522767175,-2.1926224864218398,-5.323333738698557
2022-03-03T13:30:00-05:00,285.25638182,285.66638141,277.6663894,279.79305394,255.55704067938183,NaN,NaN,NaN,NaN,NaN,291.8514419042001,323.4497343080051,260.2531495003951,267.61092948781874,285.4178752272733,288.71559288109887,282.1201575734478,564951,840878.2,46.2659439670592,44.54009412206907,NaN,NaN,NaN,NaN,11.284420987704973,18.828392883041143,748254570,2.392652684760497,-2.3325178827479363,-4.7251705675084335
2022-03-04T09:30:00-05:00,282.99971741,285.09304865,275.12639194,282.38638469,255.55704067938183,NaN,NaN,NaN,NaN,NaN,291.8015086208001,323.4515388580862,260.151478383514,267.61092948781874,280.86860842666664,280.86860842666664,280.86860842666664,1002252,854368.3,47.98398520628092,45.65621985590773,NaN,NaN,NaN,NaN,11.190294967868903,18.27989144929556,749256822,2.013203853885538,-2.2086657501515106,-4.221869604037049
2022-03-04T13:30:00-05:00,282.76305098,283.86971654,276.17639089,279.7663873,255.55704067938183,NaN,NaN,NaN,NaN,NaN,291.86957521940013,323.4009207540962,260.33822968470406,267.61092948781874,280.5207541036393,280.9711850888677,280.07032311841095,597744,856620.2,46.37090068336039,46.775549922362416,NaN,NaN,NaN,NaN,10.940511445163983,17.77056868938895,748659078,1.5411250718140614,-2.295463264269472,-3.8365883360835333
2022-03-07T09:30:00-05:00,285.99638108,288.71304504,272.53306119,273.1663939,255.55704067938183,NaN,NaN,NaN,NaN,NaN,291.77337531560016,323.502412540098,260.0443380911023,267.61092948781874,278.1375000433333,278.1375000433333,278.1375000433333,1208067,864217.2,42.49538168633286,47.679022817585526,NaN,NaN,NaN,NaN,11.31475947408084,16.744636604636053,747451011,0.7782281975644283,-2.863803089127998,-3.6420312866924265
2022-03-07T13:30:00-05:00,272.84972754,273.89639317,268.22973216,268.22973216,255.55704067938183,NaN,NaN,NaN,NaN,NaN,291.4969089250002,323.7956944109143,259.1981234390861,267.61092948781874,276.09931478601715,279.5906992745347,272.6079302974996,411702,840578,39.81494813501474,47.69014633659045,NaN,NaN,NaN,NaN,10.911323869503637,16.22308499803687,747039309,-0.02257930679084197,-3.670255420180979,-3.647676113390137
2022-03-08T09:30:00-05:00,265.17640187,283.32638375,260.93640611,279.24972115,255.55704067938183,NaN,NaN,NaN,NaN,NaN,290.93690948420016,323.09440655835283,258.7794124100475,267.61092948781874,274.5041703366667,274.5041703366667,274.5041703366667,1182972,850896,47.739414963956754,48.25096474007696,NaN,NaN,NaN,NaN,11.731227710253377,15.394365245795768,748222281,0.21319882775517573,-3.3811775786961675,-3.5943764064513433
2022-03-08T13:30:00-05:00,279.00972139,281.33305241,274.49305924,274.74972565,255.55704067938183,NaN,NaN,NaN,NaN,NaN,290.19191022820013,322.08791724359446,258.2959032128058,267.61092948781874,275.26681166054584,276.36861611175783,274.16500720933385,566769,852033.4,45.12648072075163,48.49989199644782,NaN,NaN,NaN,NaN,11.381853814520994,14.62483976157189,747655512,0.09539380345338255,-3.475134152134615,-3.5705279555879974
2022-03-09T09:30:00-05:00,279.82305391,285.92638115,277.47638959,284.46471595,255.55704067938183,NaN,NaN,NaN,NaN,NaN,289.65967742640015,321.02770941279476,258.29164544000554,267.61092948781874,282.62249556333336,282.62249556333336,282.62249556333336,853554,853613.6,51.32100508982102,48.42965632454178,NaN,NaN,NaN,NaN,11.367196792055207,14.371378692848547,748509066,0.6690950024503928,-2.7341592025250065,-3.4032542049753993
2022-03-09T13:30:00-05:00,284.18971622,286.8530469,282.86638421,286.19971421,255.55704067938183,NaN,NaN,NaN,NaN,NaN,289.17987790540013,320.00635668353766,258.3533991272626,267.61092948781874,283.3112468855073,284.48348909252405,282.1390046784905,294660,853976.6,52.35543221124446,48.39906606011791,NaN,NaN,NaN,NaN,10.84001578476555,14.228066649011803,748803726,1.135355088530618,-1.9840603443121267,-3.119415432842745
2022-03-10T09:30:00-05:00,283.99304975,284.03304971,270.28639677,271.34639571,255.55704067938183,NaN,NaN,NaN,NaN,NaN,288.56607851820013,319.5658253092323,257.56633172716795,262.1999826148973,275.2219473966667,275.2219473966667,275.2219473966667,1041243,869638.7,43.7785606208197,47.87288980126857,NaN,NaN,NaN,NaN,11.202394474425153,13.731702810167745,747762483,0.448615716148244,-2.55864578765744,-3.007261503805684
2022-03-10T13:30:00-05:00,271.34639571,279.85638722,270.34306338,279.4663876,255.55704067938183,NaN,NaN,NaN,NaN,NaN,288.1180122988001,318.9829874847004,257.25303711289985,262.1999826148973,275.66781050523855,276.2968491687399,275.0387718417372,523119,871802.2,48.72392937976762,47.66612539311213,NaN,NaN,NaN,NaN,11.081746571966212,13.270793531241118,748285602,0.5402791464813994,-2.3319125707039348,-2.872191717185334
2022-03-11T09:30:00-05:00,280.58971982,281.0097194,265.74306797,268.5230652,255.55704067938183,NaN,NaN,NaN,NaN,NaN,287.39594635320015,318.37135728501744,256.42053542138285,262.1999826148973,271.7586175233334,271.7586175233334,271.7586175233334,1296897,889691.3,43.20776944378656,47.0912227322881,NaN,NaN,NaN,NaN,11.380668347540052,13.299931206183901,746988705,-0.10278236316812306,-3.000669671145488,-2.897887307977365
2022-03-11T13:30:00-05:00,268.71639834,268.73306499,264.63306908,265.09306862,255.55704067938183,NaN,NaN,NaN,NaN,NaN,286.75514699300015,318.22008273685293,255.29021124914738,262.1999826148973,269.7669865779739,272.44981958499693,267.0841535709509,714720,897583.6,41.617397733348966,46.16924587198997,NaN,NaN,NaN,NaN,10.860620316287193,13.435631100313028,746273985,-0.692927721136964,-3.76404695939857,-3.071119238261606
2022-03-14T09:30:00-04:00,260.38307333,266.69973369,252.08308161,253.23974713,NaN,NaN,NaN,293.37554569534853,293.37554569534853,293.37554569534853,285.6483480982002,317.84927770747845,253.44741848892193,262.1999826148973,257.3408541433334,257.3408541433334,257.3408541433334,991776,899274.9,36.6033477103736,45.2431783965656,NaN,NaN,NaN,NaN,11.128908299409536,14.631615805410839,745282209,-1.7549474604469504,-5.264803563820294,-3.5098561033733437
2022-03-14T13:30:00-04:00,253.78307992,256.66307704,252.01308168,255.42307828,NaN,NaN,NaN,287.4115741341963,NaN,NaN,284.60461580700013,317.27025005977686,251.9389815542234,262.1999826148973,256.54787311886844,257.758463883906,255.33728235383086,425544,888829.4,38.08309386307309,44.65868910342373,NaN,NaN,NaN,NaN,10.666128803737427,15.747459180188866,745707753,-2.1572698310599723,-6.2064433921983095,-4.049173561138337
2022-03-15T09:30:00-04:00,258.3030754,266.99973339,252.22641481,262.68640436,NaN,NaN,NaN,287.4115741341963,NaN,NaN,283.72841668200016,316.34843387560056,251.10839948839975,262.1999826148973,260.63751752,260.63751752,260.63751752,943485,884847.7,42.86116782755551,44.292773576371914,NaN,NaN,NaN,NaN,10.959499502041897,15.441571145188465,746651238,-1.7959060050078692,-6.294056067398174,-4.498150062390304
2022-03-15T13:30:00-04:00,262.58307113,268.50639855,262.58307113,267.26306646,NaN,NaN,NaN,287.4115741341963,NaN,NaN,283.0256840504002,315.5201369606328,250.53123114016753,262.1999826148973,262.42345112026567,264.9919813478298,259.85492089270156,456138,878660.6,45.70436219910316,44.24516368463925,NaN,NaN,NaN,NaN,10.599772924753188,14.98124994883741,747107376,-1.142185140440203,-5.925881487940558,-4.783696347500355
2022-03-16T09:30:00-04:00,269.33306439,280.17972023,268.11639894,274.39639267,NaN,NaN,NaN,287.4115741341963,NaN,NaN,282.3626180458002,314.17415457900154,250.5510815125989,262.1999826148973,274.23083728,274.23083728,274.23083728,1216560,880059.3,49.88969641488044,44.77332902239266,NaN,NaN,NaN,NaN,10.765264413699386,14.482528313071901,748323936,-0.17372607432914577,-5.000853940411787,-4.827127866082641
2022-03-16T13:30:00-04:00,274.47639259,280.66638641,267.56639949,280.13305361,NaN,NaN,NaN,287.4115741341963,NaN,NaN,281.8208185870002,312.83297997112936,250.80865720287102,256.35393956191785,275.0992086240374,276.04160783181817,274.1568094162566,1032939,889837.7,53.02570508939025,45.716954519133765,NaN,NaN,NaN,NaN,10.932030307006572,13.958873304215293,749356875,0.8525006166667763,-3.7615020952491705,-4.614002711915947
2022-03-17T09:30:00-04:00,276.74972365,288.49637859,275.42972497,288.01637907,248.28642672850785,248.28642672850785,248.28642672850785,NaN,NaN,NaN,281.33955240100016,311.183321376793,251.49578342520732,260.04906582788595,283.98082754333336,283.98082754333336,283.98082754333336,1011594,862747.8,57.00749154285877,46.37895998905534,NaN,NaN,NaN,NaN,11.084503400791817,14.185055827841216,750368469,1.9961905302125293,-2.118764549150285,-4.114955079362814
2022-03-17T13:30:00-04:00,287.89971252,291.66637542,287.89971252,290.82637626,257.12353875266655,NaN,NaN,NaN,NaN,NaN,280.94275279720017,309.724966372157,252.16053922224336,267.02519376030875,286.338806690147,289.32903939183666,283.34857398845736,629037,848149.1,58.36232308223203,47.32437730058965,NaN,NaN,NaN,NaN,10.561800507878118,14.659928630175086,750997506,2.825232320907991,-0.5834146782278253,-3.4086469991358164
2022-03-18T09:30:00-04:00,291.49637559,301.23303254,289.46304429,300.03636706,262.5680577643636,NaN,NaN,NaN,NaN,NaN,280.8427528970002,309.32258692355816,252.36291887044223,275.635093087247,296.91081463,296.91081463,296.91081463,1496877,850039.9,62.53017406206592,48.12503222717857,NaN,NaN,NaN,NaN,10.648099632315393,15.81874427907611,752494383,3.8155923880462788,1.3608434859220324,-2.4547489021242463
2022-03-18T13:30:00-04:00,299.86970056,302.53636457,297.41970301,301.53303224,267.9903256834834,NaN,NaN,NaN,NaN,NaN,280.8422862308002,309.32076333407014,252.36380912753026,279.49968222779756,298.29264435426137,300.03768558943193,296.5476031190908,938607,858715.6,63.175257004024665,48.8978768552343,NaN,NaN,NaN,NaN,10.252996912864294,16.98505795787517,753432990,4.3542043861920625,2.9880065806158314,-1.366197805576231
2022-03-21T09:30:00-04:00,305.33302844,314.13968631,302.5730312,304.2396962,276.1035481892341,NaN,NaN,NaN,NaN,NaN,281.0524193542002,310.05842589049644,252.04641281790396,289.4070134012381,306.9841379033333,306.9841379033333,306.9841379033333,934098,842094.2,64.3699190327825,50.368688170374504,NaN,NaN,NaN,NaN,10.42111528123113,18.790985944495088,754367088,4.64872969835155,4.444714317363207,-0.20401538098834315
2022-03-21T13:30:00-04:00,304.26636284,309.29635782,304.22636288,306.94636016,276.1035481892341,NaN,NaN,NaN,NaN,NaN,281.4580856158002,311.3212990543862,251.5948721772142,289.4070134012381,306.94070658188195,307.0121977124032,306.86921545136073,344742,831337.9,65.572717222632,51.572173016293384,NaN,NaN,NaN,NaN,10.038892399714621,20.467919074927867,754711830,4.764231305612445,5.751273751027213,0.9870424454147682
2022-03-22T09:30:00-04:00,310.32302346,317.59968286,307.52635959,317.57634955,281.06298312805217,NaN,NaN,NaN,NaN,NaN,281.93908513560024,313.30143370810885,250.5767365630916,294.4161128723923,314.23413066666666,314.23413066666666,314.23413066666666,979782,829122.3,69.87402259752834,53.47690538441778,NaN,NaN,NaN,NaN,10.082780278306434,22.47931933965967,755691612,5.256259009557747,7.557366207361952,2.301107197804205
2022-03-22T13:30:00-04:00,317.50301629,332.59966788,317.40301639,331.35966912,292.8608532938226,NaN,NaN,NaN,NaN,NaN,282.7277510148002,316.91138430989815,248.54411771970229,306.4544861449139,321.2520178555092,327.6696764621474,314.83435924887107,1171626,854745.6,74.34914618448929,55.8148874166421,NaN,NaN,NaN,NaN,10.448056793427403,24.99464355398277,756863238,6.147751158922786,9.985796146457687,3.838044987534902
2022-03-23T09:30:00-04:00,326.75300705,346.72965377,325.6363415,332.98300083,302.6270793406942,NaN,NaN,NaN,NaN,NaN,283.2652838114002,319.6752752636925,246.8552923591079,315.26685224693114,335.1163320333333,335.1163320333333,335.1163320333333,1557390,870055.9,74.82349461229715,58.54489790963664,NaN,NaN,NaN,NaN,11.20843218461116,27.789167580305296,758420628,6.452852406444196,11.904110495590146,5.45125808914595
2022-03-23T13:30:00-04:00,332.65633449,336.33299749,328.28633886,333.37300044,302.6270793406942,NaN,NaN,NaN,NaN,NaN,283.7846166262002,322.2404092837394,245.328823968661,315.26685224693114,334.48160480602536,335.5556681199113,333.40754149213944,543891,864250.4,74.9433782028076,61.177775362474826,NaN,NaN,NaN,NaN,10.98259121642465,30.384082747604786,758964519,6.281005556173194,13.302515034362443,7.021509478189249
2022-03-24T09:30:00-04:00,336.57633058,341.24299258,329.65633749,335.7563314,302.6270793406942,NaN,NaN,NaN,NaN,NaN,284.4644159474002,325.295981536159,243.63285035864138,315.26685224693114,335.5518871566667,335.5518871566667,335.5518871566667,869028,860058.8,75.7047393685925,63.52374475826317,NaN,NaN,NaN,NaN,11.025738635965748,32.941446174972796,759833547,5.932119441872892,14.436658780530365,8.504539338657473
2022-03-24T13:30:00-04:00,335.71633144,339.41966107,334.77633237,337.97299585,304.77189736630015,NaN,NaN,NaN,NaN,NaN,285.06474868120023,328.0842662173961,242.04523114500438,315.26685224693114,336.11125862240254,336.9568962425185,335.2656210022866,380247,853902,76.42231815547443,65.71788446943255,NaN,NaN,NaN,NaN,10.569852211968197,35.31614078610023,760213794,5.4664009658607995,15.337540545983472,9.871139580122673
2022-03-25T09:30:00-04:00,335.99966449,340.33966015,332.64966783,334.04299977,304.77189736630015,NaN,NaN,NaN,NaN,NaN,285.85894788800016,330.94989275315027,240.76800302285005,315.9824947680709,335.6774425833333,335.67744639803055,335.677438768636,889479,850142.9,72.3426993666256,67.32167039455722,NaN,NaN,NaN,NaN,10.364147933970468,37.187035660085584,759324315,4.5471434121773875,15.555068845344408,11.00792543316702
2022-03-25T13:30:00-04:00,334.61966586,337.06633009,332.95633419,337.00633015,304.77189736630015,NaN,NaN,NaN,NaN,NaN,286.7554136596002,334.0424472885115,239.46838003068893,315.9824947680709,335.67699051739703,335.67753632579615,335.6764447089979,610134,850555.9,73.49178526673445,68.7835332643675,NaN,NaN,NaN,NaN,9.917422788686864,38.92429518592912,759934449,3.821357482067569,15.784622285751482,11.963264803683913
2022-03-28T09:30:00-04:00,355.03297881,365.41963511,351.52631565,363.48297038,324.9926561582406,NaN,NaN,NaN,NaN,NaN,288.42241199500023,340.3108403796914,236.53398361030906,333.9803984255654,360.14297371333333,360.14297371333333,360.14297371333333,1035282,844796.4,81.06244960061235,70.50174455420705,NaN,NaN,NaN,NaN,11.238557229494944,41.37129410244281,760969731,4.7467375717712805,17.896686768398013,13.149949196626732
2022-03-28T13:30:00-04:00,363.43630376,365.87296799,360.66630652,363.94296992,330.60115143377516,NaN,NaN,NaN,NaN,NaN,289.9917437614002,346.0107747901359,233.9727127326645,338.1182479074523,361.02170392538414,362.49566215066704,359.54774570010125,367959,843338.3,81.16310614302559,72.1303719156923,NaN,NaN,NaN,NaN,10.807707532388164,43.65345851008387,761337690,4.9873865765604855,19.384182417327338,14.396795840766853
2022-03-29T09:30:00-04:00,369.3296312,371.57962896,357.80297605,364.99963553,331.62911336973985,NaN,NaN,NaN,NaN,NaN,291.9074751818002,351.39702178613237,232.417928577468,342.4875264389618,364.79408018,364.79408018,364.79408018,785874,830101.7,81.40757253422855,73.47875752084677,NaN,NaN,NaN,NaN,11.01977505936044,45.89798403191897,762123564,4.8129547561002735,20.412989285892195,15.600034529791921
2022-03-29T13:30:00-04:00,364.68963584,368.43296543,363.46963706,366.06630113,333.7151213836154,NaN,NaN,NaN,NaN,NaN,293.7529400056002,356.5151511492691,230.99072886193125,342.67761922816953,365.12061514973874,365.65331132980566,364.5879189696718,295293,821052.5,81.66623706582378,74.79954181097527,NaN,NaN,NaN,NaN,10.587171724406122,47.98218630219442,762418857,4.377170798639227,21.071498028090957,16.69432722945173
2022-03-30T09:30:00-04:00,363.74630345,371.12296275,361.40630578,368.46963206,334.1687366286783,NaN,NaN,NaN,NaN,NaN,295.9216711732002,361.3122358064569,230.5311065399435,345.6603573035356,366.99963353000004,366.99963353000004,366.99963353000004,633231,813708.4,82.26492937334282,76.077756835301,NaN,NaN,NaN,NaN,10.524992099091397,49.97932434171538,763052088,3.8757473010932344,21.539011355818275,17.66326405472504
2022-03-30T13:30:00-04:00,368.73963179,369.33629786,361.68297217,364.49963603,334.1687366286783,NaN,NaN,NaN,NaN,NaN,298.1150689830002,365.1809562892932,231.04918167670718,345.6603573035356,366.32660428229786,367.2077572185646,365.4454513460311,369426,816200.6,77.7484012963319,76.94744855485101,NaN,NaN,NaN,NaN,10.319873069870582,51.833809664127706,762682662,2.943903210360048,21.3431430676751,18.399239857315052
2022-03-31T09:30:00-04:00,364.9629689,367.66629953,360.65963986,363.44630375,334.1687366286783,NaN,NaN,NaN,NaN,NaN,300.3413334268002,368.53454710815186,232.14811974544855,345.6603573035356,363.9240810466667,363.9240810466667,363.9240810466667,512037,798560.4,76.54757163279709,77.42413062879878,NaN,NaN,NaN,NaN,10.083214969879824,53.366231609768874,762170625,1.9705535532451215,20.862431798871455,18.891878245626334
2022-03-31T13:30:00-04:00,363.28630391,364.99963553,359.02964149,359.33297452,334.1687366286783,NaN,NaN,NaN,NaN,NaN,302.19239824500016,371.6538929544745,232.73090353552584,345.6603573035356,362.6944981849561,364.08556006915893,361.3034363007533,400059,794458.4,71.87879103572419,77.24767668960126,NaN,NaN,NaN,NaN,9.789413474888406,54.476949820370294,761770566,0.8224404618406069,19.91992882292709,19.097488361086484
2022-04-01T09:30:00-04:00,360.38297347,364.86130233,355.63297821,359.17630801,334.1687366286783,NaN,NaN,NaN,NaN,NaN,304.0329297404002,374.55160266217405,233.5142568186264,345.6603573035356,359.89019618333333,359.89019618333333,359.89019618333333,710934,774926.3,71.69941886508886,77.02452842194353,NaN,NaN,NaN,NaN,9.74933566382495,54.861882581064414,761059632,-0.12439451589823847,18.941995216213684,19.066389732111922
2022-04-01T13:30:00-04:00,359.00297485,361.85630533,358.16964235,361.48297237,334.1687366286783,NaN,NaN,NaN,NaN,NaN,305.8651279108002,377.4901536137281,234.24010220787224,345.6603573035356,360.15328000529473,360.4565928168681,359.84996719372134,534855,768930.8,72.77660201671294,76.86975869436534,NaN,NaN,NaN,NaN,9.316287614980311,55.2193201445661,761594487,-0.7379500756953732,18.143952137492704,18.881902213188077
2022-04-04T09:30:00-04:00,363.12297074,381.01961953,357.73297612,381.01961953,337.967130504552,NaN,NaN,NaN,NaN,NaN,307.7004594114002,382.1749479541233,233.22597086867705,354.0564964167364,373.25740505999994,373.25740505999994,373.25740505999994,911595,766258.1,79.79218620646517,77.16171918278482,NaN,NaN,NaN,NaN,10.314170171767431,56.29534871039022,762506082,-0.009189769315792518,18.870415001543336,18.879604770859128
2022-04-04T13:30:00-04:00,381.37961917,383.29295059,379.08962146,381.84295204,350.63662688320875,NaN,NaN,NaN,NaN,NaN,309.5322575822002,386.6584091576657,232.4061060067347,359.62078753438914,375.92272858769735,379.74651950972356,372.09893766567114,442908,766836.9,80.02580124173348,77.41911083180332,NaN,NaN,NaN,NaN,9.8776815259269,57.362647535138755,762948990,0.3284862196191298,19.290212545383042,18.961726325763912
2022-04-05T09:30:00-04:00,378.76962178,384.18628304,363.3629705,368.18963234,350.63662688320875,NaN,NaN,NaN,NaN,NaN,311.1501892998002,389.7228362759681,232.57754232363231,359.62078753438914,371.91296195999996,371.9129695893945,371.91295433060543,846432,763601.8,66.33126271055428,76.9897224992268,NaN,NaN,NaN,NaN,10.659512312646402,55.99332949536203,762102558,-0.5212782088644587,18.31012856468334,18.831406773547798
2022-04-05T13:30:00-04:00,367.30296656,369.53296433,362.43297142,363.80963672,350.63662688320875,NaN,NaN,NaN,NaN,NaN,312.6631877890002,392.3127993673065,233.01357621069386,359.62078753438914,369.7084639544086,372.8405372947298,366.5763906140874,419322,762374.6,62.628632018595624,76.2137829815026,NaN,NaN,NaN,NaN,10.405260926743091,54.60198236142857,761683236,-1.477771253840615,16.98419270624703,18.461963960087644
2022-04-06T09:30:00-04:00,357.66630952,359.49297436,342.6663245,344.4329894,NaN,NaN,NaN,384.04890378004217,384.04890378004217,384.04890378004217,313.8003866534002,393.60810649691877,233.99266680988165,359.62078753438914,348.8640960866667,348.8640960866667,348.8640960866667,1083462,757938,49.4720834276856,73.95732825486498,NaN,NaN,NaN,NaN,11.17226459054716,51.18955861365567,760599774,-3.4047019189812993,14.206086561361019,17.61078848034232
2022-04-06T13:30:00-04:00,344.63965586,354.93631224,344.49632267,348.52965197,NaN,NaN,NaN,382.61924063094926,NaN,NaN,314.9079188808002,395.0749342531666,234.7409035084338,359.62078753438914,349.045048375301,349.2684114529736,348.8216852976284,711081,747209.4,51.778541848004785,71.85843080522064,NaN,NaN,NaN,NaN,11.124483036936649,48.02087941929512,761310855,-4.333099390749894,12.194414241904951,16.527513632654845
2022-04-07T09:30:00-04:00,351.16631601,358.74964177,340.66632649,347.56298627,NaN,NaN,NaN,382.61924063094926,NaN,NaN,316.1506509732002,396.3775056578727,235.92379628852765,359.62078753438914,348.9929848433333,348.9929848433333,348.9929848433333,978321,746100.3,51.1848156934181,69.69966245944845,NaN,NaN,NaN,NaN,11.621542482869742,44.72302531448935,760332534,-4.900221243467275,10.402237078320752,15.302458321788027
2022-04-07T13:30:00-04:00,347.67298616,355.13964537,344.64965585,352.33631484,NaN,NaN,NaN,382.61924063094926,NaN,NaN,317.60151619120023,397.7696542865086,237.43337809589184,359.62078753438914,349.63523512080434,350.4654938232576,348.8049764183511,585414,744646.2,53.990346437829764,67.72281312887746,NaN,NaN,NaN,NaN,11.54071727123619,41.6607322171697,760917948,-4.833691452526356,9.260344006130083,14.094035458656439
2022-04-08T09:30:00-04:00,347.88965261,349.24965126,340.84965964,344.28965621,NaN,NaN,NaN,378.84529279720385,NaN,NaN,318.8395816216002,398.70553962693583,238.97362361626455,359.62078753438914,344.79632237000004,344.79632237000004,344.79632237000004,872232,723824.7,48.88936837151821,65.33884448589,NaN,NaN,NaN,NaN,11.536855694719318,38.922929837469006,760045716,-5.180613361489943,7.618268756794009,12.798882118283952
2022-04-08T13:30:00-04:00,344.26298957,345.79632137,341.66632549,341.74632541,NaN,NaN,NaN,376.55397669960365,NaN,NaN,320.0791803838002,399.4029799616352,240.7553808059652,359.62078753438914,344.18873587258014,345.0133187703649,343.3641529747954,473565,708323.3,47.366098295804534,63.16867998585231,NaN,NaN,NaN,NaN,11.007794279382221,36.38068477060408,759572151,-5.405475375219542,6.042037899259526,11.447513274479068
2022-04-11T09:30:00-04:00,326.7363404,335.99966449,326.32634081,329.82967065,NaN,NaN,NaN,364.5964423073489,NaN,NaN,321.21244591880014,399.43436751597045,242.99052432162983,359.62078753438914,330.71855865,330.71856246469724,330.7185548353027,673932,699651.1,40.93105320914562,60.62464295559149,NaN,NaN,NaN,NaN,11.322950730854922,35.348456137212665,758898219,-6.12790843852097,3.7876277263278553,9.915536164848826
2022-04-11T13:30:00-04:00,330.49966998,331.15966932,324.89967557,325.25634188,NaN,NaN,NaN,360.79704581110576,NaN,NaN,322.35297811320015,399.10062025673324,245.60533596966707,354.8368963255113,329.6733471843594,331.3117081493406,328.0349862193782,274287,697302.6,38.75497645920231,58.25865620012564,NaN,NaN,NaN,NaN,10.96131094650814,34.49538051525138,758623932,-6.641737608985462,1.613364153616999,8.255101762602461
2022-04-12T09:30:00-04:00,332.82300099,340.32966016,329.49967098,333.12300069,NaN,NaN,NaN,360.79704581110576,NaN,NaN,323.4304437040002,399.2341708962156,247.6267165117848,342.5034585034091,334.31744394333333,334.31744394333333,334.31744394333333,950880,696339.2,44.24584563918795,56.29768668398986,NaN,NaN,NaN,NaN,11.255025756043276,32.68323263802642,759574812,-6.188853317797973,0.5190351153549955,6.707888433152968
2022-04-12T13:30:00-04:00,332.73966774,333.48966699,325.65967481,328.90300491,NaN,NaN,NaN,360.79704581110576,NaN,NaN,324.51350928920016,399.0408456246455,249.98617295375482,327.2977135887272,332.9452089478081,335.1661092431594,330.72430865245684,363015,669385.5,42.06703933132306,54.1041464921763,NaN,NaN,NaN,NaN,11.010380500611612,31.32245741325308,759211797,-5.9110291108161235,-0.6808979553671861,5.230131155448937
2022-04-13T09:30:00-04:00,327.1696733,339.43966105,324.41634272,338.40966208,NaN,NaN,NaN,360.79704581110576,NaN,NaN,325.59240821180015,399.32709168486167,251.85772473873863,324.9016881003854,334.08855528333333,334.08855528333333,334.08855528333333,845409,645652.8,48.24949760172902,51.85109730612372,NaN,NaN,NaN,NaN,11.297018916996496,29.438492285066182,760057206,-4.868017822822964,-0.8548911230797671,4.0131266997431965
2022-04-13T13:30:00-04:00,338.52966196,342.02299181,336.26633089,340.84299298,NaN,NaN,NaN,360.79704581110576,NaN,NaN,326.6852737872002,399.6680786511761,253.7024689232243,324.9016881003854,335.86582257175587,338.4799194817563,333.2517256617554,390777,640549,49.72832288094629,49.68699170892463,NaN,NaN,NaN,NaN,10.901279060068175,27.430436145590548,760447983,-3.840386432454693,-0.7873563408251698,3.053030091629523
2022-04-14T09:30:00-04:00,332.99966748,337.31299651,327.39633974,328.47300534,NaN,NaN,NaN,360.79704581110576,NaN,NaN,327.8278059798002,399.0775965138751,256.57801544572527,322.81628767430834,331.06078053,331.06078053,331.06078053,806319,638458.7,43.00111577659653,48.02055264221337,NaN,NaN,NaN,NaN,11.08309150149188,26.363330054810675,759641664,-3.8122251879846774,-1.7122513933513233,2.099973794633354
2022-04-14T13:30:00-04:00,328.43967204,332.60633454,328.05633908,328.17967229,NaN,NaN,NaN,360.79704581110576,NaN,NaN,328.8020716736002,398.69942239847796,258.90472094872246,318.44971242475737,330.54537137292135,331.2381757506876,329.8525669951551,446262,640659.2,42.8530722696402,46.608012660145114,NaN,NaN,NaN,NaN,10.61644178424246,25.372445827657934,759195402,-3.6325960119747016,-2.440771220335023,1.1918247916396787
2022-04-18T09:30:00-04:00,329.79300402,336.45966403,324.69634244,331.60300221,NaN,NaN,NaN,360.79704581110576,NaN,NaN,330.0636704138002,397.80742318898615,262.31991763861424,318.44971242475737,330.91966956,330.91966956,330.91966956,481242,627051.3,45.22323655075144,46.304523597506964,NaN,NaN,NaN,NaN,10.698361770367995,24.01897064740477,759676644,-3.1219779600736075,-2.7106476584523307,0.4113303016212768
2022-04-18T13:30:00-04:00,331.68966879,338.19966229,331.58966889,334.64966583,NaN,NaN,NaN,360.79704581110576,NaN,NaN,331.4548023580002,396.6120216682308,266.29758304776965,315.7937605885143,332.1823187005513,334.00485161476064,330.359785786342,230982,614412.9,47.317412154104375,45.985871476514085,NaN,NaN,NaN,NaN,10.406335458198853,22.5678905724439,759907626,-2.447592279143703,-2.6481600473083517,-0.20056776816464894
2022-04-19T09:30:00-04:00,335.13633202,344.7663224,332.21633493,339.74299408,NaN,NaN,NaN,360.79704581110576,NaN,NaN,333.18486729700015,394.41867062559567,271.95106396840464,319.5696004882316,338.90855046999997,338.90855046999997,338.90855046999997,490197,596243.4,50.710045949949,45.95195935198058,NaN,NaN,NaN,NaN,10.559453459041789,21.38836441560354,760397823,-1.569720719602501,-2.162718667667775,-0.5929979480652743
2022-04-19T13:30:00-04:00,340.29299353,343.13632403,339.49966099,342.6663245,NaN,NaN,NaN,360.79704581110576,NaN,NaN,334.9297322214002,392.03350295182423,277.8259614909761,321.16061498058525,340.0093775501786,341.4005349488517,338.6182201515055,306942,594209.5,52.596896835936874,45.85242723755965,NaN,NaN,NaN,NaN,10.064968429110236,20.29309012710892,760704765,-0.74523411224767,-1.5245405883748617,-0.7793064761271917
2022-04-20T09:30:00-04:00,343.26299057,344.6663225,326.03967443,328.52133862,NaN,NaN,NaN,360.79704581110576,NaN,NaN,336.2464309066002,389.53492288157724,282.9579389316232,321.16061498058525,333.0757785166666,333.0757785166666,333.0757785166666,728310,592290.7,43.84993189526453,45.49246748925582,NaN,NaN,NaN,NaN,10.676516974888075,19.79589768535432,759976455,-1.0849906413216652,-2.1355447777792733,-1.050554136457608
2022-04-20T13:30:00-04:00,328.84967163,330.33300348,325.12634201,325.31634182,NaN,NaN,NaN,359.15894448101676,NaN,NaN,337.40749641380023,387.0374477202906,287.7775451073099,321.16061498058525,331.27821194721776,334.0754921329591,328.4809317614764,300756,592472.8,42.13991392870792,45.11916860589178,NaN,NaN,NaN,NaN,10.285813010253216,19.415823528558523,759675699,-1.4360241560775178,-2.8455843315545053,-1.4095601754769875
2022-04-21T09:30:00-04:00,358.20964231,363.53630366,343.3329905,346.6663205,318.2221656265295,318.2221656265295,318.2221656265295,NaN,NaN,NaN,338.85289497040026,385.1562586604237,292.5495312803768,325.13156773629964,351.17853821999995,351.1785436147966,351.1785328252033,1580106,624035.3,54.78834558229368,46.10897520397379,NaN,NaN,NaN,NaN,12.28110935523513,19.77849288890845,761255805,-0.2054099503251643,-1.6663226133834428,-1.4609126630582785
2022-04-21T13:30:00-04:00,346.44632072,346.73632043,332.13800168,336.19633096,318.2221656265295,NaN,NaN,NaN,NaN,NaN,339.9741605174002,383.1447008005526,296.80362023424783,325.13156773629964,347.4455909289703,353.27033663827615,341.6208452196645,648987,633354,49.117739727237186,46.84917258026199,NaN,NaN,NaN,NaN,12.446624312004047,19.137050340288425,760606818,-0.07816828885140881,-1.5586230241225394,-1.4804547352711306
2022-04-22T09:30:00-04:00,338.15299567,344.87965562,331.39966908,336.19633096,318.2221656265295,NaN,NaN,NaN,NaN,NaN,340.9377595552003,381.4982616647008,300.37725744569974,325.13156773629964,337.49188522000003,337.49188522000003,337.49188522000003,1048434,651233.9,49.11773972723719,47.19716501512266,NaN,NaN,NaN,NaN,12.520435899718041,18.480069932525094,760606818,0.01917905357583405,-1.456480918301338,-1.4756599718771721
2022-04-22T13:30:00-04:00,336.14966434,338.53299529,333.98299983,335.13633202,318.2221656265295,NaN,NaN,NaN,NaN,NaN,341.82395867040026,379.82150335348183,303.8264139873187,325.13156773629964,336.92534159311344,337.693393455503,336.1572897307239,570462,656914,48.5279975397035,47.658662030006965,NaN,NaN,NaN,NaN,11.951118725452465,17.870016696744862,760036356,0.024995738482398,-1.4444152987741745,-1.4694110372565725
2022-04-25T09:30:00-04:00,326.17300763,336.17966431,325.27967519,332.66633448,318.2221656265295,NaN,NaN,NaN,NaN,NaN,342.47655801880023,378.6583573074187,306.29475873018174,325.13156773629964,331.37522465999996,331.37522465999996,331.37522465999996,743454,657998,47.10861349736731,47.577170308266844,NaN,NaN,NaN,NaN,11.87603803934872,16.636165657009155,759292902,-0.11690192671822319,-1.6155384456543516,-1.4986365189361284
2022-04-25T13:30:00-04:00,332.66300115,335.36633179,326.48967398,332.7463344,318.2221656265295,NaN,NaN,NaN,NaN,NaN,343.10082406200024,377.4669143730739,308.7347337509266,325.13156773629964,331.43476162908934,331.51167133418613,331.35785192399254,445518,655020.1,47.16251828919506,47.393898551713185,NaN,NaN,NaN,NaN,11.661796594395238,15.490446834397426,759738420,-0.18094425100292333,-1.7248168326897826,-1.5438725816868593
2022-04-26T09:30:00-04:00,332.09300172,333.27633387,295.16637193,296.49970393,NaN,NaN,NaN,352.20761530807545,352.20761530807545,352.20761530807545,342.9460242166002,378.07223213047104,307.8198163027294,325.13156773629964,308.3141365766667,308.3141365766667,308.3141365766667,1826688,685523.2,31.498695517866395,46.57229710466104,NaN,NaN,NaN,NaN,13.550951261938431,16.45518534667825,757911732,-2.510699428754421,-4.682246867629885,-2.1715474388754643
2022-04-26T13:30:00-04:00,296.51970391,299.82636727,291.74970867,291.99970842,NaN,NaN,NaN,333.14901462316294,NaN,NaN,342.6470911818002,379.2183523175056,306.0758300460948,325.13156773629964,303.50374014396385,310.07565324933194,296.93182703859577,978684,703382.4,30.159470333546338,45.665611252082904,NaN,NaN,NaN,NaN,13.159930357514256,17.515700558491503,756933048,-4.106711443671327,-7.304936743464623,-3.198225299793296
2022-04-27T09:30:00-04:00,299.5963675,305.99969444,293.97303979,300.26970016,NaN,NaN,NaN,333.14901462316294,NaN,NaN,342.3009581940002,380.1210851581282,304.4808312298722,325.13156773629964,300.0808114633333,300.0808114633333,300.0808114633333,757836,700429.2,35.58020392351867,44.97682320728057,NaN,NaN,NaN,NaN,13.219934333406096,17.94309147630024,757690884,-4.334851092625249,-8.616789165574858,-4.281938072949608
2022-04-27T13:30:00-04:00,300.7063664,301.106366,292.46304129,293.87303989,NaN,NaN,NaN,333.14901462316294,NaN,NaN,341.5512256094002,381.6281232558211,301.4743279629793,325.13156773629964,298.5779561005665,300.6159949207463,296.5399172803867,412083,700187.9,33.4195555148237,43.98411916161765,NaN,NaN,NaN,NaN,12.893033646019946,18.424178381849394,757278801,-4.619786850118515,-10.056671635597752,-5.436884785479237
2022-04-28T09:30:00-04:00,299.01636808,299.68970074,273.9997264,288.61304514,NaN,NaN,NaN,325.706798194262,NaN,NaN,340.66382649560023,383.3408781071653,297.9867748840352,308.7133723160397,287.4341574266666,287.4341574266666,287.4341574266666,1768842,723033.9,31.714083703289106,42.627264715427664,NaN,NaN,NaN,NaN,13.807100838447093,19.77862883477614,755509959,-4.842315738132196,-11.489779458144483,-6.647463720012286
2022-04-28T13:30:00-04:00,288.34637874,298.3963687,287.57637951,292.34970807,NaN,NaN,NaN,325.706798194262,NaN,NaN,339.8433606482002,384.5773064724058,295.1094148239946,307.7213038588318,289.4491907015308,292.03760872073684,286.8607726823248,1071975,735063.7,34.2798990271214,41.3189077290837,NaN,NaN,NaN,NaN,13.593735720700874,21.036332826779542,756581934,-4.428881584985001,-12.183565701243538,-7.754684116258536
2022-04-29T09:30:00-04:00,300.74969969,311.25635586,296.99970343,300.33303343,NaN,NaN,NaN,325.706798194262,NaN,NaN,339.1348946888002,385.20730709411527,293.06248228348517,306.5313161510654,302.86303090666667,302.86303090666667,302.86303090666667,1387530,748704,39.50947189016528,41.00887487157661,NaN,NaN,NaN,NaN,13.973229439936523,21.02716342311381,757969464,-3.3574046274575338,-11.951439900580453,-8.59403527312292
2022-04-29T13:30:00-04:00,300.51636658,301.91969852,289.99971042,290.086377,NaN,NaN,NaN,325.706798194262,NaN,NaN,338.1771623118002,386.25367160590537,290.10065301769504,306.0869325880819,299.73882701823237,303.9724118112913,295.50524222517345,755622,754377.6,35.59445717128315,40.54134224604627,NaN,NaN,NaN,NaN,13.82656934422677,21.389766329735817,757213842,-3.0853904261947314,-12.450773305866335,-9.365382879671603
2022-05-02T09:30:00-04:00,286.86304689,298.33303543,282.91971749,287.30304645,NaN,NaN,NaN,325.706798194262,NaN,NaN,337.2423632454002,387.37760133111954,287.1071251596809,306.0869325880819,289.51859979,289.51859979,289.51859979,694419,748450.5,34.59175475149729,39.0987286152751,NaN,NaN,NaN,NaN,13.939908529639144,22.0789276089741,756519423,-2.845399175440466,-12.922131848972185,-10.076732673531719
2022-05-02T13:30:00-04:00,287.69637939,301.9730318,286.37971403,300.91636619,NaN,NaN,NaN,325.706798194262,NaN,NaN,336.5205639662002,387.6773808056967,285.3637471267037,290.7978335384655,292.21092045582685,295.57846694164823,288.8433739700055,443862,747460.4,43.04300054863712,38.66481867394653,NaN,NaN,NaN,NaN,14.058009189664919,22.385153862697855,756963285,-1.5851788713796644,-12.0582062627563,-10.473027391376636
2022-05-03T09:30:00-04:00,301.35303242,307.99302579,296.2963708,304.45969598,NaN,NaN,NaN,325.706798194262,NaN,NaN,335.3400984782002,386.6774157609404,284.00278119546005,271.7276958210035,302.91636419,302.91636419,302.91636419,633855,746124.5,45.03374979090077,38.37310510706535,NaN,NaN,NaN,NaN,13.889341032545998,22.130563069295714,757597140,-0.3905918825614858,-10.961267244578494,-10.570675362017008
2022-05-03T13:30:00-04:00,304.66636244,306.75302702,300.16636693,303.04303073,NaN,NaN,NaN,325.706798194262,NaN,NaN,334.12209969440016,385.57678041513583,282.6674189736645,274.4474329998028,303.0835338078589,303.282694732523,302.88437288319477,446577,751867.5,44.36608130706434,38.07582537616255,NaN,NaN,NaN,NaN,13.367720965221285,21.89415733256515,757150563,0.3845901337848616,-10.089937694785931,-10.474527828570793
2022-05-04T09:30:00-04:00,301.10303267,306.84969359,295.21637188,304.28636282,NaN,NaN,NaN,325.706798194262,NaN,NaN,332.90783424020015,384.2559240171782,281.5597444632221,275.1885575188423,302.1174760966667,302.1174760966667,302.1174760966667,691653,743226.6,45.13489928792357,37.93484578977372,NaN,NaN,NaN,NaN,13.243835304134052,21.98701889280764,757842216,1.0251391736765587,-9.193103861475095,-10.218243035151653
2022-05-04T13:30:00-04:00,304.18969625,318.33301546,298.10303566,317.63301616,NaN,NaN,NaN,325.706798194262,NaN,NaN,331.93916854080015,382.57097635039577,281.30736073120454,282.8891167030738,307.5729330316417,312.1160926988075,303.0297733644759,997320,764370.1,52.692497842859034,38.32984432932114,NaN,NaN,NaN,NaN,13.742845625267336,21.029395361898757,758839536,2.3177934201410118,-7.3210012599753895,-9.638794680116401
2022-05-05T09:30:00-04:00,312.99968745,315.00301879,291.2863758,293.27637381,NaN,NaN,NaN,325.706798194262,NaN,NaN,330.43530337580023,381.10443080905236,279.7661759425481,282.8891167030738,299.85525613333334,299.85525613333334,299.85525613333334,1174833,775350.9,41.46670776596056,39.04184520418501,NaN,NaN,NaN,NaN,14.643116677748242,20.600463883193147,757664703,1.5399925358901747,-7.713804010253682,-9.253796546143857
2022-05-05T13:30:00-04:00,293.24304051,294.66637243,285.99638108,290.93637615,NaN,NaN,NaN,325.706798194262,NaN,NaN,328.9640381782002,379.86280937304855,278.0652669833519,282.8891167030738,296.29444135492315,300.8238200786741,291.7650626311722,726102,786528.4,40.57241105303023,39.78562668414814,NaN,NaN,NaN,NaN,14.21646486862337,20.539842953234384,756938601,0.906784969417501,-8.12031533437198,-9.027100303789481
2022-05-06T09:30:00-04:00,295.64637145,295.93303783,281.23305251,290.38971003,NaN,NaN,NaN,325.706798194262,NaN,NaN,327.5029063038002,378.5525043039576,276.4533083036428,282.8891167030738,289.18526679,289.18526679,289.18526679,1302759,803076.4,40.35345637084597,40.126573287528664,NaN,NaN,NaN,NaN,14.251002043721702,20.77695059513493,755635842,0.5097789632148189,-8.389876599770957,-8.899655562985776
2022-05-06T13:30:00-04:00,290.13971028,290.66637642,285.56971484,288.75971166,NaN,NaN,NaN,325.706798194262,NaN,NaN,326.0914410466002,377.44436764648714,274.7385144467133,282.8891167030738,289.00806495384586,289.3542030652167,288.661926842475,341430,799582,39.66608342433923,40.57275385249405,NaN,NaN,NaN,NaN,13.597120582027292,20.99712197689972,755294412,0.21133360716301475,-8.635488554032008,-8.846822161195023
2022-05-09T09:30:00-04:00,278.48305525,281.78971862,265.97306774,269.47639758,NaN,NaN,NaN,314.85985411641803,NaN,NaN,324.2974428380002,377.1472463386999,271.44763933730053,282.8891167030738,272.41306131333334,272.41306131333334,272.41306131333334,981123,816244.7,32.59291380932849,40.635527431496875,NaN,NaN,NaN,NaN,14.2535151061682,22.269097862404116,754313289,-1.1367658833765155,-10.267779515415668,-9.131013632039153
2022-05-09T13:30:00-04:00,269.33306439,269.85306387,260.48640656,262.70973767,NaN,NaN,NaN,305.56281028749,NaN,NaN,322.3219781440002,376.82256926681725,267.8213870211831,282.8891167030738,269.5167918980561,273.38527814826364,265.6483056478486,549945,826876.8,30.535253682035247,40.36805276399072,NaN,NaN,NaN,NaN,13.904453835013332,23.69446075696763,753763344,-2.2707240999749754,-11.969418757007873,-9.698694657032897
2022-05-10T09:30:00-04:00,273.10306063,274.9997254,258.11640892,265.87640117,NaN,NaN,NaN,305.56281028749,NaN,NaN,320.0191137768002,374.133408561205,265.90481899239546,282.8891167030738,266.3308451633333,266.3308451633333,266.3308451633333,992478,843619.5,32.677277876180995,39.880038905848984,NaN,NaN,NaN,NaN,14.117229738226664,24.475221955348278,754755822,-2.5719218176661265,-12.913596929115556,-10.34167511144943
2022-05-10T13:30:00-04:00,265.85973452,272.33306139,263.73973664,266.75973363,NaN,NaN,NaN,305.56281028749,NaN,NaN,317.7174494086002,370.89936581107946,264.53553300612094,282.8891167030738,266.795222308831,267.41065388107626,266.17979073658574,565071,852223.8,33.29518620758486,39.71580526558482,NaN,NaN,NaN,NaN,13.722665096210475,25.200214496701733,755320893,-2.475227028453494,-13.435708897016298,-10.960481868562804
2022-05-11T09:30:00-04:00,264.98306873,269.77973061,251.17641585,252.04974831,NaN,NaN,NaN,301.3626766376249,NaN,NaN,315.3946517280002,369.68939487498824,261.0999085810122,282.8891167030738,257.66863159,257.66863159,257.66863159,1004202,861420.2,28.589325898434822,39.28706034750893,NaN,NaN,NaN,NaN,14.071282929338297,26.486961703652153,754316691,-3.1236973938046884,-14.865103610818664,-11.741406217013976
2022-05-11T13:30:00-04:00,251.47974888,251.8930818,242.46309122,244.77975557,NaN,NaN,NaN,287.51157027500557,NaN,NaN,313.01405410500024,369.0198250240512,257.00828318594927,273.474579604459,253.34638501765042,258.8342169796845,247.8585530556163,622929,872159.3,26.58914884954237,38.11178522614501,NaN,NaN,NaN,NaN,13.750952512242705,28.044271972009632,753693762,-3.7233064701945047,-16.395539304757108,-12.672232834562603
2022-05-12T09:30:00-04:00,233.9064331,252.82641421,226.66644033,242.47642454,NaN,NaN,NaN,281.8138400293235,NaN,NaN,310.9749228078002,369.61865022697583,252.3311953886246,258.53684755125374,240.65642635999998,240.65642635999998,240.65642635999998,2106522,889706.5,25.969235827828655,36.750034228782724,NaN,NaN,NaN,NaN,14.637311181368224,30.03905533460138,751587240,-3.935410822774454,-17.59149636303067,-13.656085540256218
2022-05-12T13:30:00-04:00,242.44309124,243.97975637,235.30309837,242.69975765,NaN,NaN,NaN,280.9798656402633,NaN,NaN,308.8583249214002,369.53169682995684,248.18495301284355,258.53684755125374,240.65774751142675,240.65977884936174,240.65571617349175,891060,897775.6,26.149025191273324,35.44881593479765,NaN,NaN,NaN,NaN,14.211550239841923,31.891354171293713,752478300,-3.723300461052869,-18.310211116572304,-14.586910655519436
2022-05-13T09:30:00-04:00,257.67307603,262.3130714,250.55308314,258.84640819,NaN,NaN,NaN,280.9798656402633,NaN,NaN,307.0839933598,368.3123881549906,245.8555985646094,258.201093407003,257.23752091,257.23752091,257.23752091,1518018,913428.4,37.892800305895804,34.93152315036709,NaN,NaN,NaN,NaN,14.5973904905675,31.754882045339816,753996318,-2.2317446369623646,-17.37659145172239,-15.144846814760026
2022-05-13T13:30:00-04:00,258.64974172,258.99640804,252.77308093,256.39974397,NaN,NaN,NaN,280.9798656402633,NaN,NaN,305.16526194240004,366.61345028946204,243.71707359533804,244.42417024960235,256.838035296317,257.39682655400946,256.27924403862454,775854,920274.8,36.93437374284823,33.80594285750918,NaN,NaN,NaN,NaN,13.999243106241252,31.628157928382635,753220464,-1.197942318161065,-16.642274712461358,-15.444332394300293
2022-05-16T09:30:00-04:00,255.68641135,256.4697439,239.85642716,243.02309066,NaN,NaN,NaN,280.9798656402633,NaN,NaN,303.13993063140003,365.9566997416422,240.32316152115789,239.15458131815643,246.4497539066667,246.4497539066667,246.4497539066667,943098,926929.6,32.14697082096082,33.140247361437766,NaN,NaN,NaN,NaN,14.185962651509735,32.10986036378342,752277366,-1.2000406705593125,-16.944383232499433,-15.74434256194012
2022-05-16T13:30:00-04:00,242.72642429,246.99975336,239.73309395,241.53309215,NaN,NaN,NaN,280.9798656402633,NaN,NaN,301.1356659662,365.2782733379512,236.99305859444883,239.15458131815643,245.32884488546597,247.02728385548332,243.63040591544862,410769,925771.3,31.654782146553146,32.50327386811797,NaN,NaN,NaN,NaN,13.69172670568761,32.56257348212792,751866597,-1.0899978204599456,-17.106839837515054,-16.016842017055108
2022-05-17T09:30:00-04:00,249.05641797,253.54641349,243.11975723,252.45308125,NaN,NaN,NaN,280.9798656402633,NaN,NaN,299.5881341782,364.6144866354582,234.5617817209418,239.15458131815643,249.7064173233333,249.7064173233333,249.7064173233333,932658,895970.3,39.023245371013616,32.408258796701375,NaN,NaN,NaN,NaN,13.571840608138496,32.33290641543123,752799255,-0.12097492241747787,-16.168060670076954,-16.047085747659477
2022-05-17T13:30:00-04:00,251.96308173,254.79307891,248.28308541,253.98641305,NaN,NaN,NaN,280.9798656402633,NaN,NaN,298.1627356016,363.9954955023166,232.32997570088338,233.93528917252513,250.5238622812919,251.74705244363267,249.30067211895116,416535,877232,40.00140224171261,32.43221014079948,NaN,NaN,NaN,NaN,13.067422957557174,31.99675517327556,753215790,0.7368834332928564,-15.125981456043405,-15.862864889336262
2022-05-18T09:30:00-04:00,248.78308491,253.49974687,235.3730983,235.82309785,NaN,NaN,NaN,280.9798656402633,NaN,NaN,296.21673754479997,363.53631468543,228.89716040416994,226.17094524118528,241.56531434000001,241.56531434000001,241.56531434000001,1117437,889218.7,33.206139520067325,32.47601197728083,NaN,NaN,NaN,NaN,13.463558085588804,32.35238252458,752098353,0.22142215195260384,-15.586087199395507,-15.807509351348111
2022-05-18T13:30:00-04:00,235.72309795,238.14642886,233.66643334,236.74309693,NaN,NaN,NaN,274.857168662084,NaN,NaN,294.37353938520005,363.04546739707087,225.7016113733292,226.17094524118528,239.83263113167448,242.34651960491138,237.31874265843757,530847,893177.5,33.81939120666823,32.71059322904032,NaN,NaN,NaN,NaN,12.821875045189604,32.76390029000163,752629200,0.0895599292333209,-15.695559439806459,-15.78511936903978
2022-05-19T09:30:00-04:00,235.66976467,244.55975579,231.43976889,235.89643111,NaN,NaN,NaN,274.857168662084,NaN,NaN,292.3232747658,361.73113256337484,222.9154169682252,226.17094524118528,237.29865193000003,237.29865193000003,237.29865193000003,1294518,877366.7,33.51443085990782,32.770389870735094,NaN,NaN,NaN,NaN,12.843168749104631,32.47418440832222,751334682,0.09209404865438486,-15.670001808221798,-15.762095856876183
2022-05-19T13:30:00-04:00,235.72643128,240.43309325,234.8730988,236.47643053,NaN,NaN,NaN,274.857168662084,NaN,NaN,290.2359435168,359.9582460714148,220.51364096218515,226.17094524118528,237.28740944253792,237.30468144879808,237.27013743627776,548463,859916.3,33.95379606796111,32.81743343219054,NaN,NaN,NaN,NaN,12.3229420134543,32.20516251819135,751883145,0.26956889061275113,-15.425134743610244,-15.694703634222995
2022-05-20T09:30:00-04:00,237.80309587,239.92309376,211.00645597,211.33312231,NaN,NaN,NaN,265.63885766082456,NaN,NaN,287.8931458562,360.1450057201845,215.64128599221556,226.17094524118528,220.75422401333333,220.75422401333333,220.75422401333333,2267058,889233.9,25.948321442833205,32.628790256790424,NaN,NaN,NaN,NaN,13.50820599749328,33.11210580337522,749616087,-1.0948261374639365,-17.063236306052914,-15.968410168588978
2022-05-20T13:30:00-04:00,211.00645597,221.46977885,211.00645597,221.33977898,NaN,NaN,NaN,256.01292228965076,NaN,NaN,285.75634799000005,359.42164068443833,212.0910552955618,226.17094524118528,219.85341416124925,221.16673790795238,218.5400904145461,1066560,899598.5,32.744685305614766,33.06847143222417,NaN,NaN,NaN,NaN,13.29071434624376,33.95426742533167,750682647,-1.1084275143871523,-17.353944561572916,-16.245517047185764
2022-05-23T09:30:00-04:00,218.33978198,226.64310702,212.69978761,222.32311133,NaN,NaN,NaN,256.01292228965076,NaN,NaN,283.57075017240004,358.1443164092087,208.99718393559132,226.17094524118528,220.55533532,220.55533532,220.55533532,1201086,916487.4,33.391629079670494,33.5986423787843,NaN,NaN,NaN,NaN,13.337328993654921,34.17715706315519,751883733,-0.8479857407899729,-17.30549922317323,-16.457513482383256
2022-05-23T13:30:00-04:00,222.07311158,225.38977494,222.07311158,224.98644201,NaN,NaN,NaN,256.01292228965076,NaN,NaN,281.377485696,356.26286736739723,206.4921040246028,226.17094524118528,221.46597651971055,223.0292994356172,219.9026536038039,407541,915276.7,35.20949049673628,34.24581847203165,NaN,NaN,NaN,NaN,12.62156716267957,34.38412601256275,752291274,-0.32028551800495464,-16.857870379889448,-16.537584861884493
2022-05-24T09:30:00-04:00,217.84311581,217.94978237,209.24979105,210.55645641,NaN,NaN,NaN,252.50361768114533,NaN,NaN,278.7937549426,354.3572684875846,203.23024139761543,226.17094524118528,212.58534327666666,212.58534327666666,212.58534327666666,1017183,928054.3,30.37285781289407,33.70867972253153,NaN,NaN,NaN,NaN,12.844073148202456,35.180482650413566,751274091,-0.7428613109906479,-17.466161500622803,-16.723300189632155
2022-05-24T13:30:00-04:00,210.14645682,212.65645432,206.92979337,209.24312439,NaN,NaN,NaN,247.7095071742751,NaN,NaN,276.1252909404,351.9010692881728,200.34951259262726,221.29538255994822,211.7667635037597,213.09554276056642,210.437984246953,386025,926035.9,29.969348111667657,33.211177891732916,NaN,NaN,NaN,NaN,12.335686562616567,36.01924800730952,750888066,-0.9001322596396335,-17.848465514181697,-16.948333254542064
2022-05-25T09:30:00-04:00,207.94979235,222.08311157,207.7664592,221.1531125,NaN,NaN,NaN,247.7095071742751,NaN,NaN,273.97792641800004,349.7780019710352,198.17785086496485,215.59697097356687,217.00089442333334,217.00089442333334,217.00089442333334,970194,935320.6,38.01196975468024,33.630106386998584,NaN,NaN,NaN,NaN,12.477184120286811,35.743846600630825,751858260,-0.03693788655382235,-16.994505612734343,-16.95756772618052
2022-05-25T13:30:00-04:00,221.12311253,222.99977732,217.40644957,219.43311422,NaN,NaN,NaN,247.7095071742751,NaN,NaN,271.860261866,347.7211459405012,195.99937779149877,215.59697097356687,218.06595496650198,219.48117152436876,216.6507384086352,549492,920393,37.344943929209926,34.036546514331214,NaN,NaN,NaN,NaN,11.985480093837753,35.38983783556933,751308768,0.5508646047374732,-16.26898697025868,-16.819851574996154
2022-05-26T09:30:00-04:00,220.33311332,239.5164275,217.8864491,235.62309805,NaN,NaN,NaN,247.7095071742751,NaN,NaN,269.639397417,343.0731745744323,196.2056202595677,214.4828681718535,231.00865821666667,231.0086628886976,231.00865354463576,1500213,931239,46.80689506610936,34.59252149255234,NaN,NaN,NaN,NaN,12.674372829992198,33.491103378456195,752808981,2.0769609072699637,-14.223650440908699,-16.300611348178663
2022-05-26T13:30:00-04:00,235.95309772,237.73309594,233.52310015,235.86976447,NaN,NaN,NaN,247.7095071742751,NaN,NaN,267.6328660872,339.1399284813148,196.12580369308517,210.26860697931983,232.20597121419902,234.2538498851622,230.15809254323585,512814,924129.4,46.93837317174475,35.088019416126066,NaN,NaN,NaN,NaN,12.069774469992755,31.727992811136847,753321795,3.0889620183399416,-12.439408825253736,-15.528370843593677
2022-05-27T09:30:00-04:00,241.08642593,251.71308198,240.30309338,250.67974968,208.28036728164122,208.28036728164122,208.28036728164122,NaN,NaN,NaN,265.92253446160004,334.8317195562002,197.01334936699988,221.81983205645588,247.56530834666668,247.56530834666668,247.56530834666668,1581993,933437.2,54.250064667241666,36.59115692663852,NaN,NaN,NaN,NaN,12.339313258564701,29.933204281561448,754903788,4.648044065922363,-9.718315761190723,-14.366359827113087
2022-05-27T13:30:00-04:00,250.67641635,253.20641383,249.93308376,253.17308053,215.11056158702115,NaN,NaN,NaN,NaN,NaN,264.2832694318001,330.3702343741997,198.19630448940046,227.6551488561647,248.98157276771914,251.0845362766763,246.878609258762,717513,945973.3,55.3651831746824,38.13014206721096,NaN,NaN,NaN,NaN,11.691743030810079,28.373553004881803,755621301,5.671682248662886,-7.276757016284478,-12.948439264947364
2022-05-31T09:30:00-04:00,257.83974253,259.59974078,244.87642214,253.51641352,215.42840476511108,NaN,NaN,NaN,NaN,NaN,262.70027101260007,325.8875951162868,199.51294690891336,231.79706948093175,252.66419214666666,252.66419214666666,252.66419214666666,1145388,951448.8,55.525935649556544,39.70239240932873,NaN,NaN,NaN,NaN,11.908284145752216,27.377061370155225,756766689,6.155919033424571,-5.253540473166652,-11.409459506591222
2022-05-31T13:30:00-04:00,253.1697472,256.63307707,249.61641741,253.19974717,217.0314204412424,NaN,NaN,NaN,NaN,NaN,261.10933926800004,321.086154694442,201.1325238415581,231.79706948093175,252.80022256197046,253.01827297797954,252.58217214596138,445770,947976.3,55.32801093267369,41.229122042522484,NaN,NaN,NaN,NaN,11.558882396769915,26.451747709337692,756320919,6.220534778762616,-3.6337910331379533,-9.85432581190057
2022-06-01T09:30:00-04:00,252.74641429,257.16640987,243.67309001,245.34975501,217.0314204412424,NaN,NaN,NaN,NaN,NaN,260.0863402896,319.3544025817348,200.81827799746523,231.79706948093175,248.72975163,248.72975163,248.72975163,937461,946142.4,50.520464656589674,42.98427512921938,NaN,NaN,NaN,NaN,11.69705650128635,25.028006912704086,755383458,5.523815810840167,-2.9495560483503596,-8.473371859190527
2022-06-01T13:30:00-04:00,245.16642185,250.08308361,244.683089,247.00308669,217.0314204412424,NaN,NaN,NaN,NaN,NaN,259.18640785499997,317.85224434492926,200.52057136507068,231.79706948093175,248.32309196438095,248.9817060845271,247.6644778442348,357399,939220,51.47678508096132,44.322282256029844,NaN,NaN,NaN,NaN,11.247266366194467,23.705961887258592,755740857,4.980320186108012,-2.247971626555511,-7.228291812663524
2022-06-02T09:30:00-04:00,244.15642286,264.13973624,242.23975811,261.35640569,217.0314204412424,NaN,NaN,NaN,NaN,NaN,258.4081419656,315.8938561788149,200.92242775238515,233.52764793874164,255.91196668,255.91196668,255.91196668,1154034,944214.4,58.902963188411135,46.14452040665417,NaN,NaN,NaN,NaN,12.008174349323435,23.541907099643062,756894891,5.360485287347486,-0.5276852034791659,-5.888170490826652
2022-06-02T13:30:00-04:00,261.32640572,262.62640442,257.26640977,258.76307494,224.12868101678737,NaN,NaN,NaN,NaN,NaN,257.7059426666,314.292375339032,201.119509994168,235.4567364539933,257.04415603254193,258.7291819658253,255.35913009925855,521007,940817,57.1996312927226,47.715244749224624,NaN,NaN,NaN,NaN,11.533304370800332,23.389570511142928,756373884,5.2059409276783635,0.6192556687713022,-4.586685258907061
2022-06-03T09:30:00-04:00,243.22475713,247.61641941,233.99976634,235.24643176,224.12868101678737,NaN,NaN,NaN,NaN,NaN,256.63861039899996,312.8649567293712,200.41226406862867,235.4567364539933,238.9542058366667,238.9542058366667,238.9542058366667,1536564,921818.4,44.60359048519149,48.73172565438873,NaN,NaN,NaN,NaN,12.478304672886024,22.220365492681513,754837320,3.3772101966242594,-0.36517251312673693,-3.7423827097509963
2022-06-03T13:30:00-04:00,235.22976511,236.47643053,233.44643356,234.49976584,224.12868101678737,NaN,NaN,NaN,NaN,NaN,255.48161155439993,311.0984715132331,199.86475159556673,235.4567364539933,237.49731520525,239.47688674344508,235.51774366705493,832266,919858.6,44.27024967702985,49.753218623343166,NaN,NaN,NaN,NaN,11.803425551251307,21.174268483579944,754005054,2.040426377859067,-1.1918497374271624,-3.2322761152862296
2022-06-06T09:30:00-04:00,244.59642242,244.63975571,234.38309929,236.84309683,224.12868101678737,NaN,NaN,NaN,NaN,NaN,254.2118128223999,308.5592607049904,199.86436493980943,235.4567364539933,238.62198394333333,238.62198394333333,238.62198394333333,846438,897472.6,45.643229948166386,50.2983086371636,NaN,NaN,NaN,NaN,11.692942041876213,19.78557923689466,754851492,1.27460760938034,-1.6390166035608047,-2.9136242129411447
2022-06-06T13:30:00-04:00,236.89976344,240.84309284,236.69976364,238.24309543,224.12868101678737,NaN,NaN,NaN,NaN,NaN,253.17494719099992,306.7173227118764,199.6325716701234,235.4567364539933,238.61337244821448,238.62584168238914,238.60090321403982,403713,885067.9,46.491393276127965,50.95162644765775,NaN,NaN,NaN,NaN,11.1536839817422,18.496082079258326,755255205,0.8436978003874289,-1.8590019624568583,-2.7026997628442873
2022-06-07T09:30:00-04:00,233.7064333,239.81976053,230.15310351,238.33309534,224.12868101678737,NaN,NaN,NaN,NaN,NaN,252.19554816879992,304.991318446603,199.39977789099686,235.4567364539933,236.10198646,236.10198646,236.10198646,869400,882611.3,46.54913367161256,50.933214919479404,NaN,NaN,NaN,NaN,11.047467770189186,17.59238750394521,756124605,0.5597674292180139,-2.00299047632177,-2.562757905539784
2022-06-07T13:30:00-04:00,238.32976201,239.95642706,237.07976326,238.86642815,224.12868101678737,NaN,NaN,NaN,NaN,NaN,250.95454940799988,301.9991263391007,199.90997247689901,235.4567364539933,236.8892886589339,238.06137115727597,235.71720616059184,392271,881994.7,46.91470427239216,50.93152428381136,NaN,NaN,NaN,NaN,10.463838915175675,16.740604612486706,756516876,0.40986166821186387,-2.050430820274954,-2.460292488486818
2022-06-08T09:30:00-04:00,240.1164269,249.80308389,239.33309435,242.60975774,224.12868101678737,NaN,NaN,NaN,NaN,NaN,249.7175506431999,298.4615241923664,200.97357709403337,235.4567364539933,243.91531199333335,243.91531199333335,243.91531199333335,887913,880503.2,49.524129062187285,50.59395745487891,NaN,NaN,NaN,NaN,10.497611545520272,16.00658693697319,757404789,0.5557385817808522,-1.7656192612607526,-2.321357843041605
2022-06-08T13:30:00-04:00,242.77309091,243.53642348,240.96975938,241.76975858,224.12868101678737,NaN,NaN,NaN,NaN,NaN,248.49208520019994,294.83356490175015,202.1506054986497,235.4567364539933,243.3881644914637,244.21477211518254,242.56155686774486,361107,878655.6,48.942743396276846,50.13521175642137,NaN,NaN,NaN,NaN,9.931115299411681,15.324999095424923,757043682,0.5855952626758447,-1.5893637646967989,-2.1749590273726436
2022-06-09T09:30:00-04:00,249.20308449,255.46307824,244.01308967,246.51642051,224.12868101678737,NaN,NaN,NaN,NaN,NaN,247.33668635399994,290.8506508001655,203.82272190783436,235.4567364539933,248.66419613999997,248.66419613999997,248.66419613999997,1181652,880796.1,52.347069973334214,49.908149922405485,NaN,NaN,NaN,NaN,10.199844182310846,15.619982046940168,758225334,0.8963605421153087,-1.0545083497285077,-1.9508688918438164
2022-06-09T13:30:00-04:00,246.33308736,246.3930873,239.33309435,239.69976065,224.12868101678737,NaN,NaN,NaN,NaN,NaN,245.7780212437999,284.4185083799674,207.1375341076324,233.3089959148162,246.26638266376793,249.53575838537313,242.99700694216273,635610,884288.2,47.45366145844582,49.34569638853207,NaN,NaN,NaN,NaN,9.98437860928864,15.42089171305618,757589724,0.6269158899547889,-1.1672240294003302,-1.794139919355119
2022-06-10T09:30:00-04:00,235.15643185,239.44309424,227.97977235,229.85977047,224.12868101678737,NaN,NaN,NaN,NaN,NaN,244.50968917699993,280.9299631749962,208.08941517900368,233.3089959148162,232.4275456866667,232.4275456866667,232.4275456866667,1520694,891827.4,41.43264906197689,48.696566703202585,NaN,NaN,NaN,NaN,10.108350730053738,14.422348429163694,756069030,-0.18643911899263133,-2.027188818095908,-1.8407496991032768
2022-06-10T13:30:00-04:00,229.84977048,234.49309918,229.03643796,232.27643473,224.12868101678737,NaN,NaN,NaN,NaN,NaN,243.33649034859994,277.40213280858256,209.27084788861728,233.3089959148162,232.2511430095034,232.48717547848784,232.01511054051898,849393,901858.4,43.33428130643877,48.11495929073669,NaN,NaN,NaN,NaN,9.776087193621327,13.495129665549241,756918423,-0.5154532036588482,-2.485066203676837,-1.9696130000179888
2022-06-13T09:30:00-04:00,222.72311093,226.61977371,214.73645224,217.55644942,NaN,NaN,NaN,253.2297230940284,253.2297230940284,253.2297230940284,241.87982513639992,273.9427149668758,209.816935305924,233.3089959148162,219.63755845666665,219.63755845666665,219.63755845666665,928530,857240.8,35.72535691217904,46.459415985291535,NaN,NaN,NaN,NaN,10.33065114336266,13.732175702888485,755989893,-1.6160904373431189,-3.9897260466968874,-2.3736356093537685
2022-06-13T13:30:00-04:00,218.11144887,219.53644745,214.75978555,215.8431178,NaN,NaN,NaN,248.871470963618,NaN,NaN,240.42149325919993,270.3870883025394,210.4558982158605,233.3089959148162,218.76093526956305,220.10077295993025,217.42109757919584,397482,834938.2,34.955992584699885,44.87058464900421,NaN,NaN,NaN,NaN,9.933937625979611,13.952289880417784,755592411,-2.3089312399114883,-5.259799659243129,-2.9508684193316403
2022-06-14T09:30:00-04:00,218.2864487,226.329774,211.82645515,224.02310963,NaN,NaN,NaN,248.871470963618,NaN,NaN,239.51242750019992,268.6433191056664,210.38153589473342,233.3089959148162,220.72644626,220.72644626,220.72644626,997581,828154.7,41.440123100606726,44.644622692962436,NaN,NaN,NaN,NaN,10.260321999123926,13.496401893901618,756589992,-2.073221968734311,-5.542395880249529,-3.469173911515218
2022-06-14T13:30:00-04:00,224.09310956,224.09310956,217.75978256,220.99644599,NaN,NaN,NaN,248.871470963618,NaN,NaN,238.67816166659995,267.4914044132729,209.864918919927,233.3089959148162,220.79723584631876,220.90115164368294,220.69332004895458,462939,830001.3,39.85689358598741,44.32938297217369,NaN,NaN,NaN,NaN,9.979822356329361,13.073077334993751,756127053,-1.9783290488923018,-5.942085222630595,-3.9637561737382936
2022-06-15T09:30:00-04:00,220.83644615,228.70310496,218.50644848,228.329772,NaN,NaN,NaN,248.871470963618,NaN,NaN,237.92722908319996,265.8079563608029,210.04650180559702,233.3089959148162,225.17977514666666,225.17977514666666,225.17977514666666,983112,828865.6,45.30895316494368,44.30550605908635,NaN,NaN,NaN,NaN,9.995310508020122,12.229513038027104,757110165,-1.3110121849469323,-5.6025214049219585,-4.291509219975026
2022-06-15T13:30:00-04:00,228.329772,235.52309815,223.66644332,232.99976734,NaN,NaN,NaN,248.871470963618,NaN,NaN,237.25202975739995,263.91565107696164,210.58840843783827,233.3089959148162,228.05801718362892,230.83109311600927,225.28494125124857,1059093,851301.2,48.51003982353352,44.44969509818675,NaN,NaN,NaN,NaN,10.128263673875827,11.883652226024179,758169258,-0.48687241460241903,-4.90009973822805,-4.413227323625631
2022-06-16T09:30:00-04:00,222.43644455,224.90310876,213.58978672,214.7431189,NaN,NaN,NaN,248.871470963618,NaN,NaN,236.50589716919995,263.5565188627266,209.45527547567335,225.07815835985298,217.74533812666667,217.74533812666667,217.74533812666667,1197339,858872.7,38.91959419957191,43.904727993040986,NaN,NaN,NaN,NaN,10.791243455741839,11.425028476625487,756971919,-1.0696570177816875,-5.75029859585274,-4.680641578071053
2022-06-16T13:30:00-04:00,214.7097856,215.46311818,208.70979159,212.99312065,NaN,NaN,NaN,244.49776302068398,NaN,NaN,235.87016447079998,263.5986881223654,208.14164081923457,216.53115693788237,215.38950518320476,218.04834898213633,212.7306613842732,939984,871889.1,38.14119444425012,43.278048719602275,NaN,NaN,NaN,NaN,10.502820822474565,11.395836251960024,756031935,-1.447870212432469,-6.490479343611639,-5.04260913117917
2022-06-17T09:30:00-04:00,213.43312021,220.95977936,213.21312043,218.44144854,NaN,NaN,NaN,244.49776302068398,NaN,NaN,235.3894649508,263.4742674805097,207.30466242109028,213.4352187283059,217.53811610999998,217.53811992469724,217.5381122953027,1301865,865277.5,42.028588509927054,42.7426529658694,NaN,NaN,NaN,NaN,10.321666385869237,10.841271122148637,757333800,-1.2153551040525423,-6.561803011244848,-5.346447907192306
2022-06-17T13:30:00-04:00,218.62311503,219.09644789,216.01978429,216.6764503,NaN,NaN,NaN,244.49776302068398,NaN,NaN,234.8689988038,263.35428476216754,206.38371284543246,210.4043857759895,217.44783322547653,217.57658280846704,217.31908364248602,640155,869522.2,41.126915845240134,42.184379569366776,NaN,NaN,NaN,NaN,9.804166186878579,10.326317787323777,756693645,-1.0698037351489296,-6.683702576128468,-5.613898840979538
2022-06-21T09:30:00-04:00,224.60310906,243.53975681,224.60310906,242.27309141,NaN,NaN,NaN,244.49776302068398,NaN,NaN,234.53753246819997,262.2749510668968,206.80011386950318,212.39319201906824,236.80531909333334,236.80531909333334,236.80531909333334,1846641,878343.8,55.90241829783999,42.43833302111718,NaN,NaN,NaN,NaN,11.02267620995868,11.220042591229495,758540286,0.7622046039982653,-4.661143085981706,-5.4233476899799715
2022-06-21T13:30:00-04:00,242.37975797,243.49975685,236.63309704,236.92976341,NaN,NaN,NaN,244.49776302068398,NaN,NaN,234.14813285699995,261.1847595042158,207.11150620978412,215.1491751122546,237.29849221542804,238.22013836742804,236.37684606342805,528753,872051.8,52.91681107027448,42.82855799339067,NaN,NaN,NaN,NaN,10.725817895675918,12.049929909141948,758011533,1.5789608299434308,-3.4496466525506833,-5.028607482494114
2022-06-22T09:30:00-04:00,234.28309939,246.81975354,233.83309984,239.14642787,207.39817003678402,207.39817003678402,207.39817003678402,NaN,NaN,NaN,234.07059960119997,261.02709382801737,207.1141053743826,217.64596129980367,239.93309375,239.93309375,239.93309375,1177788,873131.8,54.01404713819191,43.727229284548876,NaN,NaN,NaN,NaN,10.887306167413353,13.03372364242028,759189321,2.1954232751997242,-2.2843283884944583,-4.4797516636941825
2022-06-22T13:30:00-04:00,239.06642795,240.81975953,234.8397655,236.02976431,207.39817003678402,NaN,NaN,NaN,NaN,NaN,233.96053304439994,260.83907625116615,207.08198983763373,217.64596129980367,239.14847243813983,240.37544441316817,237.9215004631115,481635,874327.3,52.173041948743624,44.35856933042779,NaN,NaN,NaN,NaN,10.536783871883827,13.947246394750163,758707686,2.3086651306770207,-1.5939202503479066,-3.9025853810249274
2022-06-23T09:30:00-04:00,238.14309553,239.12976122,229.27977105,229.99310367,207.39817003678402,NaN,NaN,NaN,NaN,NaN,233.51133349279996,259.88462029034696,207.13804669525297,217.64596129980367,232.80087864666663,232.80088134406495,232.80087594926832,1510821,893439.3,48.70999856317699,45.2860437340705,NaN,NaN,NaN,NaN,10.487727178892126,14.16751561740552,757196865,1.9089524374685483,-1.5163948341892421,-3.4253472716577904
2022-06-23T13:30:00-04:00,230.03643696,236.66643034,228.66643833,235.03643197,207.39817003678402,NaN,NaN,NaN,NaN,NaN,233.13233387119996,258.8543761122878,207.4102916301121,217.64596129980367,233.02855120188963,233.3406682741056,232.71643412967364,803895,908322.5,51.60040340828524,46.47493022146945,NaN,NaN,NaN,NaN,10.310031809685544,14.303230800273045,758000760,1.9114314911267276,-1.036057907749381,-2.9474893988761086
2022-06-24T09:30:00-04:00,237.52976281,246.026421,236.11976422,244.96642205,209.24120707974495,NaN,NaN,NaN,NaN,NaN,233.31520035519995,259.24036440534945,207.39003630505047,220.6989690533356,242.37086909,242.37087178739833,242.3708663926017,1449462,918170.1,56.76650103105179,47.569671502215535,NaN,NaN,NaN,NaN,10.35860018256515,15.143746731673534,759450222,2.473365383538334,0.14421733054680885,-2.329148052991525
2022-06-24T13:30:00-04:00,244.87975547,245.83308786,243.40642361,245.83308786,213.9038653311202,NaN,NaN,NaN,NaN,NaN,233.49700017379993,259.6423188550371,207.35168149256276,224.35779417766847,243.21692689041816,244.45347746475773,241.9803763160786,678552,923421.6,57.195932082200535,48.80817425194504,NaN,NaN,NaN,NaN,9.792033330239068,15.924225810831134,760128774,2.772459745894512,1.136426629376615,-1.636033116517897
2022-06-27T09:30:00-04:00,249.48975087,251.91641511,243.55309013,244.56642245,217.27458564629654,NaN,NaN,NaN,NaN,NaN,233.67040000059995,259.9914829228625,207.34931707833746,230.55451767413476,246.67864256333334,246.67864256333334,246.67864256333334,928038,903137.4,56.31549985203156,49.5943561581656,NaN,NaN,NaN,NaN,9.689982733793423,17.084230175510516,759200736,2.748669150973595,1.7998033221990966,-0.9488658287744982
2022-06-27T13:30:00-04:00,244.46975588,245.46975489,242.60309108,244.86308882,217.27458564629654,NaN,NaN,NaN,NaN,NaN,233.83813316639996,260.33490781153426,207.34135852126562,230.55451767413476,246.091131830417,247.11351718642678,245.06874647440722,306456,885610.4,56.48445301538275,50.16395710044054,NaN,NaN,NaN,NaN,9.20260281066532,18.03230086454269,759507192,2.617251071428175,2.3226980105107202,-0.2945530609174545
2022-06-28T09:30:00-04:00,244.52308916,249.82975053,233.66643334,234.82643218,217.27458564629654,NaN,NaN,NaN,NaN,NaN,234.30799936379992,260.013175249694,208.60282347790584,230.55451767413476,239.44087201666665,239.44087201666665,239.44087201666665,1166436,896277,49.50820981357811,50.92028678715527,NaN,NaN,NaN,NaN,9.699796694903512,17.779821293185506,758340756,1.7598495439201114,1.9052588689826848,0.14540932506257342
2022-06-28T13:30:00-04:00,234.65309902,235.06643194,232.34643466,232.62643438,217.27458564629654,NaN,NaN,NaN,NaN,NaN,234.53373247179996,259.97630465407485,209.0911602895251,230.55451767413476,237.54597422948564,240.36691381272698,234.7250346462443,526314,900363.7,48.10569630477126,51.63203692004964,NaN,NaN,NaN,NaN,9.201239593838975,17.390106915902575,757814442,0.9884682669397646,1.3809946587372792,0.3925263917975146
2022-06-29T09:30:00-04:00,230.49976983,231.10476923,222.37311128,224.84977548,217.27458564629654,NaN,NaN,NaN,NaN,NaN,234.58426575479996,259.9395146225892,209.22901688701074,230.55451767413476,226.10921866333334,226.10921866333334,226.10921866333334,876723,900607.8,43.42291095069187,51.731631380104275,NaN,NaN,NaN,NaN,9.27638841570762,16.341242125785456,756937719,-0.046702504744357776,0.3341482608670674,0.38085076561142517
2022-06-29T13:30:00-04:00,224.54310911,229.04977128,224.53977578,228.45310521,217.27458564629654,NaN,NaN,NaN,NaN,NaN,234.65359901879998,259.9223000036285,209.3848980339715,230.55451767413476,226.47826726770936,227.04466629525032,225.9118682401684,372207,899939,46.043777575833474,52.082835789432366,NaN,NaN,NaN,NaN,8.93593177887136,15.367296249248133,757309926,-0.46659532577332186,-0.20239339160522718,0.2642019341680947
2022-06-30T09:30:00-04:00,224.33310932,229.34977098,218.92644806,227.16143983,217.27458564629654,NaN,NaN,NaN,NaN,NaN,234.98569868719997,259.4009173447057,210.57048002969427,230.55451767413476,225.14588629,225.14588629,225.14588629,1350108,915345.5,45.23485268333139,51.32086681696747,NaN,NaN,NaN,NaN,9.04217400323769,15.021160491058408,755959818,-0.7901560589171445,-0.7234931394783359,0.06666291943880853
2022-06-30T13:30:00-04:00,227.07977325,228.5297718,222.95477737,224.70310896,217.27458564629654,NaN,NaN,NaN,NaN,NaN,235.29489837859998,258.7717935289649,211.81800322823509,230.55451767413476,225.2160706248742,225.32841040210712,225.10373084764126,526965,920874.1,43.66260174757953,50.659851865346404,NaN,NaN,NaN,NaN,8.794518319434998,14.699748715596517,755432853,-1.1090290578851607,-1.3196234029176424,-0.2105943450324817
2022-07-01T09:30:00-04:00,227.00643999,230.17977015,222.13644485,223.5197768,217.27458564629654,NaN,NaN,NaN,NaN,NaN,235.34223166459998,258.7141959502511,211.97026737894885,230.55451767413476,225.27866393333332,225.27866393333332,225.27866393333332,1416246,928693.9,42.889825128955685,49.86526457897238,NaN,NaN,NaN,NaN,8.74086167518964,14.190876914349243,754016607,-1.324352885770538,-1.8660354522456544,-0.5416825664751163
2022-07-01T13:30:00-04:00,223.61311004,227.29310637,222.84144415,227.25643974,217.27458564629654,NaN,NaN,NaN,NaN,NaN,235.498698175,258.5450251827652,212.4523711672348,230.55451767413476,225.43756839083846,225.67655535483962,225.1985814268373,626127,928377.8,46.13200506442822,49.433761944378425,NaN,NaN,NaN,NaN,8.434490285533238,13.718353098905345,754642734,-1.146485407046567,-1.974789325283325,-0.828303918236758
2022-07-05T09:30:00-04:00,222.96977735,228.80310486,216.28978402,228.7964382,NaN,NaN,NaN,250.39130734022217,250.39130734022217,250.39130734022217,235.362164978,258.48468664776397,212.23964330823608,226.9469050363078,224.62977569333336,224.62977569333336,224.62977569333336,928551,908639.7,47.45594491726227,49.344186683955954,NaN,NaN,NaN,NaN,8.725835325138005,14.00131929805451,755571285,-0.8690702650200917,-1.9146417495118726,-1.045571484491781
2022-07-05T13:30:00-04:00,228.77643822,233.14310053,228.33310533,233.13310054,NaN,NaN,NaN,250.39130734022217,NaN,NaN,235.3074316994,258.43784265821284,212.17702074058715,226.92981205204626,227.1444771543485,230.46779838238407,223.8211559263129,531660,898048.6,51.1006355040523,49.30848897651075,NaN,NaN,NaN,NaN,8.446132459056718,13.655934946359698,756102945,-0.3633457941124958,-1.4997537271324006,-1.1364079330199048
2022-07-06T09:30:00-04:00,230.75643624,234.3680993,227.33310633,229.83977049,NaN,NaN,NaN,250.39130734022217,NaN,NaN,234.89063211559997,257.6460269983918,212.13523723280812,215.88141416266086,230.51365870666663,230.5136625213639,230.51365489196937,740883,891793.7,48.3573924690414,48.707838364938574,NaN,NaN,NaN,NaN,8.345336781266955,13.167428917770355,755362062,-0.22713252209824075,-1.4203235856427057,-1.193191063544465
2022-07-06T13:30:00-04:00,229.99977033,233.55643345,228.58977174,231.43643556,NaN,NaN,NaN,250.39130734022217,NaN,NaN,234.45589921619998,256.62043642774523,212.29136200465473,216.28375448512867,230.77642600159075,231.10775802948655,230.44509397369495,465978,894076.9,49.76539749495906,48.177085894421324,NaN,NaN,NaN,NaN,8.104002847605027,12.713816176937392,755828040,-0.017076490129337873,-1.2145366762061371,-1.1974601860767993
2022-07-07T09:30:00-04:00,233.8064332,244.87975547,232.33310134,243.34642367,NaN,NaN,NaN,250.39130734022217,NaN,NaN,234.2524994192,255.89413247808284,212.61086636031717,224.33995234310294,240.1864268266667,240.1864268266667,240.1864268266667,1568076,913093.4,58.790899455570624,48.35390015181697,NaN,NaN,NaN,NaN,8.485382637776096,12.748927940153745,757396116,0.8864623722951162,-0.08938222070790403,-0.9758445930030202
2022-07-07T13:30:00-04:00,243.17642384,245.33308836,243.17642384,244.44642257,NaN,NaN,NaN,250.39130734022217,NaN,NaN,234.0774329272,255.2394535797473,212.91541227465268,227.82291359848236,241.13365688779675,242.87058417804278,239.39672959755072,466353,913207.2,59.51439299303011,48.570324435934644,NaN,NaN,NaN,NaN,8.033331343649232,12.831233256513958,757862469,1.4854091533229412,0.8809168486506564,-0.6044923046722848
2022-07-08T09:30:00-04:00,242.34309134,254.60641243,241.36642565,251.16308253,221.26143727252597,221.26143727252597,221.26143727252597,NaN,NaN,NaN,234.19369947759998,255.66380382370977,212.72359513149019,233.9782792307859,249.04530687,249.0453095673983,249.04530417260167,1548978,932069.4,63.7046296130802,49.58435442161336,NaN,NaN,NaN,NaN,8.405235303388574,13.830752833790195,759411447,2.21710237806347,2.166885667907053,-0.050216710156417155
2022-07-08T13:30:00-04:00,251.06308263,253.11974725,249.7264173,250.68974967,225.45014559468393,NaN,NaN,NaN,NaN,NaN,234.2674327372,255.93738372823555,212.59748174616448,234.9205757156287,249.77133004200024,250.782140726993,248.7605193570075,799110,923403.3,63.208141459774204,50.66310050411357,NaN,NaN,NaN,NaN,8.047242063860818,14.7588781555467,758612337,2.529740164659038,3.1119584956673805,0.5822183310083424
2022-07-11T09:30:00-04:00,252.10308159,252.95974741,233.88976645,237.49976284,225.45014559468393,NaN,NaN,NaN,NaN,NaN,233.7902998802,254.0586740893342,213.5219256710658,234.9205757156287,241.4497589,241.4497589,241.4497589,1269492,925808.4,51.22697736434229,51.22053381937432,NaN,NaN,NaN,NaN,8.834580556442189,13.864569420877377,757342845,1.7460201942034184,2.7647435737626154,1.018723379559197
2022-07-11T13:30:00-04:00,237.40309627,238.7164283,233.62643338,234.34976599,225.45014559468393,NaN,NaN,NaN,NaN,NaN,233.30203370119997,252.2753638856079,214.32870351679205,234.9205757156287,239.9164278263837,242.49971875526282,237.3331368975046,447255,909384.1,48.84573769180293,51.42067382765784,NaN,NaN,NaN,NaN,8.567110153839174,13.06267804328283,756895590,0.9529574895647506,2.2099202415151353,1.2569627519503848
2022-07-12T09:30:00-04:00,236.99976334,239.74309394,228.38310528,233.32643368,225.45014559468393,NaN,NaN,NaN,NaN,NaN,233.2636337396,252.22883748177205,214.29842999742797,234.9205757156287,233.8175443,233.8175443,233.8175443,949785,897648.1,48.064080608138354,51.622761536572625,NaN,NaN,NaN,NaN,8.766601475707803,12.878403817734815,755945805,0.329159377374604,1.6684119736686398,1.3392525962940358
2022-07-12T13:30:00-04:00,233.33310034,234.71643229,230.63643636,233.19976714,225.45014559468393,NaN,NaN,NaN,NaN,NaN,233.2376337656,252.19955174605133,214.2757157851487,234.9205757156287,233.53432890104398,233.974287592996,233.09437020909195,393582,889429,47.961771402101554,51.9298450833242,NaN,NaN,NaN,NaN,8.431843936728674,12.7072920368688,755552223,-0.09937354578682212,1.2150356640605082,1.3144092098473303
2022-07-13T09:30:00-04:00,225.61310805,241.99975835,225.03977529,241.17642584,NaN,NaN,NaN,259.16853500069834,259.16853500069834,259.16853500069834,233.3243003458,252.3906658507468,214.25793484085318,234.9205757156287,236.07198649333333,236.07198919073164,236.071983795935,1489131,877512,54.52622878771758,52.76101677323577,NaN,NaN,NaN,NaN,9.040996731248056,11.957518202153402,757041354,0.13430815095234427,1.4822943985377606,1.3479862475854163
2022-07-13T13:30:00-04:00,241.02309266,241.65642536,236.86309681,236.91976342,NaN,NaN,NaN,259.16853500069834,NaN,NaN,233.2978337056,252.34047313418316,214.25519427701684,234.9205757156287,236.6589392162753,237.69273649364078,235.6251419389098,480030,875887.9,50.84053442482428,53.09734029897834,NaN,NaN,NaN,NaN,8.737591861158908,11.261299641346247,756561324,-0.010204928521095669,1.3352300869340468,1.3454350154551424
2022-07-14T09:30:00-04:00,234.72976561,236.67976366,229.37977095,233.65643335,NaN,NaN,NaN,259.16853500069834,NaN,NaN,233.20430046579997,252.19295763942787,214.21564329217208,234.9205757156287,233.23865598666666,233.23865598666666,233.23865598666666,1069839,872289.6,48.15323650296417,53.14714684081418,NaN,NaN,NaN,NaN,8.6520490475047,11.178170466035322,755491485,-0.3207721433838324,0.9444698362253519,1.2652419796091843
2022-07-14T13:30:00-04:00,233.48643352,238.65309503,233.15643385,238.24309543,NaN,NaN,NaN,259.16853500069834,NaN,NaN,233.1918338114,252.1664184121212,214.21724921067877,234.9205757156287,234.61812130687716,236.30634376978006,232.92989884397426,714300,880045.1,51.99403349148523,53.21096098277368,NaN,NaN,NaN,NaN,8.426664199825792,10.840947097562694,756205785,-0.2174391621140086,0.9934430269666734,1.210882189080682
2022-07-15T09:30:00-04:00,240.42309326,243.49975685,236.90309677,240.51309317,NaN,NaN,NaN,259.16853500069834,NaN,NaN,233.14990052000002,252.05016800392428,214.24963303607575,234.9205757156287,240.30531559666665,240.30531559666665,240.30531559666665,1277295,872260.9,53.817470564856286,53.60096656104617,NaN,NaN,NaN,NaN,8.295949619838236,10.2169351641363,757483080,-0.007446960310020234,1.2015734886931568,1.209020449003177
2022-07-15T13:30:00-04:00,240.46642655,240.46642655,238.54309514,240.03642698,NaN,NaN,NaN,259.16853500069834,NaN,NaN,233.115233888,251.95840472942598,214.27206304657403,228.86541970250298,240.15431036302633,240.42137574906442,239.88724497698823,408357,859076.3,53.35914086759365,53.85766251623436,NaN,NaN,NaN,NaN,7.844095934849791,9.637495511668934,757074723,0.08312033420214648,1.31292086675586,1.2298005325537136
2022-07-18T09:30:00-04:00,244.93642208,250.47641655,243.9830897,249.00975135,NaN,NaN,NaN,259.16853500069834,NaN,NaN,233.1651005048,252.16243324492578,214.1677677646742,232.08838174451313,247.82308586666667,247.82308586666667,247.82308586666667,1060053,846096,60.22626359743331,53.96018852636741,NaN,NaN,NaN,NaN,8.029516908789093,10.228916009411611,758134776,0.6969735958180625,2.1010175273262917,1.4040439315082291
2022-07-18T13:30:00-04:00,248.94975141,249.03641799,239.64642737,240.45975989,NaN,NaN,NaN,259.16853500069834,NaN,NaN,233.1803004896,252.19972605578155,214.16087492341845,232.08838174451313,246.03766272796113,248.34821311356276,243.7271123423595,632964,844576.4,52.32155431806914,53.44641433529877,NaN,NaN,NaN,NaN,8.126693602447014,10.187831449533745,757501812,0.4867475391446059,2.0124783554389865,1.5257308162943806
2022-07-19T09:30:00-04:00,245.22975512,246.80642022,237.01976332,243.95975639,NaN,NaN,NaN,259.16853500069834,NaN,NaN,233.46230020800002,252.69337177186793,214.2312286441321,232.08838174451313,242.59531331000002,242.59531331000002,242.59531331000002,835035,841476.3,54.92938890195644,52.81961142736135,NaN,NaN,NaN,NaN,8.245262409415085,9.8072993570662,758336847,0.5389176126472905,2.199377832103494,1.6604602194562033
2022-07-19T13:30:00-04:00,244.01308967,247.10641992,243.99642302,245.26642175,NaN,NaN,NaN,259.16853500069834,NaN,NaN,233.72209994840003,253.23103663264487,214.21316326415518,232.08838174451313,243.69413189448315,245.08569096235573,242.30257282661057,520659,848616.4,55.89919720514031,52.297543980601795,NaN,NaN,NaN,NaN,7.8810767751711515,9.490291167730003,758857506,0.6116160840422322,2.4249803245089936,1.8133642404667614
2022-07-20T09:30:00-04:00,246.99975336,250.60308309,243.5497568,246.36975399,NaN,NaN,NaN,259.16853500069834,NaN,NaN,234.29836603980002,253.5639070853427,215.03282499425734,232.7504476699526,246.84086462666664,246.84086462666664,246.84086462666664,909246,840043.4,56.74554699342075,52.69172752553597,NaN,NaN,NaN,NaN,7.821951740516069,9.621126615875728,759766752,0.6790001420678946,2.6621144180516296,1.983114275983735
2022-07-20T13:30:00-04:00,246.41975394,248.83308486,246.11975424,247.29975306,NaN,NaN,NaN,259.16853500069834,NaN,NaN,234.92749874500004,253.79156591204926,216.0634315779508,233.19431121396207,246.99863902798887,247.25571953272825,246.7415585232495,342465,833915.1,57.48616550187254,53.30890094054094,NaN,NaN,NaN,NaN,7.45705023190778,9.742616674868186,760109217,0.7269115484395479,2.8917537115331697,2.164842163093622
2022-07-21T09:30:00-04:00,255.01641202,271.71639534,255.01641202,270.93306279,237.09638225116683,237.09638225116683,237.09638225116683,NaN,NaN,NaN,235.86569780820005,256.9969958131111,214.734399803289,246.99705528316966,265.88862338333337,265.88862338333337,265.88862338333337,2144766,876183.2,71.05120246443853,54.95083821599095,NaN,NaN,NaN,NaN,8.668449663914368,11.902344441206592,762253983,2.2073217477004636,4.923994347719201,2.716672600018738
2022-07-21T13:30:00-04:00,271.07306265,273.11639395,269.83973055,271.71972867,245.95531496793194,NaN,NaN,NaN,NaN,NaN,236.88016346180004,259.8490237616834,213.9113031619167,251.70259020453568,267.26022029632367,269.68832009692767,264.83212049571966,684384,886589.1,71.37856767026723,56.62346652085993,NaN,NaN,NaN,NaN,8.283322073634768,13.997184291448242,762938367,3.044938519984386,6.52284574999922,3.4779072300148344
2022-07-22T09:30:00-04:00,276.27305746,280.78638629,271.10639595,273.91305982,250.26377003166232,NaN,NaN,NaN,NaN,NaN,237.79182921820004,262.8539540912452,212.72970434515486,258.81534812362855,275.26861402000003,275.26861402000003,275.26861402000003,1313802,885378.9,72.3184865985334,57.894342078775345,NaN,NaN,NaN,NaN,8.383084092660857,16.40217752372604,764252169,3.5185856304080296,7.876139268024872,4.357553637616842
2022-07-22T13:30:00-04:00,273.88639318,274.00639306,270.71306301,272.389728,250.26377003166232,NaN,NaN,NaN,NaN,NaN,238.57962843140004,265.4040883923486,211.75516847045148,258.81534812362855,274.3055898147642,275.6709768526212,272.94020277690714,653571,889599.1,70.58474303996454,59.3046426941425,NaN,NaN,NaN,NaN,8.019530232470796,18.571967259138773,763598598,3.4940659275172177,8.725136047013365,5.231070119496147
2022-07-25T09:30:00-04:00,272.216394,273.963059,268.466398,270.40973,250.26377003166232,NaN,NaN,NaN,NaN,NaN,239.69296065340004,267.08258847103394,212.30333283576616,258.81534812362855,270.94639566666666,270.94639566666666,270.94639566666666,527499,859974.2,68.29299631186217,60.743196966206646,NaN,NaN,NaN,NaN,7.839325287294308,20.212846043984296,763071099,3.121483228700429,9.132924155371683,6.011440926671254
2022-07-25T13:30:00-04:00,270.516396,270.699729,267.453066,268.333065,250.26377003166232,NaN,NaN,NaN,NaN,NaN,240.7997595404,268.2566644378149,213.34285464298515,258.81534812362855,270.1858987303885,271.2018742793633,269.16992318141365,295563,848955.4,65.87710891289984,61.734845210593406,NaN,NaN,NaN,NaN,7.511277981059002,21.564351313386094,762775536,2.5369892340761124,9.182677469266395,6.645688235190282
2022-07-26T09:30:00-04:00,266.293067,267.159733,256.26641,259.219741,250.26377003166232,NaN,NaN,NaN,NaN,NaN,241.61532538960003,268.7883481810127,214.44230259818738,258.81534812362855,260.8819613333333,260.8819613333333,260.8819613333333,817482,845253.1,56.44104976500438,61.922243724889704,NaN,NaN,NaN,NaN,7.8366620538405,21.14607947523533,761958054,1.3954680355662692,8.39002327964812,6.99455524408185
2022-07-26T13:30:00-04:00,258.999741,259.234741,257.266409,258.789741,250.26377003166232,NaN,NaN,NaN,NaN,NaN,242.45759120360006,269.0917152868646,215.82346712033555,258.81534812362855,260.115471456526,261.25198769555135,258.97895521750064,371826,839925.3,56.033220827402786,62.113249436304635,NaN,NaN,NaN,NaN,7.41749562142332,20.75768419695248,761586228,0.5156223024960598,7.639083122201924,7.123460819705865
2022-07-27T09:30:00-04:00,263.999736,271.649728,261.916405,269.666397,250.26377003166232,NaN,NaN,NaN,NaN,NaN,243.00545731540006,270.70742010492603,215.3034945258741,258.81534812362855,267.74417666666665,267.74417666666665,267.74417666666665,1139328,853206.8,63.26401869934391,62.33023194358397,NaN,NaN,NaN,NaN,7.806245005607368,21.469387719302706,762725556,0.5663018128538093,7.831338085773126,7.265036272919317
2022-07-27T13:30:00-04:00,269.576397,275.833058,268.916398,274.703059,250.26377003166232,NaN,NaN,NaN,NaN,NaN,243.76092322720007,272.78749276455005,214.73435368985008,258.81534812362855,269.9555809224108,272.613776896508,267.29738494831355,788517,863958.1,66.04854934582512,63.31073158842368,NaN,NaN,NaN,NaN,7.7427032194925545,22.430665737032655,763514073,0.8235743246738938,8.294504178761684,7.470929854087791
2022-07-28T09:30:00-04:00,280.043053,283.21305,272.91306,279.533054,253.61715057913858,NaN,NaN,NaN,NaN,NaN,244.5686557498001,275.2378610476928,213.8994504519074,262.92220039182257,278.55305466666664,278.55305466666664,278.55305466666664,1296852,854917.3,68.51331615739319,64.28101210666917,NaN,NaN,NaN,NaN,7.925366560957374,23.80393070304694,764810925,1.1817825796406805,8.948158078638642,7.766375498997961
2022-07-28T13:30:00-04:00,279.434721,281.976385,279.391387,280.923052,256.99665932554143,NaN,NaN,NaN,NaN,NaN,245.4665215036001,277.6732577358317,213.25978527136843,264.45120631345804,279.1200061349322,280.0853260252548,278.15468624460965,447342,854283.6,69.2061571402063,65.23150924488816,NaN,NaN,NaN,NaN,7.543911663746131,25.079105314345924,765258267,1.362251440696296,9.469189799868332,8.106938359172036
2022-07-29T09:30:00-04:00,280.676386,289.093044,279.119721,288.026379,260.1358493561986,NaN,NaN,NaN,NaN,NaN,246.62718701020012,280.65127356535277,212.6031004550475,270.08623955076644,285.413048,285.413048,285.413048,1201902,842714.4,72.53243908038307,66.35914439395691,NaN,NaN,NaN,NaN,7.717441044907122,26.695196848297503,766460169,1.7833626799386355,10.33614170909533,8.552779029156694
2022-07-29T13:30:00-04:00,288.259712,298.289702,288.103045,297.149703,268.9158659990987,NaN,NaN,NaN,NaN,NaN,247.86945243080012,284.54260192705516,211.1963029345451,277.95259694061315,289.8245922171245,294.37301958467657,285.27616484957247,1130649,853765.7,76.1028432059469,67.68890708710508,NaN,NaN,NaN,NaN,7.899289755985181,28.666796744697066,767590818,2.4580753979703687,11.625373276619655,9.167297878649286
2022-08-01T09:30:00-04:00,301.274699,311.826355,297.256369,297.379703,279.3631522945942,NaN,NaN,NaN,NaN,NaN,248.9177180498001,288.1089343721528,209.72650172744738,288.2183449524905,302.1541423333333,302.1541423333333,302.1541423333333,1302630,854870.3,76.18688067964491,68.0557412453341,NaN,NaN,NaN,NaN,8.383387059129095,31.041297290809165,768893448,2.683217441938023,12.521319681071816,9.838102239133793
2022-08-01T13:30:00-04:00,297.666369,301.519698,294.999705,297.356369,279.3631522945942,NaN,NaN,NaN,NaN,NaN,249.9481836726001,291.40475174357925,208.4916156016209,288.2183449524905,301.1543245830703,302.94182325292803,299.3668259132126,407541,853546.5,76.15761988212245,68.39710211760948,NaN,NaN,NaN,NaN,8.250287483477017,32.91040602636245,768485907,2.592492199704415,13.078717488764312,10.486225289059897
2022-08-02T09:30:00-04:00,293.999706,307.736359,292.833041,303.809696,279.3631522945942,NaN,NaN,NaN,NaN,NaN,251.13304914360006,295.2102466950933,207.0558515921068,288.2183449524905,301.4596986666666,301.4596986666666,301.4596986666666,889947,851551.9,78.60497972939595,68.84613734124251,NaN,NaN,NaN,NaN,8.725503948942945,34.888406772377515,769375854,2.7159599891888924,13.881175275546013,11.165215286357121
2022-08-02T13:30:00-04:00,303.33303,305.463028,299.826367,300.4997,279.3631522945942,NaN,NaN,NaN,NaN,NaN,252.2457813672001,298.3940961482732,206.09746658612696,288.2183449524905,301.6158556382871,301.83723478094413,301.39447649563004,442806,853192.7,74.3872825346973,69.117747305152,NaN,NaN,NaN,NaN,8.504872309732736,36.72512175082007,768933048,2.337944748645217,14.087646222163642,11.749701473518424
2022-08-03T09:30:00-04:00,305.033028,309.466357,301.283032,307.499693,279.8901464014923,NaN,NaN,NaN,NaN,NaN,253.69924658360011,302.08500476264913,205.31348840455112,288.2183449524905,306.0830273333334,306.0830273333334,306.0830273333334,907014,833788.8,77.1763856876249,69.75227511770647,NaN,NaN,NaN,NaN,8.537856930466111,38.58800153646001,769840062,2.3180566067365387,14.647272231939098,12.32921562520256
2022-08-03T13:30:00-04:00,307.343026,309.399691,306.129694,307.406359,282.99262426960627,NaN,NaN,NaN,NaN,NaN,255.1948450760001,305.46875059322406,204.92093955877615,289.4878814732321,306.6070024361236,307.34457604333386,305.8694288289133,457746,833046,77.05589825189354,70.55076007049175,NaN,NaN,NaN,NaN,8.161581221147106,40.31781848026852,769382316,2.065715283703769,14.91135972983227,12.845644446128501
2022-08-04T09:30:00-04:00,311.013022,313.46302,304.999695,308.229692,284.4312025982605,NaN,NaN,NaN,NaN,NaN,256.8624434064001,308.5121460032771,205.212740809523,293.30190987858566,308.89746899999994,308.89746899999994,308.89746899999994,862449,826133,77.39121471946973,72.04720042438213,NaN,NaN,NaN,NaN,8.183134348208027,42.08815327026728,770244765,1.7346963226924466,15.01401484949406,13.279318526801614
2022-08-04T13:30:00-04:00,308.133025,309.219691,306.393027,308.563025,284.4312025982605,NaN,NaN,NaN,NaN,NaN,258.4646418022001,311.4428674310042,205.48641617339604,293.30190987858566,308.6430884949745,309.02868843239565,308.25748855755336,375342,814834.4,77.53436427592945,73.58299638499116,NaN,NaN,NaN,NaN,7.800529323336024,43.73203557526612,770620107,1.3364919242713675,14.949933432140824,13.613441507869457
2022-08-05T09:30:00-04:00,302.666364,304.233029,289.56971,292.836374,284.4312025982605,NaN,NaN,NaN,NaN,NaN,259.7781404856001,312.84332038029703,206.71296059090315,293.30190987858566,295.54637099999997,295.54637099999997,295.54637099999997,1639122,826895.3,58.66246180555303,73.25431374972038,NaN,NaN,NaN,NaN,8.600014014526307,42.56118914166792,768980985,-0.1109052674221207,13.474809923591806,13.585715191013927
2022-08-05T13:30:00-04:00,292.90304,293.639706,285.666381,288.116379,284.4312025982605,NaN,NaN,NaN,NaN,NaN,261.04640588640007,313.7275520659899,208.3652597068102,293.30190987858566,293.1647846618875,296.2604937083941,290.0690756153809,970116,845620.6,54.38404645236114,72.42113497161581,NaN,NaN,NaN,NaN,8.555250513488712,40.98225874431427,768010869,-1.4373693752945957,11.789003471895683,13.226372847190278
2022-08-08T09:30:00-04:00,294.906372,305.133028,293.239707,297.853035,284.4312025982605,NaN,NaN,NaN,NaN,NaN,262.53307105040005,315.0895252120476,209.97661688875255,293.30190987858566,298.7419233333333,298.7419233333333,298.7419233333333,927372,841197.9,60.74434950520414,71.86620878217374,NaN,NaN,NaN,NaN,9.159636119668091,40.34755922969066,768938241,-1.6926337796750222,11.110580622596501,12.803214402271523
2022-08-08T13:30:00-04:00,297.746369,298.326368,289.116378,290.376376,284.4312025982605,NaN,NaN,NaN,NaN,NaN,263.7954697756001,315.9325102074487,211.65842934375155,293.30190987858566,296.39300064134585,299.37536434216236,293.41063694052934,575268,839274.7,54.46439930213798,70.81322607945457,NaN,NaN,NaN,NaN,9.163232825406084,39.253275343993145,768362973,-2.3577652757005136,9.85600780764588,12.213773083346394
2022-08-09T09:30:00-04:00,290.293043,291.819708,279.383054,282.729717,NaN,NaN,NaN,312.7717992065052,312.7717992065052,312.7717992065052,264.8741353516001,316.2969200664599,213.4513506367403,293.30190987858566,284.64415966666667,284.64415966666667,284.64415966666667,1065576,846959.4,48.89666632930049,69.12495659723439,NaN,NaN,NaN,NaN,9.397048623591362,37.16774856846595,767297397,-3.2504014110834856,8.150771319492037,11.401172730575523
2022-08-09T13:30:00-04:00,282.729717,285.463048,280.333053,283.319717,NaN,NaN,NaN,309.5329944698459,NaN,NaN,265.8778676808001,316.73937148073753,215.01636388086263,293.30190987858566,284.1837071069314,284.9098370786656,283.45757713519725,428475,843886.6,49.327100171834076,67.21240352336919,NaN,NaN,NaN,NaN,9.092259079049123,35.2311879911907,767725872,-3.705786928343194,6.76893907014653,10.474725998489724
2022-08-10T09:30:00-04:00,297.07637,297.433036,283.499717,292.093041,NaN,NaN,NaN,309.5329944698459,NaN,NaN,267.1229330910001,317.439640915837,216.8062252661632,293.30190987858566,291.00859800000006,291.00859800000006,291.00859800000006,1022421,847659.1,55.34963147429129,65.72402858012963,NaN,NaN,NaN,NaN,9.450906216259899,34.37015199329779,768748293,-3.3325533098554097,6.309034361170461,9.64158767102587
2022-08-10T13:30:00-04:00,291.943041,294.829705,291.159709,294.236372,NaN,NaN,NaN,309.5329944698459,NaN,NaN,268.37893181980013,318.20252013074384,218.55534350885645,293.30190987858566,291.7839563052111,292.90630979829103,290.6616028121312,487950,852508.6,56.7034678572069,64.33444629263566,NaN,NaN,NaN,NaN,9.037984057955617,33.57061856668294,769236243,-2.8750378944099193,6.047790303013471,8.92282819742339
2022-08-11T09:30:00-04:00,296.753037,297.926369,288.193045,290.353043,NaN,NaN,NaN,309.5329944698459,NaN,NaN,269.3190642064001,318.9915250312103,219.64660338158996,291.67747090286855,292.1574856666667,292.1574856666667,292.1574856666667,874794,810176.2,53.53617586126417,62.54381744491197,NaN,NaN,NaN,NaN,9.087651196673075,33.05829532788057,768361449,-2.7667345644287415,5.4644099918874645,8.231144556316206
2022-08-11T13:30:00-04:00,290.356376,291.546375,285.876381,286.803047,NaN,NaN,NaN,309.5329944698459,NaN,NaN,270.1661966950001,319.5569462212798,220.7754471687204,280.7025954222948,291.076613076562,292.87774382889285,289.2754823242312,315039,797864.7,50.745652361925764,60.85512957542829,NaN,NaN,NaN,NaN,8.843532825482145,32.28752088271501,768046410,-2.8554095627160994,4.661882602921082,7.517292165637182
2022-08-12T09:30:00-04:00,289.346377,296.096371,285.103048,295.393038,NaN,NaN,NaN,309.5329944698459,NaN,NaN,271.05079580440014,320.63242637834344,221.4691652304568,278.3758960102687,292.19748566666664,292.19748566666664,292.19748566666664,945528,785588.9,56.6357167121984,59.38793893432639,NaN,NaN,NaN,NaN,8.997089266519133,31.930771231301403,768991938,-2.2816446060188884,4.6652364081135715,6.94688101413246
2022-08-12T13:30:00-04:00,295.483038,300.1597,294.829705,300.013033,NaN,NaN,NaN,309.5329944698459,NaN,NaN,272.03726147100014,321.92097375287034,222.15354918912993,279.3869550937325,294.5652603252627,297.5525453789204,291.57797527160506,594021,783603.9,59.44474483137256,58.12999940428919,NaN,NaN,NaN,NaN,8.735153961767766,31.90351445975127,769585959,-1.5709083667627297,4.983245555679048,6.5541539224417775
2022-08-15T09:30:00-04:00,301.786365,313.096354,301.263032,312.359688,280.4769651678063,280.4769651678063,280.4769651678063,NaN,NaN,NaN,273.53445997420016,323.6748935497928,223.39402639860754,289.93649757498605,308.906358,308.906358,308.906358,764094,791490.4,65.8174133388637,57.303299305674464,NaN,NaN,NaN,NaN,9.045737321641498,32.6954992734961,770350053,-0.31490134102776324,6.1605272461570735,6.475428587184837
2022-08-15T13:30:00-04:00,312.293021,312.466354,308.989691,309.279691,284.7649646147242,NaN,NaN,NaN,NaN,NaN,275.03305847440015,324.8774402356919,225.1886767131084,292.20013735998884,309.280250155239,309.8809198872442,308.6795804232338,296052,791506.7,63.151514744763034,56.27595291059115,NaN,NaN,NaN,NaN,8.647946298667108,33.43091374340201,770054001,0.2332537189654662,6.766995735891669,6.533742016926203
2022-08-16T09:30:00-04:00,311.453022,314.606352,302.889697,308.833024,284.7649646147242,NaN,NaN,NaN,NaN,NaN,276.54319028080016,325.8136683614706,227.27271220012975,292.5350511879911,308.7763576666667,308.77636148136395,308.7763538519694,856779,792816.6,62.75453696137004,56.56824399314951,NaN,NaN,NaN,NaN,8.867139777333744,33.2583428348119,769197222,0.4765270224280993,7.129400794961327,6.652873772533228
2022-08-16T13:30:00-04:00,308.599691,311.133022,305.003028,306.649693,284.7649646147242,NaN,NaN,NaN,NaN,NaN,278.0121887980001,326.39780771351343,229.6265698824868,292.5350511879911,308.4147414381187,308.95911469880247,307.87036817743495,378069,793024.7,60.74447426015947,57.022560265135105,NaN,NaN,NaN,NaN,8.67162936466705,33.09809841969252,768819153,0.40403761808901084,7.157920795144491,6.753883177055481
2022-08-17T09:30:00-04:00,302.98303,305.799694,300.153033,305.749694,284.7649646147242,NaN,NaN,NaN,NaN,NaN,279.30365416120014,327.1314311079755,231.47587721442477,292.5350511879911,303.900807,303.900807,303.900807,669225,777354.6,59.89285278542352,56.961739070865065,NaN,NaN,NaN,NaN,8.516274410047975,32.278364631371886,768149928,0.21841264688098683,7.026898985656715,6.808486338775728
2022-08-17T13:30:00-04:00,305.939694,309.576357,303.27303,303.899696,284.7649646147242,NaN,NaN,NaN,NaN,NaN,280.64325281280014,327.38727741341586,233.89922821218443,292.5350511879911,304.681251864485,305.52017158277073,303.8423321461992,579183,770376.8,58.09002072221073,57.22071202944169,NaN,NaN,NaN,NaN,8.358206737901689,31.834688222000107,767570745,-0.0895172615305615,6.696589761862526,6.786107023393088
2022-08-18T09:30:00-04:00,305.929694,306.479694,301.933031,304.726362,284.7649646147242,NaN,NaN,NaN,NaN,NaN,282.0646513858002,327.3051325485925,236.82417022300785,292.5350511879911,304.3796956666667,304.3796956666667,304.3796956666667,492045,743549.9,58.68842613718818,57.92012344429081,NaN,NaN,NaN,NaN,8.085953613765852,31.231705960499923,768062790,-0.28694086926058304,6.427430936817359,6.714371806077942
2022-08-18T13:30:00-04:00,304.833029,304.899695,302.406364,302.859697,284.7649646147242,NaN,NaN,NaN,NaN,NaN,283.3569834172001,327.18607261581707,239.5278942185832,292.5350511879911,304.0131918205158,304.4916483806011,303.53473526043047,288720,738262.5,56.71905290303486,58.44812006794801,NaN,NaN,NaN,NaN,7.686480569925435,30.671793860535463,767774070,-0.5759800928664216,5.994396689994915,6.570376782861336
2022-08-19T09:30:00-04:00,298.939701,300.236366,292.523041,294.573039,284.7649646147242,NaN,NaN,NaN,NaN,NaN,284.4381823338001,326.62264835266836,242.25371631493186,292.5350511879911,295.777482,295.777482,295.777482,1070538,733883.7,48.87780823222403,57.98584697922892,NaN,NaN,NaN,NaN,7.8757788149307615,28.798326947065,766703532,-1.3156864757430906,4.9257686881824725,6.241455163925563
2022-08-19T13:30:00-04:00,294.529705,297.336369,293.789706,296.669703,284.7649646147242,NaN,NaN,NaN,NaN,NaN,285.57084785420017,325.9273217600961,245.21437394830423,292.5350511879911,295.83055509827585,295.90390404373323,295.75720615281847,560484,714878.2,50.73364828874018,57.559431295767006,NaN,NaN,NaN,NaN,7.566556256721419,27.058679098842433,767264016,-1.6334476039589152,4.1996456589769195,5.833093262935835
2022-08-22T09:30:00-04:00,291.923041,292.263041,286.31638,288.996378,284.7649646147242,NaN,NaN,NaN,NaN,NaN,286.37058038720016,325.35889063469756,247.3822701397028,292.5350511879911,289.191933,289.191933,289.191933,618045,692058.7,44.38339514675827,56.90566124473087,NaN,NaN,NaN,NaN,7.7656110240984635,25.694007389734303,766645971,-2.2898589735772372,2.9707695459642878,5.260628519541525
2022-08-22T13:30:00-04:00,288.919711,290.333043,288.186378,289.936377,284.7649646147242,NaN,NaN,NaN,NaN,NaN,287.36011272940016,324.0829197608721,250.63730569792827,292.5350511879911,289.26583688392924,289.3931815498926,289.1384922179659,208158,685412.6,45.28686778450724,56.51574806062955,NaN,NaN,NaN,NaN,7.364257736662858,24.426812231276756,766854129,-2.569218317921205,2.0491056221400186,4.618323940061224
2022-08-23T09:30:00-04:00,291.453042,297.903035,287.999712,297.893035,284.7649646147242,NaN,NaN,NaN,NaN,NaN,288.43877830160017,323.1100719073746,253.76748469582571,290.5639254042514,294.598594,294.598594,294.598594,793449,682196,52.34382798781018,56.209184580316105,NaN,NaN,NaN,NaN,7.545619541186939,23.057551247311327,767647578,-2.14396172565377,1.938371782994011,4.082333508647781
2022-08-23T13:30:00-04:00,297.776369,298.799701,295.496371,296.36637,284.7649646147242,NaN,NaN,NaN,NaN,NaN,289.4607772666002,321.923682557922,256.9978719752784,290.5639254042514,295.2458973287867,296.27672338544636,294.2150712721271,312870,677864.8,50.98499460023925,55.60491670666372,NaN,NaN,NaN,NaN,7.2425988596735875,21.89010882185471,767334708,-1.8996751649039334,1.7077395525178645,3.607414717421798
2022-08-24T09:30:00-04:00,297.503036,303.489697,297.069703,298.666368,284.7649646147242,NaN,NaN,NaN,NaN,NaN,290.50670954680015,320.63471730888983,260.3787017847105,290.5639254042514,299.74192266666665,299.74192266666665,299.74192266666665,771801,673357.7,52.96597976593426,54.68695716574019,NaN,NaN,NaN,NaN,7.234079441125472,21.33697844759908,768106509,-1.5330845822730064,1.6910589895805401,3.2241435718535465
2022-08-24T13:30:00-04:00,298.639701,300.033033,296.62637,296.969703,284.7649646147242,NaN,NaN,NaN,NaN,NaN,291.50010854560014,319.02725552946157,263.9729615617387,289.6664080787209,299.3191021181913,300.100138192447,298.53806604393566,226191,665639.2,51.31828181381329,53.841726242100926,NaN,NaN,NaN,NaN,6.960692552473651,20.75775676427257,767880318,-1.360616978105805,1.5233723492212903,2.8839893273270953
2022-08-25T09:30:00-04:00,302.34,302.94,291.63,294.81,284.7649646147242,NaN,NaN,NaN,NaN,NaN,291.97764728980013,318.8824388498259,265.07285572977435,289.6664080787209,296.46,296.46,296.46,1335586,681410.4333333333,49.2193465265817,52.87492692533033,NaN,NaN,NaN,NaN,7.271357370154105,19.500386396287723,766544732,-1.345311814953421,1.2023495586353192,2.54766137358874
2022-08-25T13:30:00-04:00,294.78,296.14,291.8,296.13,284.7649646147242,NaN,NaN,NaN,NaN,NaN,292.46585271640015,318.7615392834426,266.1701661493577,287.6371480950946,296.0367388235455,296.7917370082021,295.28174063888883,419756,682890.9,50.55057551491291,52.14679130066987,NaN,NaN,NaN,NaN,7.061974700857381,18.332828197444655,766964488,-1.2041825930355357,1.0424331322943203,2.246615725329856
2022-08-26T09:30:00-04:00,297.4,302,288.5,289.98,284.7649646147242,NaN,NaN,NaN,NaN,NaN,292.7871915200002,318.55554351780603,267.01883952219436,287.6371480950946,293.49333333333334,293.49333333333334,293.49333333333334,1463498,677036.7666666667,44.67434836801585,51.059755270855035,NaN,NaN,NaN,NaN,7.52183365079614,17.995410597768398,765500990,-1.4655608887257323,0.41466461442269065,1.880225503148423
2022-08-26T13:30:00-04:00,289.99,290.33,287.47,288.08,284.7649646147242,NaN,NaN,NaN,NaN,NaN,293.1009969600002,318.2426389108089,267.9593550091915,287.6371480950946,292.0290231334633,294.2610861428563,289.79696012407027,629862,665694.9666666667,43.01088213596017,49.98267394326571,NaN,NaN,NaN,NaN,7.188845532882127,17.51959753904943,764871128,-1.6909558354760856,-0.23346929119668403,1.4574865442794016
2022-08-29T09:30:00-04:00,282.8,287.74,280.72,285.93,NaN,NaN,NaN,306.7686385855591,306.7686385855591,306.7686385855591,293.4114023600002,317.796625796035,269.02617892396535,287.6371480950946,284.7966666666667,284.7966666666667,284.7966666666667,789098,661085.8333333334,41.14393866176904,48.729496266450056,NaN,NaN,NaN,NaN,7.201070851961972,16.443321518226156,764082030,-1.8940819262282362,-0.9101158635058937,0.9839660627223425
2022-08-29T13:30:00-04:00,285.9,287.58,284.4,284.68,NaN,NaN,NaN,306.7686385855591,NaN,NaN,293.7383410600002,317.19034986447997,270.28633225552045,287.6371480950946,284.9987229100466,285.33348028287827,284.6639655372149,287485,651493.0666666667,40.055335895609964,47.53923076591972,NaN,NaN,NaN,NaN,6.91385150539326,15.443922356033116,763794545,-2.010849230853817,-1.5295954758449284,0.48125375500888834
2022-08-30T09:30:00-04:00,287.865,288.43,272.69,273.39,NaN,NaN,NaN,303.6565281327098,NaN,NaN,294.0217462400002,316.1006307608396,271.9428617191608,287.6371480950946,278.17,278.17,278.17,893901,645770.5666666667,31.856829600297658,46.323446577924976,NaN,NaN,NaN,NaN,7.544290683579456,15.90557135031003,762900644,-2.7035135989049723,-2.898138243622327,-0.19462464471735486
2022-08-30T13:30:00-04:00,273.37,278.29,273.22,277.7,NaN,NaN,NaN,298.493049581223,NaN,NaN,294.3999514200002,314.6215587156427,274.1783441243577,287.6371480950946,277.60913493966893,278.43150468052517,276.7867651988127,415788,645347.6666666666,37.14586217281414,45.3528904267874,NaN,NaN,NaN,NaN,7.367555634752351,16.334245416424306,763316432,-2.7191110686722335,-3.5935134805576467,-0.8744024118854133
2022-08-31T09:30:00-04:00,280.61,281.09,271.82,276.06,NaN,NaN,NaN,298.493049581223,NaN,NaN,294.52782348000017,314.19547216690836,274.86017479309197,285.77670350086055,276.3233333333333,276.3233333333333,276.3233333333333,872064,640335.7666666667,36.00083002197004,44.75413577501681,NaN,NaN,NaN,NaN,7.503444517984326,16.27593766082813,762444368,-2.6830361739918653,-4.228197629375245,-1.5451614553833797
2022-08-31T13:30:00-04:00,276.02,278.82,274.68,275.49,NaN,NaN,NaN,298.493049581223,NaN,NaN,294.5435623000002,314.1488883346055,274.9382362653949,285.77670350086055,276.3256561507903,276.3288326187617,276.3224796828189,466325,639614.9333333333,35.5901975141429,44.06151646999079,NaN,NaN,NaN,NaN,7.263198480985444,16.22179474491739,761978043,-2.542065065478027,-4.722742787230914,-2.1806777217528865
2022-09-01T09:30:00-04:00,272.51,275.83,266.15,269.94,NaN,NaN,NaN,293.7768789605284,NaN,NaN,294.35170122000017,314.71399872546795,273.9894037145324,282.5294902405508,270.64000000000004,270.64000000000004,270.64000000000004,1167138,649359.7333333333,31.788217728957335,42.59325859435844,NaN,NaN,NaN,NaN,7.435827160915055,17.11433193462431,760810905,-2.654755066083589,-5.499121554357373,-2.844366488273784
2022-09-01T13:30:00-04:00,269.95,277.57,268.7,277.28,NaN,NaN,NaN,293.7768789605284,NaN,NaN,294.2788401800002,314.85773893066664,273.69994142933376,282.5294902405508,271.8947636189091,273.70856309973175,270.0809641380865,558557,657477,40.79600603302958,41.86547369670061,NaN,NaN,NaN,NaN,7.538268077992552,17.638027146758713,761369462,-2.0918671292027007,-5.45920039977716,-3.367333270574459
2022-09-02T09:30:00-04:00,281.12,282.31,270.5,270.87,NaN,NaN,NaN,293.7768789605284,NaN,NaN,293.9357126000002,315.47011693043663,272.4013082695638,273.32359219244063,274.56,274.56,274.56,1274903,668456.1666666666,36.289071189081135,40.6742659412111,NaN,NaN,NaN,NaN,7.843391786707371,17.335745695785462,760094559,-2.0077726341686373,-5.877049063285256,-3.8692764291166184
2022-09-02T13:30:00-04:00,270.81,272.23,269.1,270.23,NaN,NaN,NaN,293.5498343401065,NaN,NaN,293.3973185400002,315.9073514866244,270.88728559337596,272.161899003162,273.1943374501152,275.1054215668922,271.2832533333382,651035,670356.6333333333,35.863063298903384,39.570321761574675,NaN,NaN,NaN,NaN,7.506720944799701,17.224800264580384,759443524,-1.8553809249111444,-6.188502585255549,-4.333121660344404
2022-09-06T09:30:00-04:00,272.675,275.98,265.73,271.6,NaN,NaN,NaN,293.5498343401065,NaN,NaN,292.8817244800002,316.1707633412979,269.59268561870243,272.161899003162,271.10333333333335,271.10333333333335,271.10333333333335,1407412,691800.5666666667,37.55303109889664,38.737013516740035,NaN,NaN,NaN,NaN,7.70266944874258,16.515110242421752,760850936,-1.535668177423644,-6.2527068821239595,-4.7170387047003155
2022-09-06T13:30:00-04:00,271.64,275.95,271.39,274.5,NaN,NaN,NaN,293.5498343401065,NaN,NaN,292.42459710000014,316.2357855923701,268.61340860763016,268.2255192025296,272.0240521198972,273.35453599146916,270.6935682483252,673994,704398.6333333333,41.09146089297176,38.06136247231567,NaN,NaN,NaN,NaN,7.478193059546682,15.856112364703021,761524930,-1.0267005911931841,-6.000414443691795,-4.973713852498611
2022-09-07T09:30:00-04:00,273.17,280.98,272.3,278.96,NaN,NaN,NaN,293.5498343401065,NaN,NaN,291.9276031800002,315.8047612487751,268.05044511122526,261.87257826747515,277.41333333333336,277.41333333333336,277.41333333333336,1051844,710900.8,46.145544304347986,38.16644789633939,NaN,NaN,NaN,NaN,7.564036412436205,14.987827930579304,762576774,-0.32389704653034634,-5.378585160661544,-5.0546881141311975
2022-09-07T13:30:00-04:00,278.87,283.84,278.87,283.76,NaN,NaN,NaN,293.5498343401065,NaN,NaN,291.5928091800002,315.44922637069794,267.73639198930243,266.06906261398007,279.19221297695896,281.48860282258386,276.89582313133405,631180,719337.8333333334,51.016406642912244,38.7382710754074,NaN,NaN,NaN,NaN,7.378748097262188,14.587516326518513,763207954,0.48599323109698567,-4.447196575259966,-4.9331898063569515
2022-09-08T09:30:00-04:00,281.17,288.58,279.77,286.41,NaN,NaN,NaN,293.5498343401065,NaN,NaN,291.17101532000015,314.6299923988516,267.7120382411487,269.9582500911841,284.92,284.92,284.92,1199540,737015,53.516041867354936,39.621992732949245,NaN,NaN,NaN,NaN,7.480980376029175,14.832620439034846,764407494,1.182231957610294,-3.455399859344084,-4.637631816954378
2022-09-08T13:30:00-04:00,286.45,289.5,285.63,289.29,NaN,NaN,NaN,293.5498343401065,NaN,NaN,290.8086881400002,313.8085713654127,267.80880491458765,272.66760007294727,286.0327999301695,287.564103979196,284.50149588114306,633470,738824.5666666667,56.13583590674468,40.77059987660173,NaN,NaN,NaN,NaN,7.223053206312805,15.17458237588298,765040964,1.7827216260637408,-2.409229784374702,-4.191951410438443
2022-09-09T09:30:00-04:00,291.68,299.49,291.25,299.26,272.7341899030493,272.7341899030493,272.7341899030493,NaN,NaN,NaN,290.6292943000002,313.2191274892139,268.0394611107865,280.92408005835784,296.6666666666667,296.6666666666667,296.6666666666667,1484130,771894.0666666667,63.75198781097081,43.048825463078366,NaN,NaN,NaN,NaN,7.435692263004747,16.559587968591565,766525094,2.7401230324841954,-0.7667976198331985,-3.506920652317394
2022-09-09T13:30:00-04:00,299.29,299.84,298.28,299.72,277.2403630892743,NaN,NaN,NaN,NaN,NaN,290.45243380000016,312.6122448017896,268.29262279821074,284.20726404668625,297.51638733099486,298.74055158825536,296.29222307373436,715064,786105.5333333333,64.06203413632713,44.97140917475787,NaN,NaN,NaN,NaN,7.015999958504408,17.878223634006783,767240158,3.257889960410708,0.5654417981959909,-2.692448162214717
2022-09-12T09:30:00-04:00,300.65,305.46,300.42,304.44,281.32943749430734,NaN,NaN,NaN,NaN,NaN,290.6845063200002,313.17982361055124,268.18918902944915,290.083811237349,303.44,303.44,303.44,949393,782067.3666666667,67.1654652542667,47.19745454849335,NaN,NaN,NaN,NaN,6.924857104325518,19.601661915913063,768189551,3.7373981740613202,1.9792995553619335,-1.7580986186993868
2022-09-12T13:30:00-04:00,304.45,304.69,302.16,304.51,282.4517357900206,NaN,NaN,NaN,NaN,NaN,291.01237874000014,313.82406913139,268.2006883486103,291.1240489898792,303.54490646737594,303.7041616350847,303.3856512996672,411968,777116.8333333334,67.21068849084321,49.456061046829085,NaN,NaN,NaN,NaN,6.610938739730837,21.201997463397465,768601519,3.862519530700201,3.070050794675865,-0.7924687360243363
2022-09-13T09:30:00-04:00,292.86,297.39,290.5,293.79,282.4517357900206,NaN,NaN,NaN,NaN,NaN,290.9311180400002,313.6735992909733,268.18863678902704,291.1240489898792,293.8933333333334,293.8933333333334,293.8933333333334,1330827,800876.2333333333,54.76975423416074,51.09759936862933,NaN,NaN,NaN,NaN,7.139443115464347,20.60335215569006,767270692,3.0615629467997367,3.0344849474753346,-0.027077999324402136
2022-09-13T13:30:00-04:00,293.79,295.97,291.41,291.995,282.4517357900206,NaN,NaN,NaN,NaN,NaN,290.96349052000016,313.70732902691276,268.21965201308757,291.1240489898792,293.60974296294125,293.98051032448166,293.23897560140085,778577,819890.2,53.000662710070934,51.96936055984657,NaN,NaN,NaN,NaN,6.955197178645466,20.04746722710461,766492115,2.2847408468528307,2.8288480592416363,0.5441072123888056
2022-09-14T09:30:00-04:00,292.16,306,291.7,303.07,282.4517357900206,NaN,NaN,NaN,NaN,NaN,291.3702961800002,314.23778467964127,268.5028076803591,291.1240489898792,300.25666666666666,300.25666666666666,300.25666666666666,1607191,847014.9333333333,61.30536753518865,53.75623887028282,NaN,NaN,NaN,NaN,7.479825951599361,20.59081934092743,768099306,2.3798940187899715,3.51897473587627,1.1390807170862987
2022-09-14T13:30:00-04:00,303.03,303.33,298.73,302.71,282.4517357900206,NaN,NaN,NaN,NaN,NaN,291.75810184000017,314.72378541286514,268.7924182671352,291.1240489898792,300.64598428667887,301.25222017371266,300.0397483996451,662815,858679.7666666667,60.9284933807806,55.54662673327406,NaN,NaN,NaN,NaN,7.27412409791369,21.09536058947718,767436491,2.2814170660428337,3.990852049639841,1.7094349835970073
2022-09-15T09:30:00-04:00,301.825,309.07,300.88,307.26,282.7350798343303,NaN,NaN,NaN,NaN,NaN,292.0614410200002,315.4338670028143,268.6890150371861,291.1240489898792,305.7366666666667,305.7366666666667,305.7366666666667,1187039,872521.0333333333,63.94533748568007,57.431791475187154,NaN,NaN,NaN,NaN,7.33954380520557,22.088219062604583,768623530,2.3748837453389675,4.678039665270717,2.3031559199317493
2022-09-15T13:30:00-04:00,307.18,307.52,302.26,303.68,282.9437125691334,NaN,NaN,NaN,NaN,NaN,292.2503135800001,315.84159273113943,268.6590344288608,291.1240489898792,305.3048718577909,305.8992595714544,304.71048414412735,626441,885862.7,60.01857440252049,58.783728154440645,NaN,NaN,NaN,NaN,7.1910049619766,23.01015907336574,767997089,2.0595068495757727,4.877539481901465,2.8180326323256923
2022-09-16T09:30:00-04:00,299.49,300.86,295.63,298.95,282.9437125691334,NaN,NaN,NaN,NaN,NaN,292.4222527200002,316.0809317345418,268.76357370545855,291.1240489898792,298.48,298.4800038146973,298.47999618530275,1574347,893821.4,55.19582350697213,59.430176668913795,NaN,NaN,NaN,NaN,7.252361750406844,22.712387567559052,766422742,1.4263229534973139,4.600936324197335,3.174613370700021
2022-09-16T13:30:00-04:00,299.04,303.73,299,303.22,282.9437125691334,NaN,NaN,NaN,NaN,NaN,292.75059178000015,316.54351376179864,268.95766979820166,291.1240489898792,299.8395096620104,301.54671468625287,298.13230463776796,998375,913108.7,58.44229870660122,59.96059753060587,NaN,NaN,NaN,NaN,7.0757644825206425,22.74218488279062,767421117,1.198244428517667,4.672418906347104,3.4741744778294374
2022-09-19T09:30:00-04:00,300,309.84,297.8,306,282.9437125691334,NaN,NaN,NaN,NaN,NaN,292.96273102000015,317.03363187343086,268.89183016656943,291.1240489898792,304.5466666666667,304.5466666666667,304.5466666666667,1241095,905695.2666666667,60.451507755841895,60.45598795121207,NaN,NaN,NaN,NaN,7.430352733769165,23.363127977145112,768662212,1.1382149945880302,4.896943221064475,3.7587282264764452
2022-09-19T13:30:00-04:00,306,309.2,305.19,309.19,285.31238066114696,NaN,NaN,NaN,NaN,NaN,293.1462703600002,317.5668133756967,268.72572734430366,291.4877589123698,305.67463180843635,307.24466975129246,304.1045938655802,640584,906052.6666666666,62.681136662821395,60.92350943378898,NaN,NaN,NaN,NaN,7.186041824214223,23.939717993331428,769302796,1.2102333373525003,5.271519898167071,4.061286560814571
2022-09-20T09:30:00-04:00,306.91,313.33,305.58,308.29,287.51022699473117,NaN,NaN,NaN,NaN,NaN,293.06487660000016,317.25476274700253,268.8749904529978,295.28520712989587,309.06666666666666,309.06666666666666,309.06666666666666,1254479,921565.3666666667,61.625535473070954,60.771619981081855,NaN,NaN,NaN,NaN,7.226324551056065,24.857562847412378,768048317,1.0974687362308782,5.433122481103169,4.335653744872291
2022-09-20T13:30:00-04:00,308.25,310.22,305.85,308.7,287.51022699473117,NaN,NaN,NaN,NaN,NaN,293.05328278000013,317.21260819183266,268.8939573681676,295.28520712989587,308.78166446567366,309.16847905721,308.3948498741373,681011,934682.9,61.93999006110453,60.62004540428023,NaN,NaN,NaN,NaN,7.022301368837774,25.709847354773263,768729328,0.9558968588034862,5.530524818376648,4.574627959573162
2022-09-21T09:30:00-04:00,308.37,310.48,306.31,308.43,287.51022699473117,NaN,NaN,NaN,NaN,NaN,293.04522230000015,317.1837433903422,268.9067012096581,295.28520712989587,308.4066666666667,308.4066666666667,308.4066666666667,616978,925452.1333333333,61.58211224454747,60.221234475014576,NaN,NaN,NaN,NaN,6.818565556777934,26.526850604140435,768112350,0.758115876733326,5.52227280548982,4.764156928756494
2022-09-21T13:30:00-04:00,308.48,313.8,300.66,300.68,287.51022699473117,NaN,NaN,NaN,NaN,NaN,292.92582844000015,316.8521285604496,268.9995283195507,295.28520712989587,306.444244037338,308.1003350548991,304.7881530197769,866336,940470.4,52.25013472367713,59.15262349164557,NaN,NaN,NaN,NaN,7.270096588436652,26.138051114260747,767246014,0.05638809793177746,4.834642051171215,4.778253953239438
2022-09-22T09:30:00-04:00,299.68,301.13,287.77,290.37,287.51022699473117,NaN,NaN,NaN,NaN,NaN,292.61823456000013,316.2710534187098,268.96541570129045,295.28520712989587,293.09,293.09,293.09,1173618,950522.2,42.93000974255437,58.306927456530836,NaN,NaN,NaN,NaN,7.705089689262606,24.697823354354604,766072396,-1.0879197795288027,3.4183542288284343,4.506274008357237
2022-09-22T13:30:00-04:00,290.34,291.48,285.87,288.49,NaN,NaN,NaN,311.19151404399685,311.19151404399685,311.19151404399685,292.3100406400001,315.7676104600498,268.85247081995044,295.28520712989587,291.3225734368578,293.5108108382653,289.1343360354503,765633,960499.1333333333,41.47713899067081,57.48381861943083,NaN,NaN,NaN,NaN,7.555440425743849,23.590550047942514,765306763,-1.9091792835879335,2.1197999038723196,4.028979187460253
2022-09-23T09:30:00-04:00,283.09,284.5,274.61,275.1,NaN,NaN,NaN,302.94076340563333,NaN,NaN,291.71751340000014,315.3863719436449,268.04865485635537,295.28520712989587,278.07,278.07,278.07,1610893,975290.9666666667,32.92930670851716,55.45695713181143,NaN,NaN,NaN,NaN,8.00719468104786,23.72605164195389,763695870,-3.215096450182945,0.010108624731572036,3.225205074914517
2022-09-23T13:30:00-04:00,275.03,276.35,272.83,275.34,NaN,NaN,NaN,297.39277415992274,NaN,NaN,291.16711946000015,315.0528705678384,267.2813683521619,295.28520712989587,276.90172121666956,278.4537087019865,275.3497337313526,912816,987099.6,33.195055413235494,53.47599727698678,NaN,NaN,NaN,NaN,7.68668077525873,24.009620626680768,764608686,-3.879166701485693,-1.6237533019425996,2.2554133995430936
2022-09-26T09:30:00-04:00,272.03,284.09,270.34,277.03,NaN,NaN,NaN,297.39277415992274,NaN,NaN,290.81625868000015,315.005043716354,266.6274736436463,295.28520712989587,277.1533333333333,277.1533333333333,277.1533333333333,1269423,986916.9333333333,35.14377858732773,51.4187430699616,NaN,NaN,NaN,NaN,8.119775005597392,23.161283463981754,765878109,-4.004751062903955,-2.7505254290868493,1.254225633817105
2022-09-26T13:30:00-04:00,277,280.5,275.79,276.02,NaN,NaN,NaN,297.39277415992274,NaN,NaN,290.40326462000013,314.8815893584715,265.92493988152876,295.28520712989587,277.23816953785894,277.36793757330804,277.10840150240983,542542,983300.5,34.49614193339387,49.59571217930971,NaN,NaN,NaN,NaN,7.87621964805472,22.373541812904097,765335567,-3.9494196155614683,-3.6825488856347306,0.26687072992673766
2022-09-27T09:30:00-04:00,283.84,288.66,278.3,279.38,NaN,NaN,NaN,297.39277415992274,NaN,NaN,290.21093706000016,314.8808188001757,265.54105531982464,295.09833256313334,282.11333333333334,282.11333333333334,282.11333333333334,854310,964863.7666666667,38.55296866283485,48.4069368332999,NaN,NaN,NaN,NaN,8.216489673193673,20.947558067261852,766189877,-3.495709493037487,-4.102766136370121,-0.6070566433326342
2022-09-27T13:30:00-04:00,279.11,283.73,277.62,283.03,NaN,NaN,NaN,297.39277415992274,NaN,NaN,290.07280952000013,314.8244960506545,265.3211229893458,295.09833256313334,281.93208323359926,282.2245984181288,281.63956804906974,328001,953330.6666666666,42.70423298686855,47.28278928189042,NaN,NaN,NaN,NaN,8.066026125108412,19.539270962692136,766517878,-2.7896130175793408,-4.0940729153068105,-1.3044598977274695
2022-09-28T09:30:00-04:00,283.01,285.5,277.66,283.46,NaN,NaN,NaN,297.39277415992274,NaN,NaN,289.7841488200001,314.5009154363716,265.0673822036286,294.9246660505067,282.2066666666667,282.2066666666667,282.2066666666667,623138,939040.4666666667,43.191150894103444,46.04990664890911,NaN,NaN,NaN,NaN,8.04988140188638,18.451991791577157,767141016,-2.161475194795889,-4.0063038912223305,-1.8448286964264415
2022-09-28T13:30:00-04:00,283.48,288.99,282.395,287.75,NaN,NaN,NaN,297.39277415992274,NaN,NaN,289.6118214200002,314.2626781008033,264.96096473919704,279.34973284040535,283.7622942553004,285.7796148948452,281.74497361575555,370549,930352.7666666667,47.94423563200046,44.99727086099333,NaN,NaN,NaN,NaN,7.945961301751639,17.86758027751865,767511565,-1.363865746291121,-3.549660879290343,-2.185795132999222
2022-09-29T09:30:00-04:00,282.76,283.61,267.02,268,NaN,NaN,NaN,297.39277415992274,NaN,NaN,288.9984940600001,314.2366979224236,263.7602901975766,271.25078627232426,272.87666666666667,272.87666666666667,272.87666666666667,1525712,941225.1666666666,33.88729157189651,43.01596772519515,NaN,NaN,NaN,NaN,8.859106923055096,17.65276801698475,765985853,-2.0329148835321424,-4.7269387374144,-2.694023853882258
2022-09-29T13:30:00-04:00,267.95,269.4,265.79,268.27,NaN,NaN,NaN,292.14888632759227,NaN,NaN,288.42450000000014,314.21092047667645,262.6380795233238,268.8373561898062,271.05216125886574,273.4805549039893,268.6237676137422,861241,948817.5333333333,34.17144323265278,41.032500094591455,NaN,NaN,NaN,NaN,8.484170714265444,17.57040479072676,766847094,-2.3039014932290565,-5.573900720418578,-3.2699992271895217
2022-09-30T09:30:00-04:00,266.11,275.54,262.61,270.55,NaN,NaN,NaN,292.14888632759227,NaN,NaN,287.9393000000002,314.1365451994452,261.74205480055514,268.8373561898062,269.56666666666666,269.56666666666666,269.56666666666666,960073,931348.9666666667,36.64763265399539,39.25146583812345,NaN,NaN,NaN,NaN,8.80172994896077,16.713309716683593,767807167,-2.177660094741595,-5.9920743456165155,-3.8144142508749206
2022-09-30T13:30:00-04:00,270.59,270.74,265.03,265.56,NaN,NaN,NaN,292.14888632759227,NaN,NaN,287.3279000000001,314.1513982125755,260.50440178742474,268.8373561898062,268.5992032993514,269.79951560813885,267.398890990564,623713,928303.9333333333,33.66311461639572,37.9238215447462,NaN,NaN,NaN,NaN,8.580892095463573,15.917435719357798,767183454,-2.2680527471253624,-6.649480184781623,-4.381427437656261
2022-10-03T09:30:00-04:00,254.51,255.12,241.02,243.03,NaN,NaN,NaN,275.1216595867611,NaN,NaN,286.3889000000001,315.92523012342804,256.85256987657215,268.8373561898062,246.39,246.39,246.39,1197492,936573.9,24.11431874922232,36.579843616651054,NaN,NaN,NaN,NaN,9.720828374359032,17.191498400189488,765985962,-3.6036813658627658,-8.886029144984718,-5.282347779121952
2022-10-03T13:30:00-04:00,243.05,247.21,241.32,242.29,NaN,NaN,NaN,270.8902205146356,NaN,NaN,285.4731000000001,317.4791664805918,253.4670335194084,268.8373561898062,245.42032677252544,246.74647067436572,244.09418287068516,640239,944182.9333333333,23.874772832270736,35.32253174819391,NaN,NaN,NaN,NaN,9.447197776190531,18.374556603818917,765345723,-4.250983491495705,-10.596077143491584,-6.345093651995879
2022-10-04T09:30:00-04:00,250.53,257.34,242.12,244.4,NaN,NaN,NaN,270.8902205146356,NaN,NaN,284.6425000000001,318.6509102686395,250.6340897313607,268.8373561898062,247.95333333333335,247.95333603073166,247.95333063593503,1404075,946624.5333333333,26.128121201274467,34.836732783390865,NaN,NaN,NaN,NaN,9.859540792176919,18.255657077309444,766749798,-4.241354066166175,-11.646786234703598,-7.4054321685374225
2022-10-04T13:30:00-04:00,244.63,249.69,244.55,249.58,NaN,NaN,NaN,270.8902205146356,NaN,NaN,283.9405000000001,319.3375472356107,248.54345276438946,268.8373561898062,247.94984872078683,247.95570696256812,247.94399047900555,496781,937231.3333333334,31.489641623795976,34.71491751271661,NaN,NaN,NaN,NaN,9.533145021307138,18.145250374122075,767246579,-3.614890330185318,-11.924045081269071,-8.309154751083753
2022-10-05T09:30:00-04:00,245.01,246.63,233.28,238.555,NaN,NaN,NaN,267.91440713617953,NaN,NaN,283.24380000000014,320.75235681361266,245.7352431863876,268.8373561898062,239.48833333333332,239.48833333333332,239.48833333333332,1573407,936105.2,26.99827632082146,34.133095922251876,NaN,NaN,NaN,NaN,10.016491805499486,18.882792342948925,765673172,-3.660573238462689,-12.884871299162114,-9.224298060699425
2022-10-05T13:30:00-04:00,238.53,242.29,237.68,240.58,NaN,NaN,NaN,267.3021613572623,NaN,NaN,282.5014000000001,321.84405486923936,243.15874513076085,257.1228849518449,239.68677789372208,240.00068667969882,239.37286910774534,628800,934971.3666666667,29.001327307039304,33.74060916322655,NaN,NaN,NaN,NaN,9.630313819392379,19.567652742573856,766301972,-3.2839861684885143,-13.329280771310067,-10.045294602821553
2022-10-06T09:30:00-04:00,239.47,244.5,235.35,240.45,NaN,NaN,NaN,267.2481994773868,NaN,NaN,281.7892000000001,322.82530441355294,240.75309558644727,250.6792463691808,240.1,240.1,240.1,911044,925771.5333333333,28.946416641635878,33.054426875998054,NaN,NaN,NaN,NaN,9.596005689435781,20.37091251259226,765390928,-2.792511970130855,-13.535934565485121,-10.743422595354266
2022-10-06T13:30:00-04:00,240.61,242.81,238,238.17,NaN,NaN,NaN,267.14214495568734,NaN,NaN,281.0428000000001,323.8302957042363,238.25530429576395,250.6792463691808,239.9551269012362,240.1619020175028,239.74835178496963,447217,919797.4,27.94699193939114,32.000338229749666,NaN,NaN,NaN,NaN,9.254148140190368,21.116796584752205,764943711,-2.3856359125974294,-13.725467486101053,-11.339831573503623
2022-10-07T09:30:00-04:00,233.935,234.53,222.12,223.96,NaN,NaN,NaN,256.0354565486106,NaN,NaN,280.12320000000017,325.71049036738117,234.53590963261917,247.9963970953446,226.87,226.87000269739832,226.8699973026017,1349077,912288.4,22.68905284096502,30.535902654525493,NaN,NaN,NaN,NaN,9.739566130176769,22.82558504517414,763594634,-2.809020828596436,-14.85110760924917,-12.042086780652733
2022-10-07T13:30:00-04:00,223.97,225.04,222.02,222.98,NaN,NaN,NaN,250.3927085236738,NaN,NaN,279.0372000000001,327.3493556198857,230.72504438011447,227.8764753128164,225.63289984707936,227.3146547094485,223.95114498471023,729997,903342.4666666667,22.376382249420473,28.70962741291263,NaN,NaN,NaN,NaN,9.259597120878427,24.417783893535656,762864637,-2.8798926820879434,-15.641952633262662,-12.762059951174718
2022-10-10T09:30:00-04:00,223.63,226.99,218.39,223.22,NaN,NaN,NaN,249.50440359077953,NaN,NaN,278.0842000000001,328.82215499860075,227.3462450013995,227.8764753128164,222.86666666666665,222.86666936406496,222.86666396926833,847784,890232.1,22.657480945527013,27.907498082457668,NaN,NaN,NaN,NaN,9.212483040815684,26.098645204166242,763712421,-2.6416795498199814,-16.064159388449696,-13.422479838629714
2022-10-10T13:30:00-04:00,223.1,226.24,222.6,223.04,NaN,NaN,NaN,249.50440359077953,NaN,NaN,277.1404000000001,330.133145572956,224.14765442704424,227.8764753128164,223.17384103580576,223.6652552031589,222.68242686845264,331253,879921.0666666667,22.59140336873449,27.080352377892073,NaN,NaN,NaN,NaN,8.81444853790028,27.659444992608933,763381168,-2.2430079592238243,-16.226239787659495,-13.98323182843567
2022-10-11T09:30:00-04:00,220.945,225.6,219.6,221.59,NaN,NaN,NaN,248.3241156684582,NaN,NaN,276.1402000000001,331.3547049406413,220.9256950593589,223.47418025025314,222.26333333333332,222.26333333333332,222.26333333333332,875028,867272.7,22.03394188697952,26.036517323105226,NaN,NaN,NaN,NaN,8.61341649947883,29.284057780892876,762506140,-1.8405993032925778,-16.283980957551393,-14.443381654258815
2022-10-11T13:30:00-04:00,221.64,221.84,215,216.6,NaN,NaN,NaN,243.90756495625558,NaN,NaN,274.98220000000015,332.6594512576664,217.30494874233392,220.35900023050368,220.4025557303629,222.59754252884073,218.20756893188508,628850,865534,20.187750150352684,25.073991289816437,NaN,NaN,NaN,NaN,8.4867438923732,31.048522269815855,761877290,-1.6786626856883462,-16.541710011369247,-14.8630473256809
2022-10-12T09:30:00-04:00,215.33,217.54,211.61,215.75,NaN,NaN,NaN,239.71267564006212,NaN,NaN,273.71800000000013,333.71535790849504,213.72064209150525,220.35900023050368,214.96666666666667,214.96666666666667,214.96666666666667,1012439,878716.0333333333,19.88215176789906,24.771693648293347,NaN,NaN,NaN,NaN,8.304119328632256,32.86515758503909,760864851,-1.4079071280479596,-16.62293123574085,-15.21502410769289
2022-10-12T13:30:00-04:00,215.8,219.29,214.52,217.32,NaN,NaN,NaN,239.71267564006212,NaN,NaN,272.38920000000013,334.3489573384528,210.42944266154743,220.35900023050368,215.69747772481836,216.6892267663449,214.70572868329182,549763,868163.6,22.2240806022143,24.653787060432172,NaN,NaN,NaN,NaN,8.05168223372995,34.22497798414904,761414614,-0.9254917691260793,-16.37188881910049,-15.446397049974411
2022-10-13T09:30:00-04:00,208.3,222.4,206.24,221.67,NaN,NaN,NaN,239.71267564006212,NaN,NaN,271.0944000000001,334.5165873996793,207.67221260032096,220.35900023050368,216.76999999999998,216.76999999999998,216.76999999999998,2097105,898946.5,28.463529259136834,24.820601921708057,NaN,NaN,NaN,NaN,8.630847788463525,35.93342781289838,763511719,-0.15617866919827428,-15.641620386472255,-15.48544171727398
2022-10-13T13:30:00-04:00,221.71,222.98,218.68,221.83,NaN,NaN,NaN,239.71267564006212,NaN,NaN,269.7452000000001,334.41949622222415,205.0709037777761,208.54420018440297,217.94140724478183,219.88413408154727,215.99868040801638,762452,898840.4666666667,28.690132491386507,24.620636983678814,NaN,NaN,NaN,NaN,8.321501517858986,37.410353542961374,764274171,0.48558766411407106,-14.878457137131392,-15.364044801245463
2022-10-14T09:30:00-04:00,223.9,226.26,207.62,208.92,NaN,NaN,NaN,239.71267564006212,NaN,NaN,267.9384000000002,334.2406851020985,201.63611489790185,206.97509639553144,214.26666666666665,214.26666666666665,214.26666666666665,1918683,909100.1333333333,22.497628737122056,24.299162156271713,NaN,NaN,NaN,NaN,9.0585371237262,39.296290400591694,762355488,0.17856408483490327,-15.140839695201834,-15.319403780036737
2022-10-14T13:30:00-04:00,208.91,209.66,204.17,205.15,NaN,NaN,NaN,233.00165592911043,NaN,NaN,266.04700000000014,333.99012680470327,198.103873195297,206.97509639553144,211.5815772172298,215.33789254971302,207.8252618847466,980385,911352.4333333333,21.067588236061866,23.73246650834475,NaN,NaN,NaN,NaN,8.803641614888615,41.184048659432314,761375103,-0.12416148355901058,-15.4746056344855,-15.350444150926489
2022-10-17T09:30:00-04:00,210.15,221.85,209.49,219.6,NaN,NaN,NaN,233.00165592911043,NaN,NaN,264.35020000000014,332.61011552763574,196.09028447236454,206.97509639553144,216.98000000000005,216.98000000000005,216.98000000000005,1516734,919596.1333333333,37.47309662059184,24.34151507827018,NaN,NaN,NaN,NaN,9.367667213825143,40.95589042371881,762891837,0.7547170564232921,-14.407047830397374,-15.161764886820666
2022-10-17T13:30:00-04:00,219.65,220.96,217.62,219.45,NaN,NaN,NaN,233.00165592911043,NaN,NaN,262.64900000000017,331.06023603619417,194.23776396380617,206.97509639553144,217.64196755052333,218.70321631486036,216.5807187861863,590131,921182.4333333333,37.38622976795863,25.01574635173929,NaN,NaN,NaN,NaN,8.937119555694776,40.74402920484199,762301706,1.3946718501433484,-13.418425074141481,-14.81309692428483
2022-10-18T09:30:00-04:00,229.19,229.79,217.55,220.84,NaN,NaN,NaN,233.00165592911043,NaN,NaN,261.19000000000017,329.9929137464386,192.38708625356173,205.4879788470314,222.7266666666667,222.7266666666667,222.7266666666667,1125713,930229.2,38.80195915569433,26.166668231362813,NaN,NaN,NaN,NaN,9.173039587430862,39.33235842283585,763427419,1.9464268436860337,-12.380063369677288,-14.326490213363321
2022-10-18T13:30:00-04:00,220.74,221.51,217.3,220.12,NaN,NaN,NaN,233.00165592911043,NaN,NaN,259.75250000000017,328.92329633053146,190.58170366946888,205.4879788470314,222.05970308354526,223.32920323193346,220.79020293515705,310718,929653.1,38.31865225373413,27.3054018030995,NaN,NaN,NaN,NaN,8.818536759757228,38.04265503724823,763116701,2.274884431544553,-11.482884673932631,-13.757769105477184
2022-10-19T09:30:00-04:00,219.82,222.92,217.8,219.63,NaN,NaN,NaN,233.00165592911043,NaN,NaN,258.0837000000002,327.01941082711676,189.1479891728836,205.4879788470314,220.11666666666667,220.11666666666667,220.11666666666667,819473,936197.6,37.97201023971703,28.3992967526845,NaN,NaN,NaN,NaN,8.55435556263171,36.65244608960204,762297228,2.4556583829006193,-10.688196126851409,-13.143854509752028
2022-10-19T13:30:00-04:00,219.615,222.84,219.51,222.48,NaN,NaN,NaN,233.00165592911043,NaN,NaN,256.47910000000013,324.91828911530115,188.0399108846991,205.4879788470314,220.7191428988801,221.45175482188404,219.98653097587618,554200,942319.3,41.298264024898224,29.735501085267625,NaN,NaN,NaN,NaN,8.181187308158018,35.36153778107342,762851428,2.7419446777272896,-9.716423662592916,-12.458368340320206
2022-10-20T09:30:00-04:00,208.35,215.54,202,208.25,NaN,NaN,NaN,233.00165592911043,NaN,NaN,254.49890000000013,322.67532951313837,186.3224704868619,205.4879788470314,208.59666666666666,208.59666666666666,208.59666666666666,2626023,978996.3333333334,32.0552837823696,30.451311220652627,NaN,NaN,NaN,NaN,9.059673929003873,35.57358637781037,760225405,1.9831013201224899,-9.979491690167094,-11.962593010289584
2022-10-20T13:30:00-04:00,208.24,208.72,205.01,207.21,NaN,NaN,NaN,232.82593386131242,NaN,NaN,252.56950000000012,320.5292819375549,184.60971806244532,205.4879788470314,208.2291827679198,208.9067184155438,207.55164712029583,772522,976039.0333333333,31.500390724407396,31.25935697594225,NaN,NaN,NaN,NaN,8.677554362646454,35.77048864620897,759452883,1.4462058633407793,-10.15483568111361,-11.60104154445439
2022-10-21T09:30:00-04:00,206.415,212.57,203.81,211.59,NaN,NaN,NaN,232.82593386131242,NaN,NaN,250.8223000000001,318.4135318340187,183.23106816598147,205.4879788470314,209.32333333333335,209.32333333333335,209.32333333333335,1497279,993945.9,36.48691915839308,32.44541178954897,NaN,NaN,NaN,NaN,8.683443336743135,35.377737821302595,760950162,1.4191635401635843,-9.82708711924991,-11.246250659413494
2022-10-21T13:30:00-04:00,211.58,214.64,211.34,214.54,NaN,NaN,NaN,232.82593386131242,NaN,NaN,249.04870000000014,315.6945018125673,182.40289818743298,205.4879788470314,210.55545595552937,212.46235225057464,208.6485596604841,625110,993992.4666666667,39.67228745155562,33.691712278787634,NaN,NaN,NaN,NaN,8.29891166983291,34.7094185808441,761575272,1.6186110668648244,-9.222986825832464,-10.841597892697289
2022-10-24T09:30:00-04:00,205.815,207.7,198.59,206.31,NaN,NaN,NaN,229.41724722855128,NaN,NaN,247.05490000000012,312.72386997791307,181.38593002208717,205.4879788470314,204.19999999999996,204.19999999999996,204.19999999999996,2049234,1022383.8666666667,34.47721973824777,34.12126159872413,NaN,NaN,NaN,NaN,8.845417979130557,35.029043436135275,759526038,1.2323920511969924,-9.30110782870105,-10.533499879898041
2022-10-24T13:30:00-04:00,206.3,213.43,205.755,211.26,NaN,NaN,NaN,229.41724722855128,NaN,NaN,245.09630000000016,309.0549546078004,181.1376453921999,205.4879788470314,205.56828040330075,208.07163748335205,203.06492332324945,612204,1021449.3666666667,39.60027432955292,34.900557444307445,NaN,NaN,NaN,NaN,8.761816694906946,34.53759490360539,760138242,1.3376427703614322,-8.86144641694625,-10.199089187307683
2022-10-25T09:30:00-04:00,210.14,224.34,210,220.45,NaN,NaN,NaN,229.41724722855128,NaN,NaN,243.33950000000016,305.0443120084642,181.6346879915361,205.33716516968008,218.26333333333332,218.26333333333332,218.26333333333332,2000094,1041316.6666666666,47.76584002533429,36.70542967917975,NaN,NaN,NaN,NaN,9.160258359556451,32.80122425252422,762138336,2.012957917486567,-7.6828917904494745,-9.695849707936041
2022-10-25T13:30:00-04:00,220.45,223.07,218.2,222.4,NaN,NaN,NaN,229.41724722855128,NaN,NaN,241.61350000000013,300.68028370285583,182.54671629714446,205.33716516968008,219.0710402164213,220.3895325239278,217.75254790891478,750590,1049776.9666666666,49.33113527831011,38.72425446791176,NaN,NaN,NaN,NaN,8.853811333873848,31.188880076520277,762888926,2.5435494438431707,-6.516412903132078,-9.059962346975249
2022-10-26T09:30:00-04:00,219.19,230.51,218.25,224.7,198.32806929971045,198.32806929971045,198.32806929971045,NaN,NaN,NaN,239.93890000000013,296.0049105693279,183.87288943067242,206.4667779411152,224.48666666666668,224.48666666666668,224.48666666666668,1742054,1055398.5333333334,51.18909552160081,39.703968675126696,NaN,NaN,NaN,NaN,9.097110524311429,29.014578525388657,764630980,2.972155442538492,-5.344768043802134,-8.316923486340626
2022-10-26T13:30:00-04:00,224.72,228.18,222.57,224.6,199.01947740867536,NaN,NaN,NaN,NaN,NaN,238.41730000000015,291.87569994649914,184.9589000535012,206.4667779411152,224.6751998464478,224.96369792857567,224.38670176431995,743963,1059237.3,51.101358167481465,40.68362070366403,NaN,NaN,NaN,NaN,8.848031201146329,26.99558422790929,763887017,3.1544341169731167,-4.3738808401242295,-7.528314957097346
2022-10-27T09:30:00-04:00,229.9,233.8,222.85,225.75,201.6742738900992,NaN,NaN,NaN,NaN,NaN,237.12490000000017,288.5839082488954,185.66589175110494,210.69333788231373,227.46666666666667,227.46666666666667,227.46666666666667,1279123,1071506.6,52.117756839450905,41.63474910964665,NaN,NaN,NaN,NaN,8.998171829635877,25.68966665195587,765166140,3.2453467337424025,-3.4716315399193434,-6.716978273661746
2022-10-27T13:30:00-04:00,225.77,226.31,224.1,225.09,201.6742738900992,NaN,NaN,NaN,NaN,NaN,235.85690000000017,285.27466461516525,186.43913538483508,210.69333788231373,226.87210665766986,227.87907558290732,225.8651377324324,445935,1071463.8666666667,51.45669819860731,42.57318096285188,NaN,NaN,NaN,NaN,8.513302413233315,24.477028902856265,764720205,3.151320312842433,-2.7778278826087046,-5.929148195451138
2022-10-28T09:30:00-04:00,225.335,227.46,216.38,225.39,201.6742738900992,NaN,NaN,NaN,NaN,NaN,234.86270000000016,283.0677260122315,186.65767398776882,210.69333788231373,223.07666666666668,223.07666666666668,223.07666666666668,1751264,1084870.1,51.75623998948906,43.55776880212131,NaN,NaN,NaN,NaN,8.696637955145222,22.986480707519124,766471469,3.0003891671761638,-2.178661736480933,-5.179050903657097
2022-10-28T13:30:00-04:00,225.38,228.85,225.26,228.49,201.6742738900992,NaN,NaN,NaN,NaN,NaN,233.92570000000018,280.7486496725684,187.10275032743198,210.69333788231373,224.28879311649303,226.27192019622044,222.30566603676561,654254,1082345.3333333333,54.85616829725157,44.526190535860835,NaN,NaN,NaN,NaN,8.331878101206279,21.443246945656156,767125723,2.9935542673729945,-1.4371080694408533,-4.430662336813848
2022-10-31T09:30:00-04:00,226.18,229.16,221.94,228.93,201.6742738900992,NaN,NaN,NaN,NaN,NaN,232.96370000000016,278.1526914386226,187.77470856137774,210.69333788231373,226.67666666666665,226.67666666666665,226.67666666666665,1124762,1091577.9333333333,55.29524449193839,46.18618772940147,NaN,NaN,NaN,NaN,8.252458236834402,20.379478170831874,768250485,2.9008164981463396,-0.8046417141309234,-3.705458212277263
2022-10-31T13:30:00-04:00,228.98,229.84,227.27,227.48,204.13449322222232,NaN,NaN,NaN,NaN,NaN,231.99290000000016,275.49431625694376,188.49148374305656,213.65752095727655,227.17033648341294,227.88214280081064,226.45853016601524,541016,1098570.0333333334,53.450265812065794,47.754035949948495,NaN,NaN,NaN,NaN,7.846568362774802,19.304704642848975,767709469,2.6318710094954088,-0.41561945040800197,-3.0474904599034107
2022-11-01T09:30:00-04:00,234.1,237.32,228.01,228.91,208.01269807575767,NaN,NaN,NaN,NaN,NaN,230.98350000000013,272.32857256010016,189.6384274399001,219.45401676582122,231.41333333333333,231.41333333333333,231.41333333333333,1299000,1112702.4333333333,55.043390750305875,49.07949820651369,NaN,NaN,NaN,NaN,7.988956336862316,18.442110819157673,769008469,2.444376808338083,0.007980550519192775,-2.43639625781889
2022-11-01T13:30:00-04:00,228.88,229.38,227.29,227.89,208.01269807575767,NaN,NaN,NaN,NaN,NaN,229.88070000000013,268.46319447663996,191.29820552336028,219.45401676582122,230.71991087333254,232.04528192687786,229.3945398197872,355574,1103593.2333333334,53.63339837451945,50.076720415296826,NaN,NaN,NaN,NaN,7.567602312800722,17.5476065932131,768652895,2.155838946506121,0.25840242531376134,-1.8974365211923598
2022-11-02T09:30:00-04:00,225.98,227.82,221.3,221.89,208.01269807575767,NaN,NaN,NaN,NaN,NaN,228.64930000000015,264.11748698552196,193.18111301447834,219.45401676582122,223.67,223.6700026973983,223.66999730260167,890146,1099516.8,46.145251348169595,50.91015124457696,NaN,NaN,NaN,NaN,7.497773576172098,16.617485643657595,767762749,1.496368948355347,-0.02697533574817612,-1.5233442841035232
2022-11-02T13:30:00-04:00,221.95,227,214.83,214.91,208.01269807575767,NaN,NaN,NaN,NaN,NaN,227.1925000000002,258.5799699999839,195.8050300000165,219.45401676582122,221.07718843948203,223.44583120159245,218.7085456773716,1066606,1116744.9,39.275384118732134,50.88694480094689,NaN,NaN,NaN,NaN,7.831504035016947,16.45556619736756,766696143,0.5730245422762157,-0.8070636062582537,-1.3800881485344694
2022-11-03T09:30:00-04:00,211.21,221.18,210.21,215.42,208.01269807575767,NaN,NaN,NaN,NaN,NaN,226.14090000000016,255.4430671341886,196.83873286581172,219.45401676582122,215.60333333333332,215.60333333333332,215.60333333333332,1172032,1085909.1333333333,39.9785011232944,50.33070630794405,NaN,NaN,NaN,NaN,8.055682318230023,16.753831281149132,767868175,0.009380272076805696,-1.3683628084384623,-1.377743080515268
2022-11-03T13:30:00-04:00,215.41,217.62,214.51,215.39,208.01269807575767,NaN,NaN,NaN,NaN,NaN,225.08330000000015,251.94220151216012,198.22439848784018,219.45401676582122,215.66127495868764,215.7630375224993,215.55951239487598,379966,1073159.6,39.94919848951737,49.660567965887424,NaN,NaN,NaN,NaN,7.7024192954993085,17.030791716089162,767488209,-0.3337466754799876,-1.7949264248652526,-1.461179749385265
2022-11-04T09:30:00-04:00,222.59,223.8,203.32,204.84,NaN,NaN,NaN,239.18404261211143,239.18404261211143,239.18404261211143,223.76910000000015,247.89165655522308,199.64654344477722,219.45401676582122,210.65333333333334,210.65333333333334,210.65333333333334,1937706,1073793.7,31.269307022336918,48.23772593022572,NaN,NaN,NaN,NaN,8.615103631535074,18.256286548308626,765550503,-1.1912715029319212,-2.9502691280501665,-1.7589976251182453
2022-11-04T13:30:00-04:00,204.8,208.7,203.09,207.37,NaN,NaN,NaN,231.11931340246997,NaN,NaN,222.60530000000017,244.01268437175082,201.19791562824952,219.45401676582122,209.03044034617812,211.10180747059508,206.95907322176117,1189470,1080763.2,34.92104445763748,47.081989236665436,NaN,NaN,NaN,NaN,8.400453372139712,19.4119519677701,766739973,-1.4888078960518634,-3.6200074951830743,-2.131199599131211
2022-11-07T09:30:00-05:00,208.75,208.86,196.66,199.02,NaN,NaN,NaN,228.50139006599406,NaN,NaN,221.72510000000017,243.3191949789501,200.13100502105024,219.45401676582122,201.51333333333332,201.51333333333332,201.51333333333332,1661994,1085605.2,29.373990303419916,45.45743448409179,NaN,NaN,NaN,NaN,8.671849559844018,20.962046467679897,765077979,-2.1106999259145796,-4.769574506524435,-2.6588745806098557
2022-11-07T13:30:00-05:00,199.05,200,197,197.08,NaN,NaN,NaN,223.48041779026707,NaN,NaN,220.82090000000014,242.6793513348947,198.96244866510557,219.45401676582122,200.50835601541164,202.08760948006477,198.9291025507585,673036,1088368.7,28.251166766639017,43.79989652466549,NaN,NaN,NaN,NaN,8.266717448426588,22.401419931881854,764404943,-2.4894092400884054,-5.770636130720362,-3.281226890631957
2022-11-08T09:30:00-05:00,194.02,195.2,186.75,192.28,NaN,NaN,NaN,216.2285806179822,NaN,NaN,219.77850000000018,242.00763009993597,197.5493699000644,214.042213412657,191.41,191.41,191.41,2143477,1122294.1666666667,25.63969351996657,41.9344289196996,NaN,NaN,NaN,NaN,8.414094773538976,24.40448739588313,762261466,-2.8726884225687392,-6.872087418842881,-3.9993989962741416
2022-11-08T13:30:00-05:00,192.28,194.77,188.94,191.27,NaN,NaN,NaN,216.2285806179822,NaN,NaN,218.61230000000018,240.58188235469848,196.64271764530187,212.25477073012559,191.50059034931726,191.62076096110633,191.3804197375282,1218109,1152540.5333333334,25.113647420442334,39.80996314278466,NaN,NaN,NaN,NaN,8.229516575429049,26.26447861245575,761043357,-2.9903233980169803,-7.737303243795367,-4.7469798457783865
2022-11-09T09:30:00-05:00,190.58,195.85,180.08,180.25,NaN,NaN,NaN,213.88429556307884,NaN,NaN,217.44620000000018,241.17676624355795,193.7156337564424,208.4628165841005,185.39333333333335,185.39333333333335,185.39333333333335,1417304,1172468.2333333334,20.235365160487362,37.305686047681014,NaN,NaN,NaN,NaN,8.768122534326972,28.47682473021357,759626053,-3.5672903739959088,-9.206092813273273,-5.638802439277364
2022-11-09T13:30:00-05:00,180.22,181.66,177.14,177.61,NaN,NaN,NaN,204.75750940112067,NaN,NaN,216.18680000000018,241.50350260993466,190.8700973900657,200.8652532672804,182.05305337129994,185.3477422374971,178.75836450510278,1456800,1202554.9,19.269673450448494,34.86421516470835,NaN,NaN,NaN,NaN,8.464685210446474,30.67378299237959,758169253,-3.8589895877513234,-10.462539423966518,-6.603549836215195
2022-11-10T09:30:00-05:00,189.68,191,180.03,188.13,NaN,NaN,NaN,204.75750940112067,NaN,NaN,215.14040000000014,240.68318981160377,189.59761018839652,199.8132026138243,186.38666666666666,186.38666666666666,186.38666666666666,2250547,1190039.0333333334,32.99259951984001,33.2891586482465,NaN,NaN,NaN,NaN,8.816493409700296,31.146999838223188,760419800,-3.107961266200549,-10.488501418965882,-7.380540152765333
2022-11-10T13:30:00-05:00,188.13,190.83,185.12,190.64,NaN,NaN,NaN,204.75750940112067,NaN,NaN,214.18980000000013,239.77128001660154,188.60831998339873,199.31456209105946,187.115816105648,188.24462131744454,185.98701089385148,939038,1195589.5666666667,35.796801823588936,32.01511603746575,NaN,NaN,NaN,NaN,8.594601023293134,31.58641548079225,761358838,-2.2468374869181744,-10.18908701141305,-7.942249524494876
2022-11-11T09:30:00-05:00,185.92,196.21,182.6,195.35,NaN,NaN,NaN,204.75750940112067,NaN,NaN,213.61760000000012,239.576432195609,187.65876780439126,186.30664967284756,191.38666666666666,191.38666936406497,191.38666396926834,2030542,1213365,40.80310735904807,31.633534323957072,NaN,NaN,NaN,NaN,8.952843807343625,31.167988243805254,763389380,-1.2163296815626445,-9.462661626448181,-8.246331944885537
2022-11-11T13:30:00-05:00,195.36,196.52,193.4,195.87,NaN,NaN,NaN,204.75750940112067,NaN,NaN,213.07540000000014,239.3598225228509,186.7909774771494,184.84531973827805,192.65747781069413,194.4772443445916,190.83771127679665,990245,1225536.1666666667,41.34688195358927,31.781498455018298,NaN,NaN,NaN,NaN,8.53621210681908,30.73273053962809,764379625,-0.39829992218200516,-8.744206847613043,-8.345906925431038
2022-11-14T09:30:00-05:00,192.71,195.71,186.37,195.45,NaN,NaN,NaN,204.75750940112067,NaN,NaN,212.52000000000015,239.0954837397133,185.944516260287,179.28825579062243,192.51,192.51,192.51,1229329,1198206,41.019136147544515,31.855829528179022,NaN,NaN,NaN,NaN,8.605054099189147,30.931843104186502,763150296,0.18458944475038308,-8.115170119493058,-8.299759564243441
2022-11-14T13:30:00-05:00,195.46,195.49,190.5,190.96,NaN,NaN,NaN,204.75750940112067,NaN,NaN,211.87840000000014,238.95131616652674,184.80548383347355,175.69696759592014,192.44828977837443,192.53841464391303,192.35816491283583,576359,1197011.1666666667,37.58881524051929,31.687230724679157,NaN,NaN,NaN,NaN,8.346835949247065,31.11673334270503,762573937,0.3293827369079363,-7.88803114310852,-8.217413880016457
2022-11-15T09:30:00-05:00,195.88,200.79,194.37,194.61,NaN,NaN,NaN,204.75750940112067,NaN,NaN,211.3388000000001,238.69001047119914,183.98758952880107,180.0405740767361,196.59,196.59,196.59,1121786,1167734.2333333334,41.8463337684673,32.44273263511704,NaN,NaN,NaN,NaN,8.45277623858656,30.432756023848835,763695723,0.7107206466845746,-7.329013071660739,-8.039733718345314
2022-11-15T13:30:00-05:00,194.56,195.76,192.08,194.4,NaN,NaN,NaN,204.75750940112067,NaN,NaN,210.89480000000015,238.60832716345843,183.18127283654186,180.0405740767361,195.78776615282345,196.95824802404843,194.61728428159847,526966,1160280.1,41.670204769032985,32.924815514502434,NaN,NaN,NaN,NaN,8.11186365011609,30.022218292168297,763168757,0.9723737183386536,-6.824266570421997,-7.796640288760651
2022-11-16T09:30:00-05:00,191.505,192.5,186.88,188.39,NaN,NaN,NaN,204.75750940112067,NaN,NaN,210.34760000000014,238.72846187838178,181.9667381216185,180.0405740767361,189.25666666666666,189.25666666666666,189.25666666666666,1257098,1144114.9,36.88536499772999,33.46134227838173,NaN,NaN,NaN,NaN,8.0695876751078,30.12114439781049,761911659,0.772935679223254,-6.830470689731584,-7.603406368954838
2022-11-16T13:30:00-05:00,188.34,188.62,185.66,186.935,NaN,NaN,NaN,204.75750940112067,NaN,NaN,209.73990000000012,238.790871790283,180.68892820971723,180.0405740767361,188.5696295584303,189.58410286680186,187.55515625005876,576565,1138534.9666666666,35.81320845559169,34.00148811330691,NaN,NaN,NaN,NaN,7.704617126885815,30.321053785601144,761335094,0.5838773181906634,-6.873559721216509,-7.457437039407172
2022-11-17T09:30:00-05:00,183.95,186.13,182.3,184.68,NaN,NaN,NaN,204.75750940112067,NaN,NaN,209.00010000000012,238.67540033478681,179.32479966521342,180.0405740767361,184.37,184.37,184.37,1102085,1132633.7,34.15613750446471,34.60980554077107,NaN,NaN,NaN,NaN,7.485358760679683,30.80084525730799,760233009,0.3588505844135321,-7.008873808890257,-7.3677243933037895
2022-11-17T13:30:00-05:00,184.79,185.82,180.9,183.18,NaN,NaN,NaN,204.75750940112067,NaN,NaN,208.2271000000001,238.53219911483268,177.9220008851675,180.0405740767361,183.96078758410926,184.48078997225616,183.44078519596235,682499,1140519.1666666667,33.06032955141478,35.17742569298339,NaN,NaN,NaN,NaN,7.302118849202563,31.36693626590949,759550510,0.17044028775936848,-7.154674033604579,-7.325114321363947
2022-11-18T09:30:00-05:00,185.19,185.19,176.55,179.47,NaN,NaN,NaN,204.07019089952598,NaN,NaN,207.6381000000001,238.9930135473194,176.28318645268078,180.0405740767361,180.40333333333334,180.40333524068197,180.4033314259847,1185712,1121667.4333333333,30.457601852568843,35.9075854567035,NaN,NaN,NaN,NaN,7.397681788545236,32.252899979923676,758364798,-0.1265682613298571,-7.483324648026269,-7.356756386696412
2022-11-18T13:30:00-05:00,179.48,180.83,177.88,180.21,NaN,NaN,NaN,201.90290949500206,NaN,NaN,207.13930000000008,239.4166016226555,174.86199837734466,180.0405740767361,180.13329514551432,180.49827257927336,179.7683177117553,649079,1121494.9333333333,31.614062487182707,36.78932753075594,NaN,NaN,NaN,NaN,7.0799902322205766,33.07558057150828,759013877,-0.19179733356270923,-7.596503053649798,-7.4047057200870885
2022-11-21T09:30:00-05:00,175.85,176.72,168.54,169.85,NaN,NaN,NaN,195.74436815432014,NaN,NaN,206.14430000000007,239.8590138211184,172.42958617888175,180.0405740767361,171.70333333333335,171.70333333333335,171.70333333333335,1271791,1126395.9,25.276633085184997,36.23818707113772,NaN,NaN,NaN,NaN,7.407848072776251,34.52278511835349,757742086,-0.8162710277205445,-8.42504450473777,-7.608773477017225
2022-11-21T13:30:00-05:00,169.8,170.3,167.55,167.88,NaN,NaN,NaN,191.36371505639653,NaN,NaN,205.11290000000008,240.26110030044038,169.9646996995598,180.0405740767361,170.7360223932658,172.18127960837938,169.29076517815224,569715,1127352.5333333334,24.27991763513397,35.41555248624808,NaN,NaN,NaN,NaN,7.075144639006519,35.93011241943464,757172371,-1.221241827373568,-9.135325761234185,-7.914083933860617
2022-11-22T09:30:00-05:00,168.7,170.89,166.19,169.3,NaN,NaN,NaN,190.59968255383302,NaN,NaN,204.08210000000005,240.3307352896203,167.83346471037981,177.3204592613889,168.79333333333332,168.79333333333332,168.79333333333332,1212691,1124475.5666666667,26.52884603432473,34.39596239162499,NaN,NaN,NaN,NaN,6.9054914505060525,37.32653563578343,758385062,-1.2482778892300708,-9.474431295398205,-8.226153406168134
2022-11-22T13:30:00-05:00,169.31,170.01,167.43,169.92,NaN,NaN,NaN,190.12878789229515,NaN,NaN,203.0781000000001,240.2630201096341,165.89317989036607,173.9883674091111,168.89052962284157,169.03987375301972,168.74118549266342,513657,1129745,27.540766352152886,33.40981127723668,NaN,NaN,NaN,NaN,6.596527775469904,38.623214336678735,758898719,-1.085223557454757,-9.58268285298658,-8.497459295531822
2022-11-23T09:30:00-05:00,173.57,181.43,172.5,178.95,NaN,NaN,NaN,190.12878789229515,NaN,NaN,202.26450000000006,239.74418101518356,164.78481898481655,172.3306939272889,177.62666666666667,177.62666666666667,177.62666666666667,1793818,1159867.4,40.41319025599872,33.366529427840554,NaN,NaN,NaN,NaN,6.947490077222056,37.487388658872256,760692537,-0.27239183040790316,-8.837949083541702,-8.565557253133798
2022-11-23T13:30:00-05:00,178.95,183.61,178.87,183.28,NaN,NaN,NaN,190.12878789229515,NaN,NaN,201.48050000000006,238.87578645430972,164.0852135456904,171.0808441134649,179.10242067882263,181.14155137296692,177.06328998467833,939542,1155631.9333333333,45.42025205648333,33.92591777183798,NaN,NaN,NaN,NaN,6.789812214563338,36.06877730814346,761632079,0.6057756135802332,-7.8083377361585065,-8.41411334973874
2022-11-25T09:30:00-05:00,185.06,185.16,180.63,182.96,NaN,NaN,NaN,190.12878789229515,NaN,NaN,200.9747000000001,238.67295907969552,163.27644092030468,171.0808441134649,182.91666666666666,182.91666666666666,182.91666666666666,1270699,1158920.8333333333,45.11851104480663,34.15964472014794,NaN,NaN,NaN,NaN,6.628397056380243,34.49264084998152,760361380,1.1807264087559695,-6.938205338793779,-8.118931747549748
2022-11-25T13:30:00-05:00,182.93,182.93,182.64,182.7,NaN,NaN,NaN,190.12878789229515,NaN,NaN,200.48450000000008,238.48192634705532,162.48707365294484,171.20218247445715,182.91654864556472,182.92089254319802,182.9122047479314,938,1146286.5666666667,44.857757384891244,34.3873270498521,NaN,NaN,NaN,NaN,6.177797266638799,33.029085567402575,760360442,1.5366249575015756,-6.1981505506727785,-7.734775508174354
2022-11-28T09:30:00-05:00,179.95,188.5,179,186.1,NaN,NaN,NaN,190.12878789229515,NaN,NaN,199.9747000000001,238.04636087314643,161.90303912685377,174.3677459795657,183.7070971195883,184.5152984688449,182.8988957703317,1216711,1122253.4,49.007951104050825,35.25322605744645,NaN,NaN,NaN,NaN,6.415097461878885,30.74346571702446,761577153,1.9666393823795278,-5.276476280199944,-7.243115662579472
2022-11-28T13:30:00-05:00,186.08,186.21,182.67,182.94,NaN,NaN,NaN,190.12878789229515,NaN,NaN,199.34270000000004,237.47531476531535,161.21008523468473,174.3677459795657,183.75101606824606,184.48471641468868,183.01731572180344,578280,1101880.4,45.5747364400357,35.95047805633531,NaN,NaN,NaN,NaN,6.2097333574589655,28.62110442738764,760998873,1.9974398922302967,-4.746315797291601,-6.7437556895218975
2022-11-29T09:30:00-05:00,184.99,186.38,180.69,180.69,NaN,NaN,NaN,190.12878789229515,NaN,NaN,198.83030000000005,237.26201203108045,160.39858796891966,174.3677459795657,182.58666666666667,182.58666666666667,182.58666666666667,1067388,1082060.2,43.25138681467748,36.600138721350504,NaN,NaN,NaN,NaN,6.172609546211896,26.967114267037363,759931485,1.8299277450981037,-4.456346008149268,-6.286273753247372
2022-11-29T13:30:00-05:00,180.66,181.07,178.76,180.88,NaN,NaN,NaN,190.12878789229515,NaN,NaN,198.22270000000003,236.8094470103393,159.63595298966075,174.3677459795657,181.80402250385015,182.91157922791615,180.69646577978415,532990,1077392,43.51326099006379,37.346776681254006,NaN,NaN,NaN,NaN,5.896708864339617,25.73462276817092,760464475,1.6984426543046762,-4.163220435366526,-5.861663089671202
2022-11-30T09:30:00-05:00,182.43,185.46,180.67,182.45,NaN,NaN,NaN,190.12878789229515,NaN,NaN,197.46270000000004,235.76419684855563,159.16120315144445,174.3677459795657,182.85999999999999,182.85999999999999,182.85999999999999,850895,1034305.9333333333,45.74137268025175,38.43847459751707,NaN,NaN,NaN,NaN,5.817658231172503,23.97960789814045,761315370,1.6806285718920932,-3.7608773748060855,-5.441505946698179
2022-11-30T13:30:00-05:00,182.36,194.76,181.57,194.76,167.95154774042564,167.95154774042564,167.95154774042564,NaN,NaN,NaN,196.90990000000005,234.54787499813065,159.27192500186945,178.69731100258406,187.52190057294035,191.16147156601772,183.88232957986298,1396052,1040237.3666666667,59.29794451211671,40.41589474215521,NaN,NaN,NaN,NaN,6.3442540718030385,23.652146890456454,762711422,2.416566335925876,-2.420798026790834,-4.83736436271671
2022-12-01T09:30:00-05:00,197.08,198.9,191.79,194.85,175.08079557040628,NaN,NaN,NaN,NaN,NaN,196.31290000000004,233.1062120058512,159.51958799414888,182.49484880206725,195.17999999999998,195.17999999999998,195.17999999999998,1460364,1041672.7,59.377856705456786,42.85169642931748,NaN,NaN,NaN,NaN,6.398950209531393,23.815839278515412,764171786,2.8010023856896487,-1.336111380604649,-4.137113766294298
2022-12-01T13:30:00-05:00,194.82,195.38,193.15,194.71,175.08079557040628,NaN,NaN,NaN,NaN,NaN,195.71510000000006,231.61093666610773,159.8192633338924,182.49484880206725,194.97885412089158,195.3161257858351,194.64158245594805,519426,1010426.9,59.18320178998953,45.3447881546643,NaN,NaN,NaN,NaN,6.101168051707722,23.96783935314159,763652360,2.9239090839901953,-0.4822274113065532,-3.4061364952967486
2022-12-02T09:30:00-05:00,191.75,196.24,191.11,191.81,175.08079557040628,NaN,NaN,NaN,NaN,NaN,195.03630000000004,229.90348198019322,160.16911801980686,182.49484880206725,193.05333333333337,193.05333333333337,193.05333333333337,1253387,977188.2333333333,55.150077288458206,47.38916181567384,NaN,NaN,NaN,NaN,6.03179890515717,23.70983677542919,762398973,2.6936503468552693,-0.039073561727661854,-2.732723908582931
2022-12-02T13:30:00-05:00,191.77,195,191.39,194.89,175.08079557040628,NaN,NaN,NaN,NaN,NaN,194.43230000000003,228.22586206202516,160.6387379379749,182.49484880206725,193.24975460725872,193.5663348499459,192.93317436457156,482497,961970.2,58.39307189606653,49.59289792595338,NaN,NaN,NaN,NaN,5.858813269074516,23.47026295326767,762881470,2.629595155845713,0.5542700362242101,-2.075325119621503
2022-12-05T09:30:00-05:00,189.48,191.26,182.46,183.3,175.08079557040628,NaN,NaN,NaN,NaN,NaN,193.59050000000002,226.33823642559076,160.84276357440928,182.49484880206725,185.67333333333332,185.67333333333332,185.67333333333332,1361603,939672.2333333333,45.16011331006727,49.93196385838685,NaN,NaN,NaN,NaN,6.328183749854906,21.92029793397689,761519867,1.7308724991309812,0.0882655042922238,-1.6426069948387574
2022-12-05T13:30:00-05:00,183.34,183.98,180.56,182.43,175.08079557040628,NaN,NaN,NaN,NaN,NaN,192.66930000000005,223.99893989642882,161.33966010357128,182.49484880206725,184.70315208839412,186.22264395165584,183.1836602251324,555085,925166.9,44.347681259701645,49.85535165861673,NaN,NaN,NaN,NaN,6.120456339150984,20.764658156972935,760964782,1.036289319422235,-0.34724534556096387,-1.3835346649831988
2022-12-06T09:30:00-05:00,181.18,183.62,175.39,177.87,175.08079557040628,NaN,NaN,NaN,NaN,NaN,191.64810000000006,221.47609710942544,161.82010289057467,182.49484880206725,178.96,178.96,178.96,1078195,920129.1,40.259495451619316,49.508279116246214,NaN,NaN,NaN,NaN,6.271138029211629,20.404601393263253,759886587,0.2682189146206926,-1.048261021707333,-1.3164799363280255
2022-12-06T13:30:00-05:00,177.89,180.61,177.38,179.93,175.08079557040628,NaN,NaN,NaN,NaN,NaN,190.69710000000006,218.8815445104017,162.51265548959842,182.49484880206725,179.06220215036325,179.22026795707902,178.90413634364748,450756,915942.3333333334,42.823757365380544,49.36299340056688,NaN,NaN,NaN,NaN,6.053913884267943,20.070262969818554,760337343,-0.0837867300776427,-1.421213348925079,-1.3374266188474362
2022-12-07T09:30:00-05:00,175.03,179.37,172.22,174.62,NaN,NaN,NaN,195.20801489090206,195.20801489090206,195.20801489090206,189.61130000000006,215.9458183977213,163.27678160227882,182.49484880206725,175.40333333333334,175.40333333333334,175.40333333333334,1401359,925261.4333333333,38.26443045062315,48.59559906817918,NaN,NaN,NaN,NaN,6.172205749677376,20.417166647586683,758935984,-0.6267035415303397,-2.120806045760361,-1.4941025042300211
2022-12-07T13:30:00-05:00,174.6,174.61,172.24,173.96,NaN,NaN,NaN,192.28015057767925,NaN,NaN,188.53270000000003,212.847915253828,164.21748474617206,182.49484880206725,174.9133499679132,175.7145280750625,174.1121718607639,524148,925167.5,37.726780260247885,48.035030769622914,NaN,NaN,NaN,NaN,5.9013339104147065,20.739291491228514,758411836,-0.9626386564645202,-2.6974008248106713,-1.7347621683461512
2022-12-08T09:30:00-05:00,171.99,175.2,169.08,173.18,NaN,NaN,NaN,190.97264373323924,NaN,NaN,187.55850000000007,210.30213878098482,164.8148612190153,182.28370323332305,172.48666666666668,172.48666666666668,172.48666666666668,1770577,942283.4666666667,37.063966080592756,47.59307214575972,NaN,NaN,NaN,NaN,5.9169529168136545,21.424373376816533,756641259,-1.156695451529663,-3.18063148275823,-2.023936031228567
2022-12-08T13:30:00-05:00,173.24,174.45,171.36,173.38,NaN,NaN,NaN,190.97264373323924,NaN,NaN,186.72790000000003,208.4246173636935,165.03118263630657,182.28370323332305,172.66144307826258,172.92647314569308,172.39641301083208,769999,948731.2666666667,37.36781638643255,47.15411181692891,NaN,NaN,NaN,NaN,5.71502770846982,22.060520842005406,757411258,-1.1864752330289594,-3.507030072514766,-2.3205548394858067
2022-12-09T09:30:00-05:00,173.84,182.5,173.37,179,NaN,NaN,NaN,190.97264373323924,NaN,NaN,185.99950000000004,206.18721866754632,165.81178133245376,182.02996258665843,178.29,178.29,178.29,1876502,974545.1666666666,45.3519208598535,47.126293829757614,NaN,NaN,NaN,NaN,5.958954300721976,21.018732503293943,759287760,-0.763132304697764,-3.274470220358012,-2.5113379156602478
2022-12-09T13:30:00-05:00,178.91,181.64,178.65,179.01,NaN,NaN,NaN,190.97264373323924,NaN,NaN,185.27190000000007,203.71723836935394,166.8265616306462,174.66897006932675,178.65867880415897,179.2978123114745,178.01954529684343,624399,972608.5,45.36526669798574,46.131102557319686,NaN,NaN,NaN,NaN,5.74688613638469,20.051357617347584,759912159,-0.4342509372635517,-3.054151587239687,-2.6199006499761355
2022-12-12T09:30:00-05:00,176.1,177.37,169.72,169.94,NaN,NaN,NaN,190.97264373323924,NaN,NaN,184.57390000000007,202.64194419852768,166.50585580147245,168.9971760554614,172.34333333333333,172.34333333333333,172.34333333333333,1315200,976924.7666666667,36.62799130322178,44.50611217144575,NaN,NaN,NaN,NaN,5.999965698071498,20.369647084223626,758596959,-0.7602913926450321,-3.5702648907824255,-2.8099734981373934
2022-12-12T13:30:00-05:00,169.98,170.08,167.53,167.7,NaN,NaN,NaN,187.09042616034017,NaN,NaN,183.78050000000007,201.2488025219946,166.31219747800554,168.38680825592505,170.57943420566815,172.5235601771119,168.6353082342244,1082656,991377.3333333334,34.843166521229946,42.76753822367721,NaN,NaN,NaN,NaN,5.753539576780677,20.91520380337497,757514303,-1.0421250774462143,-4.112629844945161,-3.0705047674989467
2022-12-13T09:30:00-05:00,174.86,175.08,156.92,162.13,NaN,NaN,NaN,185.93063406214287,NaN,NaN,183.04270000000005,200.9838354389837,165.1015645610164,168.38680825592505,164.71,164.71,164.71,3094287,1052127.2,30.821319292113614,41.029769795366875,NaN,NaN,NaN,NaN,6.639715321296345,22.42340269194111,754420016,-1.4916142340708682,-4.935022560087532,-3.4434083260166637
2022-12-13T13:30:00-05:00,162.12,163.19,159.94,160.92,NaN,NaN,NaN,181.0328779684091,NaN,NaN,182.31950000000003,200.84466431775977,163.7943356822403,168.38680825592505,163.75261547769205,165.2692653619414,162.2359655934427,1232999,1074236.6666666667,30.01091442564639,39.00247283319401,NaN,NaN,NaN,NaN,6.397592798346606,23.82387308846681,753187017,-1.7409789232653696,-5.619631980098376,-3.878653056833006
2022-12-14T09:30:00-05:00,159.29,161.6,155.88,159.41,NaN,NaN,NaN,178.10297442439054,NaN,NaN,181.66210000000004,201.0400179573036,162.28418204269647,168.38680825592505,158.96333333333334,158.96333333333334,158.96333333333334,2241659,1108535.6,28.986620355310805,37.84722333642569,NaN,NaN,NaN,NaN,6.34919331275042,25.453759160857924,750945358,-1.867014620282017,-6.212421332185528,-4.345406711903511
2022-12-14T13:30:00-05:00,159.4,160.17,155.31,156.84,NaN,NaN,NaN,176.88556649600915,NaN,NaN,180.97350000000006,201.35763640554742,160.5893635944527,168.38680825592505,158.34043249121774,159.08935181734384,157.59151316509164,1550734,1143104.8333333333,27.28002317242182,36.62810490162,NaN,NaN,NaN,NaN,6.242822361839674,27.01252736442241,749394624,-1.972534514448327,-6.81107485496392,-4.838540340515593
2022-12-15T09:30:00-05:00,153.31,160.85,153.29,157.73,NaN,NaN,NaN,176.37622256437234,NaN,NaN,180.52310000000006,201.92124299325903,159.12495700674108,168.38680825592505,157.29,157.29,157.29,1611322,1137021.6333333333,28.842437002467832,35.8126007266806,NaN,NaN,NaN,NaN,6.336906478851126,28.62338173012948,751005946,-1.834359051659419,-7.1314891550898665,-5.297130103430447
2022-12-15T13:30:00-05:00,157.65,158.25,155.64,157.71,NaN,NaN,NaN,175.7295760841736,NaN,NaN,180.12510000000006,202.44556186708445,157.80463813291567,168.38680825592505,157.2621311627118,157.30374273876578,157.22051958665782,722756,1129795.4333333333,28.827447983393014,34.81286434225292,NaN,NaN,NaN,NaN,6.070698873218904,30.119175069714625,750283190,-1.6045766451207557,-7.302850909831392,-5.698274264710636
2022-12-16T09:30:00-05:00,159.635,160.95,150.03,151.17,NaN,NaN,NaN,174.9098226258021,NaN,NaN,179.38590000000005,203.00713838328528,155.76466161671482,168.38680825592505,154.04999999999998,154.04999999999998,154.04999999999998,2243083,1162208.2333333334,24.367891682979774,33.820254430278396,NaN,NaN,NaN,NaN,6.417077525131838,31.949917550041818,748040107,-1.7418563677537895,-7.875594724402873,-6.133738356649084
2022-12-16T13:30:00-05:00,151.18,151.62,150.15,150.19,NaN,NaN,NaN,169.62255796099288,NaN,NaN,178.57690000000005,203.34390715791022,153.80989284208988,162.12244660474005,152.98396577479275,154.56020622249744,151.40772532708806,1025989,1196376.6,23.774382143369166,32.82365456478706,NaN,NaN,NaN,NaN,6.063714844765278,33.64989271034563,747014118,-1.7432108380424491,-8.312751904202145,-6.569541066159696
2022-12-19T09:30:00-05:00,154,155.2,145.82,153.36,NaN,NaN,NaN,169.62255796099288,NaN,NaN,177.73710000000005,203.01452076162028,152.45967923837983,156.60695728379204,151.46,151.46,151.46,1777722,1215076.9666666666,29.73595386446847,32.30022512077819,NaN,NaN,NaN,NaN,6.300592355853473,35.5410907011006,748791840,-1.3904825549422002,-8.307644259837446,-6.917161704895245
2022-12-19T13:30:00-05:00,153.13,153.185,149.14,149.87,NaN,NaN,NaN,169.62255796099288,NaN,NaN,176.81710000000004,202.72818365854343,150.90601634145665,155.22156582703363,151.21504604042627,151.55914732141372,150.87094475943883,900866,1225829.8333333333,27.212586454231882,31.574851554192424,NaN,NaN,NaN,NaN,6.1519786161496555,37.29720312108735,747890974,-1.2561691112138345,-8.487373093912538,-7.231203982698704
2022-12-20T09:30:00-05:00,146.06,148.46,140.81,141.77,NaN,NaN,NaN,163.88202331675012,NaN,NaN,175.7435,202.89608604626912,148.5909139537309,145.67825266162689,143.67999999999998,143.67999999999998,143.67999999999998,2605279,1277092.8666666667,22.450756611057344,29.93905410784984,NaN,NaN,NaN,NaN,6.359694429281823,39.44280141809583,745285695,-1.5571311567659434,-9.177617928656133,-7.62048677189019
2022-12-20T13:30:00-05:00,141.76,142.24,137.66,137.81,NaN,NaN,NaN,158.94670407507965,NaN,NaN,174.68050000000002,203.47868982158482,145.88231017841522,144.7306021293015,142.36516508266047,144.39333148514925,140.3369986801717,1094938,1295824.4666666666,20.55686234642036,28.167025225595175,NaN,NaN,NaN,NaN,6.232573398618837,41.595146762319914,744190757,-1.8473843734808355,-9.929717238741233,-8.082332865260398
2022-12-21T09:30:00-05:00,139.335,141.25,135.9,138.27,NaN,NaN,NaN,157.43776298075784,NaN,NaN,173.55370000000002,203.5293599133373,143.57804008666275,144.32958536275297,138.47333333333333,138.47333333333333,138.47333333333333,1934024,1331928.7666666666,21.38646361878,27.07834467670648,NaN,NaN,NaN,NaN,6.169532441574634,43.67987305610675,746124781,-1.82942531375544,-10.369114507454697,-8.539689193699257
2022-12-21T13:30:00-05:00,138.28,140.75,137.24,137.49,NaN,NaN,NaN,157.43776298075784,NaN,NaN,172.41549999999998,203.44193983766306,141.3890601623369,144.32958536275297,138.4790580443712,138.48809806140204,138.47001802734033,775587,1311246.6,20.98627038709226,26.088566381410935,NaN,NaN,NaN,NaN,5.979565838605017,45.61569032890881,745349194,-1.6941904865972592,-10.65742730194583,-8.963236815348571
2022-12-22T09:30:00-05:00,136,136.55,122.27,124.07,NaN,NaN,NaN,149.12927370767397,NaN,NaN,171.1291,204.63415762955927,137.62404237044072,143.8729346321619,127.63,127.63,127.63,3562229,1381308.7666666666,15.583298126446195,25.00013629814897,NaN,NaN,NaN,NaN,6.6395968501332305,47.9998035962007,741786965,-2.295332581362784,-11.832402542052051,-9.537069960689267
2022-12-22T13:30:00-05:00,124.06,126.78,123.51,125.35,NaN,NaN,NaN,144.413852175507,NaN,NaN,169.8974,205.45288493495863,134.34191506504138,143.8729346321619,126.84211064983938,127.97493733625656,125.70928396342221,1723159,1421433.2,17.758163655817,24.124939814589727,NaN,NaN,NaN,NaN,6.3989113608379995,50.21362305868602,743510124,-2.38315741747998,-12.516016732539242,-10.132859315059262
2022-12-23T09:30:00-05:00,126.37,128.6,121.03,124.18,NaN,NaN,NaN,144.24026798571123,NaN,NaN,168.68740000000003,206.2115327809192,131.16326721908084,138.9926781645836,124.60333333333334,124.60333333333334,124.60333333333334,3379284,1492296.4333333333,17.31893981238329,23.29153406152347,NaN,NaN,NaN,NaN,6.482560549349571,52.34618586822991,740130840,-2.2955625959869757,-13.00231256004298,-10.706749964056005
2022-12-23T13:30:00-05:00,124.17,125.15,122.51,123.13,NaN,NaN,NaN,142.732301259088,NaN,NaN,167.4864,206.87581781951184,128.09698218048817,138.9926781645836,124.34502221981703,124.78469090899263,123.90535353064142,1166433,1515094.3,16.914608000503193,22.551147263529288,NaN,NaN,NaN,NaN,6.208091938681744,54.326422762806395,738964407,-2.0897198256747487,-13.318899746149441,-11.229179920474692
2022-12-27T09:30:00-05:00,117.495,119.64,111.61,112.83,NaN,NaN,NaN,135.23901483822033,NaN,NaN,166.1536,208.24775688857613,124.05944311142387,138.1091425316669,114.69333333333333,114.69333333333333,114.69333333333333,2792423,1562788.3,13.568245956595902,21.460133617395577,NaN,NaN,NaN,NaN,6.58751394306162,56.46000429875875,736171984,-2.4061026461686996,-14.236808228185566,-11.830705582016867
2022-12-27T13:30:00-05:00,112.78,113.27,108.76,109.09,NaN,NaN,NaN,130.3524687092103,NaN,NaN,164.73120000000003,209.54770278903993,119.91469721096013,131.86931402533352,113.19078535094441,115.24829764605694,111.13327305583188,1489200,1593925.4666666666,12.593947681014214,20.300597881511376,NaN,NaN,NaN,NaN,6.43912008998579,58.503379566671896,734682784,-2.6090931702618896,-15.09207204484423,-12.48297887458234
2022-12-28T09:30:00-05:00,110.33,116.24,108.26,112.08,NaN,NaN,NaN,130.3524687092103,NaN,NaN,163.57580000000004,210.7229617962316,116.42863820376849,126.89496878097076,112.19333333333333,112.19333333333333,112.19333333333333,2760593,1650005.4,17.683056441898145,19.82310965000554,NaN,NaN,NaN,NaN,6.5491829407010895,59.63103806216152,737443377,-2.2949309724528266,-15.351642590148373,-13.056711617695546
2022-12-28T13:30:00-05:00,112.08,114.59,110.55,112.7,NaN,NaN,NaN,130.3524687092103,NaN,NaN,162.47220000000004,211.70195527706846,113.24244472293162,126.89496878097076,112.33292313528902,112.53076752870993,112.13507874186811,1374239,1680788.1666666667,18.73959270049538,19.463481832657415,NaN,NaN,NaN,NaN,6.369955587793869,60.67814952225904,738817616,-1.8191136203509775,-15.330603643134268,-13.51149002278329
2022-12-29T09:30:00-05:00,120.4,123.57,117.49,119.16,NaN,NaN,NaN,130.3524687092103,NaN,NaN,161.46940000000004,212.12404044448485,110.81475955551522,126.89496878097076,120.07333333333334,120.07333333333334,120.07333333333334,3508567,1751028.4333333333,28.96937346913907,19.40872609013389,NaN,NaN,NaN,NaN,6.691387331522877,59.539443412475,742326183,-0.8900757965624404,-14.624084768486341,-13.7340089719239
2022-12-29T13:30:00-05:00,119.13,122.16,118.6,121.82,NaN,NaN,NaN,130.3524687092103,NaN,NaN,160.50740000000005,212.29778332509252,108.71701667490757,117.85597502477661,120.3230187847683,120.68918322479026,119.95685434474633,1631413,1787937.2666666666,32.72493809596226,19.802465493114628,NaN,NaN,NaN,NaN,6.467716807842672,58.48207345338983,743957596,0.03385168093152657,-13.691694370759492,-13.725546051691019
2022-12-30T09:30:00-05:00,119.99,124.47,119.78,121.14,NaN,NaN,NaN,130.3524687092103,NaN,NaN,159.35120000000003,212.01683990155274,106.68556009844733,111.54282401585702,121.79666666666667,121.79666666666667,121.79666666666667,2031561,1796636.7333333334,32.255428610131474,20.50279920733421,NaN,NaN,NaN,NaN,6.34073703585391,57.002413872198396,741926035,0.6929141353045853,-12.859403382560288,-13.552317517864873
2022-12-30T13:30:00-05:00,121.13,123.27,120.89,123.24,NaN,NaN,NaN,130.3524687092103,NaN,NaN,158.15040000000002,211.31445220974075,104.98634779025929,111.54282401585702,122.01447195674457,122.3283037587713,121.70064015471785,978527,1803587.6666666667,35.34068799490602,21.55878675365462,NaN,NaN,NaN,NaN,6.05782724757863,55.62844426109208,742904562,1.3272489955029823,-11.893256273486145,-13.220505268989127
2023-01-03T09:30:00-05:00,118.47,118.78,104.68,105.66,NaN,NaN,NaN,130.3524687092103,NaN,NaN,156.60440000000003,211.2673129351887,101.94148706481135,110.18425921268563,109.70666666666666,109.70666666666666,109.70666666666666,2760595,1833057.4333333333,25.053950504461568,21.820750102631873,NaN,NaN,NaN,NaN,6.950839587037299,55.60417069814726,740143967,0.6538755042983091,-12.403160888616242,-13.05703639291455
2023-01-03T13:30:00-05:00,105.67,109.39,105.36,108.07,NaN,NaN,NaN,127.30075341326955,NaN,NaN,155.11180000000002,210.90688260626604,99.316717393734,109.83731587011216,109.05086441533973,110.02405922366026,108.0776696070192,1253571,1854029.8333333333,28.14183901019804,22.331862147139425,NaN,NaN,NaN,NaN,6.7422081879632065,55.58163096112706,741397538,0.47037988923623075,-12.469061531369263,-12.939441420605494
2023-01-04T09:30:00-05:00,109.11,114.59,107.52,112.75,NaN,NaN,NaN,127.30075341326955,NaN,NaN,153.64480000000003,209.95841444482144,97.33118555517862,109.83731587011216,111.62,111.62,111.62,2989902,1909853.2333333334,33.8422610829915,23.636073786892663,NaN,NaN,NaN,NaN,6.765621888822978,54.50899539266578,744387440,0.7473433857328953,-12.005262188439374,-12.75260557417227
2023-01-04T13:30:00-05:00,112.83,114.3,111.85,113.63,NaN,NaN,NaN,127.30075341326955,NaN,NaN,152.25860000000003,209.0298515993793,95.48734840062077,109.83731587011216,112.05394065922714,112.77737564967262,111.33050566878165,1075768,1909623.6333333333,34.88821373857867,24.85964879280421,NaN,NaN,NaN,NaN,6.45736318247848,53.51297665052316,745463208,1.0541843793771513,-11.43487509995083,-12.489059479327981
2023-01-05T09:30:00-05:00,110.51,111.75,107.17,111.06,NaN,NaN,NaN,127.30075341326955,NaN,NaN,150.86600000000004,208.19257394263164,93.53942605736844,109.83731587011216,109.99333333333334,109.99333333333334,109.99333333333334,2856409,1901694.3666666667,33.23560481316386,25.996553435717107,NaN,NaN,NaN,NaN,6.45755152658716,52.970420968102,742606799,1.1410932578815647,-11.062692906976025,-12.20378616485759
2023-01-05T13:30:00-05:00,111.09,111.42,109.99,110.34,NaN,NaN,NaN,127.30075341326955,NaN,NaN,149.45520000000005,207.2279961227427,91.6824038772574,109.83731587011216,110.12875662869901,110.37687006109083,109.88064319630719,850955,1888959.5666666667,32.76731333979073,27.1288895313805,NaN,NaN,NaN,NaN,6.098440703259507,52.46661926299663,741755844,1.2010589360966382,-10.702462494736793,-11.90352143083343
2023-01-06T09:30:00-05:00,102.95,112.9,101.86,111.11,NaN,NaN,NaN,126.75577555224889,NaN,NaN,148.02840000000006,205.99467245010655,90.06212754989357,109.83731587011216,108.62333333333333,108.62333333333333,108.62333333333333,2468538,1896522.2,33.84091960182556,28.576937648896905,NaN,NaN,NaN,NaN,6.451409224455256,52.59206267013696,744224382,1.3333445012299947,-10.236840804295937,-11.570185305525932
2023-01-06T13:30:00-05:00,111.15,114.38,111.1,113.02,NaN,NaN,NaN,126.75577555224889,NaN,NaN,146.39360000000005,203.6014500571381,89.185749942862,109.83731587011216,109.9437693949352,111.89709589774174,107.99044289212867,1128041,1882432.4333333333,36.54761775684039,30.287914082884487,NaN,NaN,NaN,NaN,6.224879994137024,52.386581718923196,745352423,1.5737373174248255,-9.6030136587449,-11.176750976169725
2023-01-09T09:30:00-05:00,119,123.51,117.15,123.25,NaN,NaN,NaN,126.75577555224889,NaN,NaN,144.96160000000003,200.81447722006823,89.10872277993184,109.83731587011216,121.30333333333334,121.30333333333334,121.30333333333334,2169827,1901049.2666666666,48.66233830195529,32.50071993003142,NaN,NaN,NaN,NaN,6.529531423127238,50.45696481604875,747522250,2.396663972826511,-8.180921010136586,-10.577584982963097
2023-01-09T13:30:00-05:00,123.19,123.24,119.26,119.81,NaN,NaN,NaN,126.75577555224889,NaN,NaN,143.4636,197.8987343542022,89.02846564579782,107.73349507387583,121.1364214655663,121.38372712908959,120.88911580204301,988397,1909903.9666666666,45.515379013984536,34.41327609528065,NaN,NaN,NaN,NaN,6.348136321475292,48.66517769195106,746533853,2.6637224316123884,-7.247931943447611,-9.91165437506
2023-01-10T09:30:00-05:00,121.045,122.75,114.94,117.51,NaN,NaN,NaN,126.75577555224889,NaN,NaN,141.97760000000005,195.09302398362257,88.86217601637752,107.73349507387583,118.4,118.4,118.4,2320945,1912499.3666666667,43.49028815689434,35.450484287263166,NaN,NaN,NaN,NaN,6.452555155655629,47.438044651995654,744212908,2.6350548025281135,-6.617835871899857,-9.25289067442797
2023-01-10T13:30:00-05:00,117.51,118.88,116.665,118.85,NaN,NaN,NaN,126.75577555224889,NaN,NaN,140.45680000000004,191.74822266539334,89.16537733460675,107.73349507387583,118.32498989336165,118.44541080452996,118.20456898219334,900535,1908317.5666666667,45.02495320708719,36.329056795200664,NaN,NaN,NaN,NaN,6.149872644537369,46.298563972037066,745113443,2.648825068605353,-5.941859338671279,-8.590684407276632
2023-01-11T09:30:00-05:00,122.1,125.94,120.52,122.05,NaN,NaN,NaN,126.75577555224889,NaN,NaN,139.23180000000005,189.28246611984306,89.18113388015703,111.07046947782443,122.83666666666666,122.83666666666666,122.83666666666666,2951752,1947451.9,48.613892362596225,37.49751849180529,NaN,NaN,NaN,NaN,6.217024598498986,43.97824879453692,748065195,2.801136371676402,-5.089263942681129,-7.890400314357531
2023-01-11T13:30:00-05:00,122.04,123.26,121.28,123.2,NaN,NaN,NaN,126.75577555224889,NaN,NaN,138.04720000000006,186.73735096135962,89.3570490386405,111.07046947782443,122.76852504152927,122.88186701392922,122.65518306912932,1066899,1952986.3333333333,49.88020891988111,38.536055700732085,NaN,NaN,NaN,NaN,5.914379984320488,41.82367041542964,749132094,2.895087535330898,-4.271540895193908,-7.166628430524806
2023-01-12T09:30:00-05:00,122.5,122.92,117.01,120.33,NaN,NaN,NaN,126.75577555224889,NaN,NaN,136.89640000000006,184.47451408788703,89.31828591211308,111.07046947782443,120.08666666666666,120.08666666666666,120.08666666666666,1920843,1930171.8,46.78177660392062,40.088043279264866,NaN,NaN,NaN,NaN,5.934067128297596,40.353341347552615,747211251,2.684389120321166,-3.8111420301233494,-6.495531150444515
2023-01-12T13:30:00-05:00,120.34,124.13,119.85,123.55,NaN,NaN,NaN,126.75577555224889,NaN,NaN,135.76880000000006,181.86315829079314,89.67444170920697,111.2672003726461,121.0024635628612,122.17745172877225,119.82747539695013,1166872,1932569.6,50.497151147067854,41.68485128904128,NaN,NaN,NaN,NaN,5.81591947627634,38.766194797587154,748378123,2.676318717373495,-3.1501327537276467,-5.826451471101142
2023-01-13T09:30:00-05:00,116.55,121.64,115.6,120.48,NaN,NaN,NaN,126.75577555224889,NaN,NaN,134.68600000000006,179.607560257854,89.76443974214612,111.2672003726461,119.24,119.24000233601545,119.23999766398454,2490281,1951111.5,47.119534130624274,42.63322793530077,NaN,NaN,NaN,NaN,5.968353799399459,37.80898504095011,745887842,2.3881617135540214,-2.8412493291586145,-5.229411042712636
2023-01-13T13:30:00-05:00,120.5,122.62,120.22,122.37,NaN,NaN,NaN,126.75577555224889,NaN,NaN,133.6542000000001,177.27102099190597,90.0373790080942,111.2672003726461,120.05992865311735,121.2324496725799,118.8874076336548,1217753,1965850.3666666667,49.36498016937037,43.667282680357324,NaN,NaN,NaN,NaN,5.713471385156642,36.727928463314456,747105595,2.250650029699325,-2.4160985055884794,-4.666748535287804
2023-01-17T09:30:00-05:00,125.695,131.36,125.02,130.435,109.94653701943687,109.94653701943687,109.94653701943687,NaN,NaN,NaN,132.79930000000007,174.93419774569207,90.66440225430807,116.77524659079481,128.93833333333333,128.93833333333333,128.93833333333333,2752686,1938865.6,57.632375663509485,45.40990916966773,NaN,NaN,NaN,NaN,5.947509143359739,34.22635459928097,749858281,2.6037128910053715,-1.4121074215310898,-4.015820312536461
2023-01-17T13:30:00-05:00,130.47,131.7,130.11,131.48,113.27396715491702,NaN,NaN,NaN,NaN,NaN,131.9613000000001,172.46977342519676,91.45282657480345,119.23719727263584,129.596836574812,130.59063885754105,128.60303429208292,1208572,1921712.7,58.576142836208334,47.253396990840415,NaN,NaN,NaN,NaN,5.636258490262613,31.85181326329536,751066853,2.791815846255928,-0.5260505047165509,-3.317866350972479
2023-01-18T09:30:00-05:00,136.555,136.65,127.01,127.805,113.68583228423898,NaN,NaN,NaN,NaN,NaN,130.9374000000001,169.16191800820883,92.7128819917914,121.85975781810869,130.48833333333334,130.48833333333334,130.48833333333334,2596031,1895604.2666666666,54.018899456536275,48.694681266176886,NaN,NaN,NaN,NaN,5.922240026672426,30.229911589084384,748470822,2.5590819741964643,-0.11901388322689854,-2.678095857423363
2023-01-18T13:30:00-05:00,127.73,129.12,127.28,128.77,113.68583228423898,NaN,NaN,NaN,NaN,NaN,129.93260000000012,165.6057426280313,94.25945737196895,121.85975781810869,129.9378889072011,130.86094189660176,129.01483591780047,923174,1887495.6333333333,55.008737821231946,50.013332699347714,NaN,NaN,NaN,NaN,5.6306514533386816,28.723860034459914,749393996,2.3650573205368044,0.2782257932476426,-2.0868315272891618
2023-01-19T09:30:00-05:00,127.05,129.99,124.31,126.81,113.68583228423898,NaN,NaN,NaN,NaN,NaN,129.0700000000001,162.8683649900387,95.2716350099615,121.85975781810869,127.03666666666668,127.03666666666668,127.03666666666668,2385143,1873919.6333333333,52.53503574197887,50.28995394506369,NaN,NaN,NaN,NaN,5.634176349528777,26.81678703658902,747008853,2.013408837301243,0.4299295193373922,-1.5834793179638509
2023-01-19T13:30:00-05:00,126.83,128.71,126.79,127.12,113.68583228423898,NaN,NaN,NaN,NaN,NaN,128.2584000000001,160.20549291562983,96.31130708437038,121.85975781810869,127.18636152982685,127.41644382466461,126.9562792349891,1009629,1857933.9333333333,52.8958347474371,50.81712935459601,NaN,NaN,NaN,NaN,5.36887803884815,25.045933538566047,748018482,1.7216759167864903,0.5686155780192621,-1.1530603387672282
2023-01-20T09:30:00-05:00,128.66,131.69,127.35,130.47,113.68583228423898,NaN,NaN,NaN,NaN,NaN,127.62520000000012,158.08207849796608,97.16832150203416,121.85975781810869,129.83666666666667,129.83666666666667,129.83666666666667,1926821,1830141.5333333334,56.724132857344216,51.76240397605672,NaN,NaN,NaN,NaN,5.311815321787567,23.895352574668212,749945303,1.6728716823190741,0.9380292641316146,-0.7348424181874595
2023-01-20T13:30:00-05:00,130.49,133.5,130.45,133.42,115.46500125889715,NaN,NaN,NaN,NaN,NaN,127.07520000000014,156.06510044549748,98.08529955450278,122.85522144183784,130.94973088949013,132.24484335552387,129.65461842345638,1423203,1831773.6666666667,59.82089989026052,52.81925731056909,NaN,NaN,NaN,NaN,5.150257084517028,23.11390864212801,751368506,1.7495489620931304,1.4520937844289534,-0.29745517766417695
2023-01-23T09:30:00-05:00,135.87,143.88,134.27,143.75,121.88909211076545,NaN,NaN,NaN,NaN,NaN,126.76200000000011,154.6658119976444,98.85818800235583,130.13417715347026,140.63333333333333,140.63333333333333,140.63333333333333,2354739,1793312.7333333334,68.3592276366467,54.22963840157269,NaN,NaN,NaN,NaN,5.529524435622955,23.71957749397317,753723245,2.367842857296285,2.6623483939561794,0.2945055366598943
2023-01-23T13:30:00-05:00,143.73,145.35,141.35,143.8,126.39981519663975,NaN,NaN,NaN,NaN,NaN,126.50120000000014,153.50488949310179,99.4975105068985,132.3533417227762,141.6391233751018,143.00720640557796,140.27104034462565,1272719,1781356.2666666666,68.39423772856686,55.55206903076453,NaN,NaN,NaN,NaN,5.420272690221315,24.436502274934497,754995964,2.6317571896413967,3.58420202371164,0.9524448340702435
2023-01-24T09:30:00-05:00,143,146.45,141.12,143.36,126.87845996042886,NaN,NaN,NaN,NaN,NaN,126.21380000000016,152.16736134020593,100.2602386597944,133.38767337822097,143.64333333333335,143.64333333333335,143.64333333333335,1262872,1755733.3,67.68449213506597,57.045120140132056,NaN,NaN,NaN,NaN,5.413824640919792,25.21980383337437,753733092,2.62244948980521,4.230506696326756,1.6080572065215462
2023-01-24T13:30:00-05:00,143.31,144.17,142.77,143.91,127.14102996222755,NaN,NaN,NaN,NaN,NaN,125.93780000000015,150.8169927650366,101.05860723496372,133.38767337822097,143.63571322782383,143.64776050200777,143.6236659536399,505247,1739957.3,68.12970122468742,58.30458800281917,NaN,NaN,NaN,NaN,5.12712288085409,25.947155280497114,754238339,2.49958183271904,4.732534497420346,2.232952664701306
2023-01-25T09:30:00-05:00,141.905,144.75,138.07,144.61,127.14102996222755,NaN,NaN,NaN,NaN,NaN,125.80660000000015,150.21693284819878,101.3962671518015,133.38767337822097,142.47666666666666,142.47666666666666,142.47666666666666,1548384,1699550.2666666666,68.72035753899422,59.847503960559884,NaN,NaN,NaN,NaN,5.238042675078799,25.562133350404835,755786723,2.315853517026638,5.1277695609846035,2.8119160439579653
2023-01-25T13:30:00-05:00,144.63,146.4,143.88,144.44,129.04860374657508,NaN,NaN,NaN,NaN,NaN,125.69160000000015,149.69209419824216,101.69110580175816,135.33208876964915,143.51084121843456,144.71230996845233,142.3093724684168,1147206,1696004.7666666666,68.38886809994612,61.20635309845816,NaN,NaN,NaN,NaN,5.043896769716029,25.430472410620165,754639517,2.042810595356297,5.3654292881533365,3.3226186927970396
2023-01-26T09:30:00-05:00,159.965,161.41,154.77,158,140.41593993991262,NaN,NaN,NaN,NaN,NaN,125.78440000000015,150.24360404591806,101.32519595408223,144.0706710157193,158.06,158.06,158.06,3793070,1722777.0333333334,77.64989741190305,62.636176080486266,NaN,NaN,NaN,NaN,5.895761286164884,26.836788286430806,758432587,2.5996609157580766,6.572194837494635,3.9725339217365585
2023-01-26T13:30:00-05:00,158.03,160.5,156.84,160.27,141.3002153971893,NaN,NaN,NaN,NaN,NaN,125.99240000000015,151.42487618616488,100.55992381383541,144.79853681257546,158.39806983176047,158.9198315556338,157.87630810788713,1592426,1739998.9666666666,78.77113301285434,64.07867537881812,NaN,NaN,NaN,NaN,5.736064051438821,28.142653028254976,760025013,2.92105465105403,7.6238522355540965,4.7027975845000665
2023-01-27T09:30:00-05:00,162.43,178.88,161.21,176.72,150.92702378822617,NaN,NaN,NaN,NaN,NaN,126.69140000000017,155.5150878306685,97.86771216933185,157.01382945006037,172.27,172.27,172.27,4499046,1794753.5333333334,84.7439992398835,66.27332536334292,NaN,NaN,NaN,NaN,6.6556309049074756,30.472082357254976,764524059,3.9762975681916783,9.673169544739665,5.696871976547986
2023-01-27T13:30:00-05:00,176.8,180.67,176.03,177.88,159.46829543421586,NaN,NaN,NaN,NaN,NaN,127.49280000000016,159.55473962691354,95.43086037308677,160.8570635600483,174.31753735556248,177.13459913106934,171.50047558005562,2376793,1845614.8,85.06314703499703,68.42006887861186,NaN,NaN,NaN,NaN,6.511657268842654,32.71645593576128,766900852,4.451350491811623,11.261060091312515,6.809709599500892
2023-01-30T09:30:00-05:00,178.07,179.78,168.36,171.34,159.46829543421586,NaN,NaN,NaN,NaN,NaN,128.15420000000015,162.37016828148893,93.93823171851136,160.8570635600483,173.16,173.16,173.16,2610554,1850348.6666666667,75.47648816263916,70.05874405151617,NaN,NaN,NaN,NaN,6.862253178211035,33.43511365768648,764290298,4.036306968816358,11.85509331052134,7.818786341704982
2023-01-30T13:30:00-05:00,171.21,171.21,166.5,166.77,159.46829543421586,NaN,NaN,NaN,NaN,NaN,128.73980000000014,164.54039502075165,92.93920497924864,160.8570635600483,171.68672909498747,173.96616485093833,169.4072933390366,1090544,1849098.7666666666,69.57574354088688,71.25016610819115,NaN,NaN,NaN,NaN,6.717806522624533,33.79736488074654,763199754,3.2016467420965764,11.820844769325703,8.619198027229126
2023-01-31T09:30:00-05:00,164.57,173.7,162.79,171.97,159.46829543421586,NaN,NaN,NaN,NaN,NaN,129.69780000000014,167.45723591527644,91.93836408472386,160.8570635600483,169.48666666666665,169.4866699702914,169.4866633630419,1871620,1839158.5333333334,72.2355835333461,72.3581268707627,NaN,NaN,NaN,NaN,7.017248913865638,33.536410817296776,765071374,2.7639345380508225,12.074116199792655,9.310181661741833
2023-01-31T13:30:00-05:00,172,174.29,170.71,173.27,159.46829543421586,NaN,NaN,NaN,NaN,NaN,130.65620000000013,170.3106012467706,91.00179875322965,160.8570635600483,170.50831837789107,172.02391359979418,168.99272315598796,850466,1834560.8333333333,72.87406019074439,73.29049546365441,NaN,NaN,NaN,NaN,6.771731134303805,33.34516360244855,765921840,2.342778806689628,12.238655170103868,9.89587636341424
2023-02-01T09:30:00-05:00,173.89,175.82,169.95,174.33,159.46829543421586,NaN,NaN,NaN,NaN,NaN,131.65920000000008,173.10415474047392,90.21424525952625,160.8570635600483,173.36666666666667,173.3666685740153,173.36666475931804,1719839,1814523.9666666666,73.41097584797151,73.65133462160618,NaN,NaN,NaN,NaN,6.707321767567819,33.30481042044781,767641679,1.9334221249076489,12.312654019548802,10.379231894641153
2023-02-01T13:30:00-05:00,174.36,183.8,172.02,181.43,159.46829543421586,NaN,NaN,NaN,NaN,NaN,132.8252000000001,176.4668873166002,89.18351268340001,163.5673127898853,176.56076541933342,179.39930924101856,173.72222159764829,2177676,1857095.3333333333,76.73297353479748,74.2469586077655,NaN,NaN,NaN,NaN,7.069655927027261,33.91557004294828,769819355,1.9339720418501418,12.79669694695383,10.862724905103688
2023-02-02T09:30:00-05:00,187.325,196.76,185.1,193.4,169.58229907115833,NaN,NaN,NaN,NaN,NaN,134.43660000000008,180.86687354819196,88.0063264518082,172.90885023190825,191.75333333333333,191.75333333333333,191.75333333333333,3047183,1860276.3666666667,81.03497724316621,75.20056468691553,NaN,NaN,NaN,NaN,7.65968050366817,35.276053908752864,772866538,2.497798755414159,13.984973349371387,11.487174593957228
2023-02-02T13:30:00-05:00,193.43,195.54,182.63,188.32,169.58229907115833,NaN,NaN,NaN,NaN,NaN,136.02120000000008,184.2560849510389,87.78631504896126,172.90885023190825,190.74832077952013,192.1368222975798,189.35981926146044,1596426,1877927.2666666666,74.72068086994922,75.67134894729136,NaN,NaN,NaN,NaN,8.034703324834728,36.127153736579295,771270112,2.291335567903621,14.351344053836755,12.060008485933134
2023-02-03T09:30:00-05:00,183.965,199,183.78,191.96,169.58229907115833,NaN,NaN,NaN,NaN,NaN,137.61880000000008,187.82708901924428,87.41051098075587,172.90885023190825,191.58,191.58,191.58,3379618,1926553.1,76.1544590967375,76.2023562014159,NaN,NaN,NaN,NaN,8.547938801632247,37.12058351644713,774649730,2.1641603460895844,14.765208918545113,12.601048572455529
2023-02-03T13:30:00-05:00,191.91,193.08,188.2,190,169.58229907115833,NaN,NaN,NaN,NaN,NaN,139.16480000000007,190.94451903979373,87.38508096020641,172.90885023190825,191.23328355731852,191.76211939094168,190.70444772369535,1452696,1936080.5666666667,73.72953864779186,76.58383266911915,NaN,NaN,NaN,NaN,8.285943172944231,38.0430540263244,773197034,1.7310365438132376,14.764844252222076,13.033807708408839
2023-02-06T09:30:00-05:00,193.13,197.7,189.98,194.08,171.00684860006973,NaN,NaN,NaN,NaN,NaN,140.66320000000007,194.34185001134034,86.9845499886598,173.9432090549896,193.92,193.92,193.92,1923553,1917189.6333333333,75.4798452836734,76.42882894567417,NaN,NaN,NaN,NaN,8.245518660591072,39.17434031261389,775120587,1.510368470953214,14.921768297100357,13.411399826147143
2023-02-06T13:30:00-05:00,194.04,196.61,193.19,194.79,172.6383554818848,NaN,NaN,NaN,NaN,NaN,142.12260000000006,197.609982502331,86.63521749766912,175.8945672439917,194.17873016046687,194.59959532744125,193.7578649934925,726963,1900829.9666666666,75.78223249104238,76.21533605125903,NaN,NaN,NaN,NaN,7.9008387562631395,40.22482043559699,775847550,1.2159233560289557,14.931304021183337,13.715380665154381
2023-02-07T09:30:00-05:00,196.445,197.23,191.1,191.69,172.6383554818848,NaN,NaN,NaN,NaN,NaN,143.5336000000001,200.38620367089578,86.6809963291044,177.59265379519334,193.34,193.34,193.34,2244413,1883887.5333333334,71.6287208491259,75.27853045191921,NaN,NaN,NaN,NaN,7.774350273672915,40.773618104856105,773603137,0.6447548854797809,14.521324272004108,13.876569386524327
2023-02-07T13:30:00-05:00,191.7,197.48,189.55,196.77,172.6383554818848,NaN,NaN,NaN,NaN,NaN,145.00420000000008,203.46230990307458,86.54609009692558,177.80512303615467,193.78037997513863,194.38116633164168,193.17959361863558,1205918,1883799.0666666667,74.13088769328336,74.49765478465395,NaN,NaN,NaN,NaN,7.785468111267705,40.9655379518075,774809055,0.4506421349084775,14.439872055159924,13.989229920251447
2023-02-08T09:30:00-05:00,196.11,202.84,194.31,200.84,176.2561025655273,NaN,NaN,NaN,NaN,NaN,146.90780000000007,206.30838485099252,87.5072151490076,182.83509842892374,199.33,199.33,199.33,2386874,1876827.1666666667,75.96018325690999,74.53220443424472,NaN,NaN,NaN,NaN,7.838648960462869,41.5504436492803,777195929,0.4375533709403836,14.536171633926926,14.098618262986543
2023-02-08T13:30:00-05:00,200.8,202.9,199.55,201.33,179.46377972163975,NaN,NaN,NaN,NaN,NaN,148.77300000000005,209.02900126128515,88.51699873871497,185.221078743139,199.90203058084143,200.7833931825033,199.02066797917956,1005446,1879569.5666666667,76.17858508173092,75.00383597287644,NaN,NaN,NaN,NaN,7.518031177572665,42.097974044556494,778201375,0.30914856028555704,14.48505396334349,14.175905403057932
2023-02-09T09:30:00-05:00,207.775,214,205.65,211.91,187.32519882520154,NaN,NaN,NaN,NaN,NaN,150.7562000000001,212.64435151739406,88.86804848260613,193.5218629945112,210.51999999999998,210.51999999999998,210.51999999999998,2573001,1885831.5,80.33321821366864,75.58223845004234,NaN,NaN,NaN,NaN,7.886028950603188,43.31218155124866,780774376,0.7584126937809916,15.123921270284171,14.36550857650318
2023-02-09T13:30:00-05:00,212.06,212.74,204.79,207.32,187.32519882520154,NaN,NaN,NaN,NaN,NaN,152.63000000000008,215.57273184411318,89.68726815588698,193.5218629945112,209.8207598226809,210.85759653645164,208.7839231089102,1170232,1891184.9333333333,74.28048465870971,75.6826973406113,NaN,NaN,NaN,NaN,7.89059831127439,44.25811956780907,779604144,0.5763548258568072,15.085952108824188,14.50959728296738
2023-02-10T09:30:00-05:00,202.225,206.19,192.91,196.64,187.32519882520154,NaN,NaN,NaN,NaN,NaN,154.34160000000008,217.32393410854147,91.3592658914587,193.5218629945112,198.58,198.58,198.58,3589557,1946609.4666666666,62.483637661564366,74.90217318443935,NaN,NaN,NaN,NaN,8.356269860469077,42.98923685315179,776014587,-0.38182286942690347,14.03231869618375,14.414141565610654
2023-02-10T13:30:00-05:00,196.72,197.78,194.8,196.84,187.32519882520154,NaN,NaN,NaN,NaN,NaN,156.07160000000007,218.87606374072436,93.26713625927579,193.5218629945112,198.0798378879288,198.97622659327817,197.1834491825794,1117557,1936421.2666666666,62.60341278166623,73.89291884492998,NaN,NaN,NaN,NaN,7.972250584721285,41.81098861811287,777132144,-1.0810217445691173,13.062864384899257,14.143886129468374
2023-02-13T09:30:00-05:00,194.415,196.28,187.63,194.75,187.32519882520154,NaN,NaN,NaN,NaN,NaN,157.74440000000007,220.12360710108427,95.36519289891586,193.5218629945112,192.88666666666666,192.88666666666666,192.88666666666666,2205566,1931448.8333333333,60.432137816157955,72.42128745728652,NaN,NaN,NaN,NaN,8.060661257241193,39.64639626487269,774926578,-1.7249231350121619,11.987732210703172,13.712655345715334
2023-02-13T13:30:00-05:00,194.76,195.69,193.09,194.66,187.32519882520154,NaN,NaN,NaN,NaN,NaN,159.37720000000007,221.2601580792642,97.49424192073596,193.5218629945112,193.3353095969753,194.05193868981306,192.61868050413753,864436,1917839.4,60.335094033489675,71.39374554039657,NaN,NaN,NaN,NaN,7.670614024581107,37.636417651149664,774062142,-2.1688439820763623,11.001600368119881,13.170444350196243
2023-02-14T09:30:00-05:00,191.95,204.75,189.5,203.8,187.32519882520154,NaN,NaN,NaN,NaN,NaN,160.98820000000006,223.2182254141035,98.75817458589663,193.5218629945112,199.35,199.35,199.35,3045654,1977265.4666666666,66.26060050671961,70.6870413553953,NaN,NaN,NaN,NaN,8.211998737111028,36.70514955705754,777107796,-1.8701695632859092,10.832732396088858,12.702901959374767
2023-02-14T13:30:00-05:00,203.95,209.8,202.41,209.29,187.32519882520154,NaN,NaN,NaN,NaN,NaN,162.77780000000007,225.31386134575436,100.24173865424578,193.5218629945112,201.59144711199832,205.1264944623973,198.05639976159935,1224467,2001239.4666666666,69.23367320421073,70.3659081094252,NaN,NaN,NaN,NaN,8.153284541603098,36.27968209746138,778332263,-1.3503798030911387,11.014927205510844,12.365307008601983
2023-02-15T09:30:00-05:00,211.755,214.65,206.14,212.86,187.32519882520154,NaN,NaN,NaN,NaN,NaN,164.68480000000008,227.3979295331364,101.97167046686376,193.5218629945112,211.2166666666667,211.2166666666667,211.2166666666667,1948651,2014581.7,71.02188465637093,70.04748235033217,NaN,NaN,NaN,NaN,8.178764217202877,36.269422560483235,780280914,-0.8386995945663394,11.316932515394058,12.155632109960397
2023-02-15T13:30:00-05:00,212.96,214.21,209.7,214.21,188.93941123440095,NaN,NaN,NaN,NaN,NaN,166.59200000000007,229.41349546134632,103.77050453865382,194.92373766545055,211.67009504051637,212.35566851346698,210.98452156756576,852400,2004754.8333333333,71.69192928600751,69.75531783568684,NaN,NaN,NaN,NaN,7.916709630259816,36.25989584757495,781133314,-0.4986890656102023,11.532270777947645,12.030959843557847
2023-02-16T09:30:00-05:00,210.78,217.65,208.39,210.75,189.78784708738272,NaN,NaN,NaN,NaN,NaN,168.3660000000001,231.06549859448577,105.66650140551442,197.59099013236045,212.26333333333332,212.26333333333332,212.26333333333332,2396770,1958211.5,67.39099807942367,69.45262335213667,NaN,NaN,NaN,NaN,8.012658942384116,36.5254146595949,778736544,-0.5899280294899949,11.293549806695353,11.883477836185348
2023-02-16T13:30:00-05:00,210.76,214,201.85,201.92,189.78784708738272,NaN,NaN,NaN,NaN,NaN,169.94040000000007,231.97413639689893,107.90666360310121,197.59099013236045,209.56598849924163,212.70055339634322,206.43142360214003,1774781,1964290,57.85243116391754,68.28987645718198,NaN,NaN,NaN,NaN,8.308183303642393,35.6757430469177,776961763,-1.2880392129280018,10.273428820025345,11.561468032953346
2023-02-17T09:30:00-05:00,199.985,204.56,197.5,201.34,189.78784708738272,NaN,NaN,NaN,NaN,NaN,171.56060000000008,232.54964579151866,110.5715542084815,197.59099013236045,201.13333333333333,201.13333333333333,201.13333333333333,2594259,1900797.1,57.27893809492494,66.95550180275447,NaN,NaN,NaN,NaN,8.219027353382222,34.238535762447384,774367504,-1.8004985763010186,9.310844812577074,11.111343388878092
2023-02-17T13:30:00-05:00,201.34,208.42,200.91,208.4,189.78784708738272,NaN,NaN,NaN,NaN,NaN,173.25760000000005,233.52628477874703,112.98891522125308,197.59099013236045,202.99989784509512,205.33054011879335,200.6692555713969,1663980,1877036.6666666667,62.191994174396136,65.9564595950877,NaN,NaN,NaN,NaN,8.168382542426349,33.29640184310369,776031484,-1.6780603568780474,9.013767942780532,10.69182829965858
2023-02-21T09:30:00-05:00,204.87,209.68,199.12,201.87,189.78784708738272,NaN,NaN,NaN,NaN,NaN,174.8854000000001,233.7443074258086,116.02649257419156,197.59099013236045,203.5566666666667,203.5566666666667,203.5566666666667,2020994,1857384.6666666667,55.79999109803308,64.20408622968516,NaN,NaN,NaN,NaN,8.339212360824467,32.1494834954907,774010490,-2.027556458642435,8.157382726355536,10.18493918499797
2023-02-21T13:30:00-05:00,201.74,201.76,197.25,197.31,189.78784708738272,NaN,NaN,NaN,NaN,NaN,176.38420000000005,233.61168477296522,119.15671522703488,197.59099013236045,202.14264163170583,204.32536614121233,199.95991712219933,848167,1849305.4333333333,51.79649670690375,62.59808709027044,NaN,NaN,NaN,NaN,8.073554335051291,30.798153031996726,773162323,-2.524188677847972,7.029703337688005,9.553892015535977
2023-02-22T09:30:00-05:00,197.93,200.85,191.8,199.7,189.78784708738272,NaN,NaN,NaN,NaN,NaN,177.76950000000008,233.82208774579397,121.71691225420619,197.59099013236045,197.44999999999996,197.44999999999996,197.44999999999996,2295676,1863440.6333333333,53.672616681504024,61.96872844883756,NaN,NaN,NaN,NaN,8.143300453976197,28.759496867370377,775457999,-2.6377227832682575,6.256738536450655,8.894461319718912
2023-02-22T13:30:00-05:00,199.7,201.99,196.83,200.86,189.78784708738272,NaN,NaN,NaN,NaN,NaN,179.15710000000007,233.97887604164205,124.33532395835809,197.59099013236045,198.37116137163596,199.55529228167381,197.1870304615981,1389257,1881400.3333333333,54.596289413759855,61.39679106541568,NaN,NaN,NaN,NaN,7.9302075644064685,27.01562410214508,776847256,-2.577670590115643,5.672373082074358,8.250043672190001
2023-02-23T09:30:00-05:00,203.94,205.1,196.36,199.15,189.78784708738272,NaN,NaN,NaN,NaN,NaN,180.5840000000001,233.67163682817232,127.49636317182785,197.59099013236045,200.20333333333338,200.20333333333338,200.20333333333338,1947166,1888977.9,52.92121926910413,60.86029688348326,NaN,NaN,NaN,NaN,7.988049881234576,25.799855832792318,774900090,-2.5892475656122302,5.013484215174714,7.602731780786944
2023-02-23T13:30:00-05:00,199.13,203.26,198.8,201.99,189.78784708738272,NaN,NaN,NaN,NaN,NaN,182.04840000000007,233.3475365790878,130.74926342091234,197.59099013236045,200.6589171887252,201.22002873873436,200.09780563871607,1283634,1859176.5,55.37028743754387,60.5056678409157,NaN,NaN,NaN,NaN,7.736046318289247,24.67092815410761,776183724,-2.348841642821643,4.66667972725989,7.015521370081533
2023-02-24T09:30:00-05:00,196.325,197.65,192.8,195.53,189.78784708738272,NaN,NaN,NaN,NaN,NaN,183.42280000000005,232.35625817168423,134.48934182831587,191.87779210588835,195.32666666666668,195.32666666666668,195.32666666666668,1724840,1815098.4,49.11191509763987,59.28076174026715,NaN,NaN,NaN,NaN,7.839900152697159,23.11188730058165,774458884,-2.5512509851077336,3.8264576386968656,6.377708623804599
2023-02-24T13:30:00-05:00,195.45,197.32,194.79,196.86,189.78784708738272,NaN,NaN,NaN,NaN,NaN,184.81760000000006,231.15921957635874,138.47598042364137,187.81022955821484,195.65658061523413,196.1255912994943,195.18756993097398,853463,1790332.9666666666,50.35601445738683,57.93235754406544,NaN,NaN,NaN,NaN,7.460621570361647,21.664206508021827,775312347,-2.517643306398706,3.2306544908062165,5.7482977972049225
2023-02-27T09:30:00-05:00,202.03,208.17,201.31,207.13,189.78784708738272,NaN,NaN,NaN,NaN,NaN,186.35080000000008,230.4152689227036,142.28633107729655,189.44529126227755,205.53666666666666,205.53666666666666,205.53666666666666,1608462,1731294.4333333333,58.743548833925786,57.05533355674793,NaN,NaN,NaN,NaN,7.735577172478671,21.35825778633165,776920809,-1.7615983684993655,3.5462998365807152,5.307898205080081
2023-02-27T13:30:00-05:00,207.17,209.4,206.38,207.65,189.78784708738272,NaN,NaN,NaN,NaN,NaN,187.83540000000008,229.60883868249198,146.06196131750818,192.91023300982206,206.3454281081852,207.43377055173252,205.25708566463786,888220,1712478.5666666667,59.12016107514864,56.15735011311516,NaN,NaN,NaN,NaN,7.3987502315873375,21.21252640464494,777809029,-1.2105840606304596,3.794668129292006,5.005252189922466
2023-02-28T09:30:00-05:00,210.59,211.23,203.75,207.24,189.78784708738272,NaN,NaN,NaN,NaN,NaN,189.10520000000008,229.27000912241334,148.94039087758682,194.29818640785763,207.40666666666667,207.40666666666667,207.40666666666667,1683902,1704490.2,58.665434794734374,55.53409559278021,NaN,NaN,NaN,NaN,7.404553786473955,20.640640738369882,776125127,-0.8735553214879754,3.913308038062496,4.7868633595504715
2023-02-28T13:30:00-05:00,207.33,209.4,204.93,205.72,189.78784708738272,NaN,NaN,NaN,NaN,NaN,190.34360000000007,228.61835131414875,152.06884868585138,194.29818640785763,207.17323264304923,207.51140296558017,206.8350623205183,802369,1707003.7333333334,56.91758024648192,55.46732052724909,NaN,NaN,NaN,NaN,7.194942801725816,20.109604048257328,775322758,-0.7571627922111741,3.8404098692865034,4.5975726614976775
2023-03-01T09:30:00-05:00,206.21,207.2,198.54,201.02,189.78784708738272,NaN,NaN,NaN,NaN,NaN,191.49680000000006,227.44341673982564,155.5501832601745,194.29818640785763,202.25333333333333,202.25333333333333,202.25333333333333,2061054,1700891.7666666666,51.780372605676575,55.07456584944564,NaN,NaN,NaN,NaN,7.299589744459686,18.749840974683366,773261704,-0.9863766973371169,3.364601789826281,4.350978487163398
2023-03-01T13:30:00-05:00,200.99,203.4,200.71,202.81,189.78784708738272,NaN,NaN,NaN,NaN,NaN,192.67480000000006,226.07670587137102,159.2728941286291,194.29818640785763,202.26729541537995,202.29074119616874,202.24384963459116,730904,1685057.9666666666,53.50167761245923,54.45382895216443,NaN,NaN,NaN,NaN,6.970333334141137,17.487203834936114,773992608,-1.003769458179371,3.0962666644391845,4.1000361226185555
2023-03-02T09:30:00-05:00,186.73,193.68,186.01,189.78,NaN,NaN,NaN,212.69073873584728,212.69073873584728,212.69073873584728,193.57820000000007,224.04580868594587,163.11059131405426,194.29818640785763,189.82333333333335,189.82333333333335,189.82333333333335,2529294,1689805.3,41.80340563498956,53.45407284766132,NaN,NaN,NaN,NaN,7.6724523817024854,18.093959182742562,771463314,-1.8309750563194775,1.8113173022192086,3.642292358538686
2023-03-02T13:30:00-05:00,189.76,191.6,188.81,190.87,NaN,NaN,NaN,212.39275061149056,NaN,NaN,194.50680000000008,221.56687610927736,167.4467238907228,194.29818640785763,190.00141136702476,190.2765997163128,189.72622301773671,1059156,1691595.6333333333,42.9276147528189,52.8205812795124,NaN,NaN,NaN,NaN,7.3237057830094505,18.65737486284855,772522470,-2.2171135922222134,0.8709003682609193,3.0880139604831327
2023-03-03T09:30:00-05:00,194.795,200.47,192.92,199.61,NaN,NaN,NaN,212.39275061149056,NaN,NaN,195.33900000000008,220.33782373232557,170.3401762676746,194.29818640785763,197.66666666666666,197.66666666666666,197.66666666666666,2446327,1687373.1666666667,51.086774774103965,52.63587828612669,NaN,NaN,NaN,NaN,7.486298227080204,17.832479347122092,774968797,-1.8132994397300832,0.8213896608205289,2.634689100550612
2023-03-03T13:30:00-05:00,199.67,200.37,196.83,197.86,NaN,NaN,NaN,212.39275061149056,NaN,NaN,196.0908000000001,218.99935799564636,173.1822420043538,194.29818640785763,197.87014174541707,198.1836978749986,197.55658561583556,1030164,1682704.2333333334,49.559020726831086,52.27607337991749,NaN,NaN,NaN,NaN,7.204419782288761,17.066504939661804,773938633,-1.6008412684550386,0.6336375149818139,2.2344787834368525
2023-03-06T09:30:00-05:00,198.55,198.55,192.31,194.28,NaN,NaN,NaN,212.39275061149056,NaN,NaN,196.4420000000001,218.68054203853922,174.20345796146097,194.29818640785763,195.04666666666665,195.04666666666665,195.04666666666665,1900722,1626409.7333333334,46.495733486316354,51.81711010971837,NaN,NaN,NaN,NaN,7.135532654982421,16.894902592451704,772037911,-1.6325964111528237,0.19373326949582292,1.8263296806486466
2023-03-06T13:30:00-05:00,194.27,195.49,193.25,193.81,NaN,NaN,NaN,212.39275061149056,NaN,NaN,196.7606000000001,218.37395454203903,175.14724545796116,194.29818640785763,194.83165553703907,195.2050139297221,194.45829714435604,630360,1610169.8333333333,46.09292483677312,51.15444135252046,NaN,NaN,NaN,NaN,6.785851751055105,16.735557555756607,771407551,-1.6135611188632926,-0.190621717930469,1.4229394009328236
2023-03-07T09:30:00-05:00,191.39,194.2,186.1,192.395,NaN,NaN,NaN,211.4112281086696,NaN,NaN,197.18170000000006,217.5840508067065,176.77934919329363,193.61954912628613,190.8983333333333,190.8983333333333,190.8983333333333,2259805,1611977.8,44.833614684120484,50.8488484658405,NaN,NaN,NaN,NaN,6.879719483122598,17.37902587654499,769147746,-1.6203192875020287,-0.6024597084447123,1.0178595790573164
2023-03-07T13:30:00-05:00,192.34,192.87,187.45,187.67,NaN,NaN,NaN,211.19389955827558,NaN,NaN,197.5997000000001,216.27602452170007,178.92337547830013,190.2456393010289,190.40222056584628,191.13156432037064,189.6728768113219,1045604,1618016.7333333334,40.822811042840485,50.16790536480148,NaN,NaN,NaN,NaN,6.775453805756698,17.97653217441992,768102142,-1.850433455204223,-1.2951822399479624,0.5552512152562605
2023-03-08T09:30:00-05:00,184.64,186.47,180,180.34,NaN,NaN,NaN,204.35872230562669,NaN,NaN,197.76710000000006,215.65492447252734,179.87927552747277,188.49151144082313,182.27,182.27,182.27,2013525,1583612.4333333333,35.51488457073526,48.50871506028786,NaN,NaN,NaN,NaN,6.839349962488362,19.25070122537335,766088617,-2.3705073731744375,-2.4078830012117862,-0.03737562803734884
2023-03-08T13:30:00-05:00,180.4,182.57,180.16,182.05,NaN,NaN,NaN,201.85718947355275,NaN,NaN,197.9427000000001,215.01913021359726,180.8662697864029,183.45988308616117,182.04864763560383,182.366114007596,181.73118126361166,978881,1575426.2333333334,37.5547349967663,46.96832748326056,NaN,NaN,NaN,NaN,6.522967822310622,20.433858201258676,767067498,-2.462744764277912,-3.115806583384739,-0.6530618191068269
2023-03-09T09:30:00-05:00,180.25,185.18,177.63,178.05,NaN,NaN,NaN,201.85718947355275,NaN,NaN,198.01710000000006,214.70946712871933,181.3247328712808,183.45988308616117,180.28666666666666,180.28666666666666,180.28666666666666,1836460,1571686.5333333334,34.78298381743218,45.26243812773897,NaN,NaN,NaN,NaN,6.596327263574149,21.02585169515538,765231038,-2.6407730393745146,-3.9540281183249704,-1.3132550789504558
2023-03-09T13:30:00-05:00,178,178.05,172.54,172.93,NaN,NaN,NaN,195.70071396247266,NaN,NaN,197.84710000000007,215.36446214045654,180.3297378595436,183.45988308616117,177.90173932428877,180.74726240634533,175.0562162422322,1290053,1586274.9666666666,31.571005491615267,43.45196850239135,NaN,NaN,NaN,NaN,6.5187324590331395,22.078806966173303,763940985,-2.928697769699641,-4.974127291075007,-2.045429521375366
2023-03-10T09:30:00-05:00,175.09,178.29,168.5,173.83,NaN,NaN,NaN,194.20818150963296,NaN,NaN,197.45570000000004,216.1855892692921,178.72581073070796,183.45988308616117,173.54,173.54,173.54,3232903,1614146.0666666667,32.746652409772366,42.092417059826765,NaN,NaN,NaN,NaN,6.752394426245057,23.413991891490785,767173888,-2.8795525481630326,-5.6448702065791565,-2.765317658416124
2023-03-10T13:30:00-05:00,173.77,175.5,171.77,173.38,NaN,NaN,NaN,194.01076416828602,NaN,NaN,197.15690000000006,216.90901106590695,177.40478893409318,181.90190646892893,173.54292636967904,173.54747610147274,173.53837663788534,1337456,1599568.5666666667,32.4464880427347,40.58847494770358,NaN,NaN,NaN,NaN,6.536509110084695,24.653806464999878,765836432,-2.7013054480741965,-6.141949468508869,-3.440644020434673
2023-03-13T09:30:00-04:00,167.455,174.5,163.92,173.15,NaN,NaN,NaN,190.10232034245482,NaN,NaN,196.78070000000002,217.60197911632653,175.95942088367352,181.05152517514313,170.5233333333333,170.5233333333333,170.5233333333333,2743953,1604558.3666666667,32.28360560370923,39.908489231183566,NaN,NaN,NaN,NaN,6.825329887935789,26.436878841768962,763092479,-2.4312870915798745,-6.479752884909516,-4.048465793329641
2023-03-13T13:30:00-04:00,173.12,177.34,172.84,174.43,NaN,NaN,NaN,190.10232034245482,NaN,NaN,196.46930000000003,218.13549154443024,174.80310845556983,178.59922014011448,171.7432101934973,173.69623311490747,169.79018727208714,1070518,1584776.3,34.261456118733705,39.289477900177474,NaN,NaN,NaN,NaN,6.659234895940375,27.504949680881168,764162997,-2.0159970304617323,-6.568462081406807,-4.552465050945075
2023-03-14T09:30:00-04:00,177.31,183.8,177.17,182.64,NaN,NaN,NaN,190.10232034245482,NaN,NaN,196.24050000000003,218.24181180179926,174.2391881982008,177.6793761120916,181.20333333333335,181.20333333333335,181.20333333333335,1920913,1581440.2666666666,45.29773822594368,38.87597528959459,NaN,NaN,NaN,NaN,6.852860974801777,27.29787190182842,766083910,-1.0845723952209703,-5.908180544971287,-4.823608149750317
2023-03-14T13:30:00-04:00,182.49,183.45,179.97,183.34,NaN,NaN,NaN,190.10232034245482,NaN,NaN,196.0115,218.30485042114535,173.71814957885468,170.48250088967328,181.54774012437866,182.04070167752076,181.05477857123657,937616,1584421.9,46.12817009440436,38.63091453013554,NaN,NaN,NaN,NaN,6.611942333744507,27.105585392708008,767021526,-0.3552701219895287,-5.2676958022372276,-4.912425680247699
2023-03-15T09:30:00-04:00,180.88,182.31,176.05,178.4,NaN,NaN,NaN,190.10232034245482,NaN,NaN,195.74570000000003,218.54986716391988,172.94153283608017,170.2090005693909,178.92,178.92,178.92,1951892,1572962.4333333333,41.35664102257031,38.263836497010814,NaN,NaN,NaN,NaN,6.660375024191326,27.342240469137124,765069634,-0.15000735124218245,-5.0999348693004265,-4.949927518058244
2023-03-15T13:30:00-04:00,178.28,180.85,176.5,180.52,NaN,NaN,NaN,190.10232034245482,NaN,NaN,195.42070000000004,218.61702212312883,172.22437787687124,170.2090005693909,179.02973169517833,179.1987277965738,178.86073559378286,822937,1554085.1,44.03225086157588,38.116645498782454,NaN,NaN,NaN,NaN,6.495348236749089,27.561991611535586,765892571,0.16693200170670774,-4.741262515924859,-4.908194517631567
2023-03-16T09:30:00-04:00,180.34,185.81,178.89,184.92,NaN,NaN,NaN,190.10232034245482,NaN,NaN,195.10230000000004,218.42901251676878,171.7755874832313,170.15369000458747,183.20666666666668,183.20666666666668,183.20666666666668,2227418,1563426.8333333333,49.21154360593052,38.42935470748317,NaN,NaN,NaN,NaN,6.525680505552726,26.819194969045324,768119989,0.682377389951065,-4.055222780192736,-4.737600170143801
2023-03-16T13:30:00-04:00,184.93,185.38,183.67,184.03,NaN,NaN,NaN,190.10232034245482,NaN,NaN,194.7563,218.21608642784307,171.29651357215695,171.99995200366996,183.55336791015972,184.08219713456398,183.02453868575546,957374,1552551.5,48.239123259483,38.959091294386205,NaN,NaN,NaN,NaN,6.181703326584675,26.129455229590082,767162615,0.9560712987348845,-3.5425110467251955,-4.49858234546008
2023-03-17T09:30:00-04:00,184.53,186.17,177.34,179.87,NaN,NaN,NaN,190.10232034245482,NaN,NaN,194.11550000000003,217.4158708339587,170.81512916604134,171.99995200366996,181.12666666666667,181.12666666666667,181.12666666666667,2087662,1564645.5666666667,43.87504406958822,39.55624554430427,NaN,NaN,NaN,NaN,6.370867374685768,26.262721872871523,765074953,0.853029736174177,-3.432295175242359,-4.285324911416536
2023-03-17T13:30:00-04:00,179.83,180.83,178.58,180.1,NaN,NaN,NaN,190.10232034245482,NaN,NaN,193.5711,216.88392542207194,170.25827457792806,171.99995200366996,180.68361820166734,181.29618703658778,180.0710493667469,1092076,1572599.3333333333,44.175745392197385,40.02917485826363,NaN,NaN,NaN,NaN,6.0765197050653565,26.386469470204293,766167029,0.7974746045718222,-3.2884816557017587,-4.085956260273581
2023-03-20T09:30:00-04:00,178.09,186.44,176.38,182.8,NaN,NaN,NaN,190.10232034245482,NaN,NaN,193.2943,216.78279148072392,169.80580851927607,171.99995200366996,181.87333333333333,181.87333333333333,181.87333333333333,1721314,1576361.0666666667,47.717025076626896,40.95303494820611,NaN,NaN,NaN,NaN,6.361054011846403,25.418144151428983,767888343,0.9304073634215038,-2.9229470559967012,-3.853354419418205
2023-03-20T13:30:00-04:00,182.71,184.05,182.16,183.23,NaN,NaN,NaN,190.10232034245482,NaN,NaN,193.02210000000002,216.6549227759611,169.38927722403895,171.99995200366996,182.15212916818862,182.67869626950946,181.6255620668678,482531,1562838.1,48.279738636720104,42.14651588714217,NaN,NaN,NaN,NaN,6.041693011000233,24.518984926851907,768370874,1.0275254420600124,-2.5689476168431895,-3.596473058903202
2023-03-21T09:30:00-04:00,188.48,196.24,188.07,196.03,172.1689780034251,172.1689780034251,172.1689780034251,NaN,NaN,NaN,193.0477,216.69072512031897,169.404674879681,178.99104187256256,193.4466666666667,193.4466666666667,193.4466666666667,2359949,1585373,61.54705065466139,44.20368719034853,NaN,NaN,NaN,NaN,6.539429224500218,23.704281037828228,770730823,1.884187045920568,-1.241239251502492,-3.12542629742306
2023-03-21T13:30:00-04:00,196.04,197.99,194.86,197.62,176.9206153669058,NaN,NaN,NaN,NaN,NaN,193.10690000000002,216.78058014399102,169.43321985600903,182.62583349805007,194.44211794078015,195.9817230513338,192.9025128302265,986561,1591512.7333333334,62.822815318593705,46.3734248529099,NaN,NaN,NaN,NaN,6.295898565607345,23.160815400383598,771717384,2.452317744940898,-0.06002911624693752,-2.5123468611878357
2023-03-22T09:30:00-04:00,199.25,200.6,195.35,196.33,178.6412692138646,NaN,NaN,NaN,NaN,NaN,192.95750000000004,216.45297890552493,169.46202109447515,185.68366679844004,197.42666666666668,197.42666666666668,197.42666666666668,1411656,1569866.1333333333,61.05301092412447,48.428382375796694,NaN,NaN,NaN,NaN,6.22119152520682,22.969338749830335,770305728,2.6204363125573074,0.7631985295087986,-1.8572377830485087
2023-03-22T13:30:00-04:00,196.33,200.59,190.99,191,178.6412692138646,NaN,NaN,NaN,NaN,NaN,192.59170000000003,215.62360809377302,169.55979190622705,185.68366679844004,195.60480133161644,197.2083924944793,194.00121016875357,1822108,1606239.6,54.25238493312495,49.85630586253893,NaN,NaN,NaN,NaN,6.462534987692047,22.05206525993368,768483620,2.2652261063758528,0.9742948499213071,-1.2909312564545457
2023-03-23T09:30:00-04:00,195.29,199.31,193.01,193.44,178.6412692138646,NaN,NaN,NaN,NaN,NaN,192.2033,214.49811155874622,169.9084884412538,185.68366679844004,195.25333333333333,195.25333333333333,195.25333333333333,1874950,1584428.1333333333,56.63382794585441,50.666026556818274,NaN,NaN,NaN,NaN,6.5944967742854725,21.200311305029647,770358570,2.091324608664789,1.3232245043764408,-0.7681001042883483
2023-03-23T13:30:00-04:00,193.44,193.9,188.66,192.2,178.6412692138646,NaN,NaN,NaN,NaN,NaN,191.76310000000004,213.15328306513516,170.37291693486492,185.68366679844004,193.74890955471602,195.55249753868551,191.94532157074653,1304534,1592607.4,55.06504002525311,51.304374409021754,NaN,NaN,NaN,NaN,6.497747004693653,19.698005602351422,769054036,1.8005645460945723,1.482605578329867,-0.3179589677647052
2023-03-24T09:30:00-04:00,191.69,192.33,187.16,188.31,178.6412692138646,NaN,NaN,NaN,NaN,NaN,191.31430000000003,212.02294476589373,170.60565523410634,185.68366679844004,189.26666666666665,189.26666666666665,189.26666666666665,1938830,1575690.8333333333,50.35282836662974,51.946959219311715,NaN,NaN,NaN,NaN,6.402907932929821,18.511481536404638,767115206,1.278581262001315,1.2802676097369385,0.001686347735623539
2023-03-24T13:30:00-04:00,188.38,190.77,188.28,190.4,178.6412692138646,NaN,NaN,NaN,NaN,NaN,191.08390000000003,211.57057950547386,170.5972204945262,185.68366679844004,189.45185501383895,189.711775899904,189.1919341277739,984203,1574158.8,52.6950952121296,52.565733815779836,NaN,NaN,NaN,NaN,6.1234145091491206,17.409709189454052,768099409,1.0177504527873602,1.273874413719824,0.25612396093246365
2023-03-27T09:30:00-04:00,194.415,197.38,189.955,191.74,178.6412692138646,NaN,NaN,NaN,NaN,NaN,190.89190000000005,211.16937547304553,170.61442452695456,185.68366679844004,193.025,193.025,193.025,1417770,1558060.4,54.18744147184168,52.92115509191634,NaN,NaN,NaN,NaN,6.216384901352754,16.994295831079782,769517179,0.8840952304701597,1.3612429990201633,0.47714776855000357
2023-03-27T13:30:00-04:00,191.65,193.89,191.36,191.84,178.6412692138646,NaN,NaN,NaN,NaN,NaN,190.56070000000008,210.21487167015462,170.90652832984554,185.68366679844004,192.83018215122075,193.13176212803586,192.52860217440565,591641,1556769.7666666666,54.30330003864809,53.354310576142424,NaN,NaN,NaN,NaN,5.9530716941132695,16.608554855446528,770108820,0.7560086948297062,1.4221586370871364,0.6661499422574302
2023-03-28T09:30:00-04:00,192.04,192.31,185.44,187.02,178.6412692138646,NaN,NaN,NaN,NaN,NaN,190.26370000000006,209.67257763988323,170.85482236011688,185.68366679844004,188.25666666666666,188.25666666666666,188.25666666666666,1498934,1531407.4,48.00194228333045,53.649089019981155,NaN,NaN,NaN,NaN,6.01856657310518,15.621235527392782,768609886,0.3224210092428308,1.0691762038109687,0.7467551945681379
2023-03-28T13:30:00-04:00,187.07,189.36,186.36,189.21,178.6412692138646,NaN,NaN,NaN,NaN,NaN,190.10170000000005,209.4075631104638,170.7958368895363,185.68366679844004,188.27286712366393,188.2973940388587,188.24834020846916,653960,1518352.6,50.79572430079972,54.12194465630989,NaN,NaN,NaN,NaN,5.802954675026238,14.704439008485732,769263846,0.16670746502119305,0.9551395258446291,0.7884320608234361
2023-03-29T09:30:00-04:00,193.09,195.27,189.44,192.55,178.6412692138646,NaN,NaN,NaN,NaN,NaN,189.95870000000002,209.08313199784095,170.8342680021591,183.85693343875204,192.42,192.42,192.42,1760549,1509920.0666666667,54.78568304927507,54.626848797213334,NaN,NaN,NaN,NaN,5.821315055381507,14.408277026790167,771024395,0.2663331639391936,1.121348515747428,0.8550153518082345
2023-03-29T13:30:00-04:00,192.43,193.96,190.69,193.91,178.6412692138646,NaN,NaN,NaN,NaN,NaN,189.81970000000004,208.7249524352365,170.91444756476358,182.49068074921027,192.5534555923647,192.75350648978147,192.35340469494795,783503,1503407.4666666666,56.33822752223702,55.20245514617883,NaN,NaN,NaN,NaN,5.639078265711399,14.133269472358572,771807898,0.39381200843973785,1.3472803623579068,0.953468353918169
2023-03-30T09:30:00-04:00,195.59,197.32,194.43,197,178.6412692138646,NaN,NaN,NaN,NaN,NaN,189.7767,208.60649953265633,170.94690046734368,185.87516309432098,196.25,196.25,196.25,1713442,1499306.8666666667,59.72228085416789,55.07211444614358,NaN,NaN,NaN,NaN,5.479858389589156,14.381664996155386,773521340,0.6415729944861366,1.7554345970258396,1.113861602539703
2023-03-30T13:30:00-04:00,197.01,197.12,195.09,195.28,179.05003472210396,NaN,NaN,NaN,NaN,NaN,189.64250000000004,208.21611141512295,171.06888858487713,186.9491304754568,196.1223767634531,196.3155452620208,195.9292082648854,747922,1481235.8333333333,57.07070692916573,54.66124956118444,NaN,NaN,NaN,NaN,5.23343993318993,14.612317982538139,772773418,0.6433112187127423,1.918000625930631,1.2746894072178887
2023-03-31T09:30:00-04:00,197.57,206.32,197.22,204.83,183.98480587109918,NaN,NaN,NaN,NaN,NaN,189.82850000000002,208.81587625371148,170.84112374628856,192.66330438036542,202.79,202.79,202.79,14682288,1862882,66.07659261373888,55.02007682472833,NaN,NaN,NaN,NaN,5.648194223676363,16.004978060517594,787455706,1.2085148563265444,2.7853329776260694,1.576818121299525
2023-03-31T13:30:00-04:00,204.82,207.79,204.62,207.475,188.7959510587765,NaN,NaN,NaN,NaN,NaN,190.04080000000005,209.5676207714412,170.5139792285589,195.27964350429235,204.01213426095092,205.80024681887815,202.22402170302368,6858701,2046923.5,68.07424906650625,56.00735283425556,NaN,NaN,NaN,NaN,5.471180350556622,17.454937267995298,794314407,1.6538433717979726,3.6441223360469905,1.990278964249018
2023-04-03T09:30:00-04:00,199.92,202.68,193.16,193.22,188.7959510587765,NaN,NaN,NaN,NaN,NaN,189.76260000000005,208.69491293212684,170.83028706787326,195.27964350429235,196.35333333333332,196.35333603073164,196.353330635935,16395662,2501980.466666667,50.73425779244808,55.58595496615511,NaN,NaN,NaN,NaN,6.102881754088292,16.673578668587176,777918745,0.9184036643251234,3.1382835446554225,2.219879880330299
2023-04-03T13:30:00-04:00,193.21,195.29,192.2,194.61,188.7959510587765,NaN,NaN,NaN,NaN,NaN,189.50180000000003,207.78959546692334,171.21400453307672,195.27964350429235,195.7105222051898,196.74884569564225,194.67219871473733,6283916,2675760.4,52.017708696760764,55.36828844269137,NaN,NaN,NaN,NaN,5.887675914510558,15.800929828811377,784202661,0.4777683974172282,2.8170903771018345,2.3393219796846063
2023-04-04T09:30:00-04:00,197.325,198.74,190.59,192.15,188.7959510587765,NaN,NaN,NaN,NaN,NaN,189.20000000000007,206.79172157578478,171.60827842421537,195.27964350429235,193.82666666666668,193.82666666666668,193.82666666666668,11036000,2979596.6333333333,49.557086234886356,55.31144971899541,NaN,NaN,NaN,NaN,6.049270492045518,15.465726790126567,773166661,-0.0017772651673859663,2.337100398225374,2.33887766339276
2023-04-04T13:30:00-04:00,192.13,192.71,190.32,192.64,188.7959510587765,NaN,NaN,NaN,NaN,NaN,188.93840000000003,205.91805799891125,171.9587420010888,195.27964350429235,193.3350189889972,194.177895154354,192.49214282364042,3754846,3073504.3,50.06379100315713,55.12349941835453,NaN,NaN,NaN,NaN,5.787894028327982,15.108172190566972,776921507,-0.2923064748892972,1.9734945697811384,2.2658010446704355
2023-04-05T09:30:00-04:00,190.5,190.67,183.76,185.73,NaN,NaN,NaN,205.53286671514374,205.53286671514374,205.53286671514374,188.63260000000005,205.27835119842837,171.98684880157174,195.27964350429235,186.72,186.72,186.72,11172683,3380864,43.43729091195278,54.3556315212196,NaN,NaN,NaN,NaN,6.0087587405902685,14.326657233754903,765748824,-0.9207182992306313,1.1149031706321466,2.035621469862778
2023-04-05T13:30:00-04:00,185.73,187.02,184.82,185.49,NaN,NaN,NaN,203.70523640991,NaN,NaN,188.28620000000006,204.45132425686728,172.12107574313285,195.27964350429235,186.4576471987778,186.88032574115613,186.03496865639949,4304359,3496911.4,43.22329953673695,53.56420291394023,NaN,NaN,NaN,NaN,5.736704544833822,13.600964773857982,761444465,-1.300203693398182,0.4103668531150504,1.7105705465132324
2023-04-06T09:30:00-04:00,183.13,186.38,179.73,185.37,NaN,NaN,NaN,200.93863475491406,NaN,NaN,188.19800000000006,204.37767700542668,172.01832299457345,195.27964350429235,183.82666666666668,183.82666666666668,183.82666666666668,10268519,3764948.1,43.108944416546834,53.214703066312836,NaN,NaN,NaN,NaN,5.80193993448855,13.655937745669908,751175946,-1.4931520253274646,-0.15586948514609844,1.3372825401813662
2023-04-06T13:30:00-04:00,185.36,186.15,184.4,185.07,NaN,NaN,NaN,200.93863475491406,NaN,NaN,188.08200000000008,204.26655152297818,171.89744847702198,195.27964350429235,184.1988603345487,184.81131370850605,183.58640696059135,3792274,3859444.7666666666,42.804051546428624,52.643869298143464,NaN,NaN,NaN,NaN,5.5125156534536535,13.706984076638125,747383672,-1.5671518540653238,-0.6216572774002884,0.9454945766650352
2023-04-10T09:30:00-04:00,179.95,183.74,176.11,183.55,NaN,NaN,NaN,197.66940687379565,NaN,NaN,187.7608000000001,203.65226215550678,171.86933784449343,195.27964350429235,181.13333333333335,181.13333333333335,181.13333333333335,10443825,4137983.533333333,41.2135752979788,51.67443303019373,NaN,NaN,NaN,NaN,5.75876453534982,14.778515204211251,736939847,-1.6370035658968458,-1.100759880706022,0.5362436851908238
2023-04-10T13:30:00-04:00,183.56,185.1,182.82,184.51,NaN,NaN,NaN,197.66940687379565,NaN,NaN,187.49380000000008,203.14433744252656,171.8432625574736,185.5142148034339,181.95706847450137,183.29904581861618,180.61509113038656,3934997,4232747.566666666,42.662654817724686,50.69760640844286,NaN,NaN,NaN,NaN,5.5102813542534035,15.509360261384817,740874844,-1.5385947077288717,-1.386999699470266,0.15159500825860578
2023-04-11T09:30:00-04:00,186.655,189.19,185.65,187.88,NaN,NaN,NaN,197.66940687379565,NaN,NaN,187.36580000000006,202.89646377975984,171.8351362202403,182.44289747419768,187.57333333333335,187.57333333333335,187.57333333333335,9666196,4497576.966666667,47.55031914262623,49.82818057190416,NaN,NaN,NaN,NaN,5.4509755432353035,15.427826750751302,750541040,-1.1825748006270564,-1.326623492525215,-0.1440486918981584
2023-04-11T13:30:00-04:00,187.9,188.62,186.56,186.83,NaN,NaN,NaN,197.66940687379565,NaN,NaN,187.22620000000006,202.64775356116664,171.8046464388335,182.44289747419768,187.51002620879333,187.6147873376769,187.40526507990978,3529884,4599155.4,46.22806899068619,49.05370643344134,NaN,NaN,NaN,NaN,5.208763004432782,15.3521170623059,747011156,-0.9631311775273088,-1.3479626638072943,-0.38483148627998554
2023-04-12T09:30:00-04:00,190.68,191.58,181.89,183.71,NaN,NaN,NaN,197.66940687379565,NaN,NaN,187.05250000000007,202.4328576356317,171.67214236436843,178.47731797935813,185.7266666666667,185.7266666666667,185.7266666666667,11283760,4896615.766666667,42.450655168305104,47.36613947305322,NaN,NaN,NaN,NaN,5.528851361259014,15.90150687034672,735727396,-0.9707019139816053,-1.5982088787569921,-0.6275069647753868
2023-04-12T13:30:00-04:00,183.73,183.99,180.31,180.53,NaN,NaN,NaN,197.66940687379565,NaN,NaN,186.90970000000007,202.39668710659708,171.42271289340306,177.950489845443,184.37983844315988,186.31128779268997,182.4483890936298,5486705,5046620.566666666,38.956619860592895,45.28630881548798,NaN,NaN,NaN,NaN,5.396790549740514,16.60734337296941,730240691,-1.1217806163046633,-2.029732735156216,-0.9079521188515527
2023-04-13T09:30:00-04:00,182.955,186.16,180.94,184.68,NaN,NaN,NaN,197.66940687379565,NaN,NaN,186.99650000000008,202.38355563127269,171.60944436872748,177.950489845443,183.92666666666665,183.92666666666665,183.92666666666665,10255947,5341430.266666667,45.28581500838979,44.89713433091238,NaN,NaN,NaN,NaN,5.413448367616191,16.81335036188089,740496638,-0.8845472954805826,-2.013636238202281,-1.1290889427216984
2023-04-13T13:30:00-04:00,184.69,186.5,184.57,185.92,NaN,NaN,NaN,197.66940687379565,NaN,NaN,187.07390000000007,202.39946025598792,171.7483397440122,177.950489845443,184.43645310767923,185.22730511898177,183.64560109637668,4261494,5422743.133333334,47.05232098832906,44.542463780310115,NaN,NaN,NaN,NaN,5.164630627072177,16.933207234306003,744758132,-0.6000570235864153,-1.8791602222047175,-1.2791031986183021
2023-04-14T09:30:00-04:00,183.875,186.28,182,183.51,NaN,NaN,NaN,197.66940687379565,NaN,NaN,187.18310000000008,202.32663814535712,172.03956185464304,177.950489845443,183.92999999999998,183.92999999999998,183.92999999999998,8489391,5643224.5,44.07396027794711,44.15081192624302,NaN,NaN,NaN,NaN,5.10144272513845,17.415862329609936,736268741,-0.5324272820300728,-1.9446373011558933,-1.4122100191258204
2023-04-14T13:30:00-04:00,183.49,185.38,182.97,184.99,NaN,NaN,NaN,197.66940687379565,NaN,NaN,187.42430000000007,202.02658557589248,172.82201442410766,177.950489845443,184.10612966654816,184.35103509379346,183.86122423930286,4390811,5746100.4,46.32109568008123,43.88347654602332,NaN,NaN,NaN,NaN,4.909196816199989,17.864042060963587,740659552,-0.35480256068261906,-1.8557132199790942,-1.5009106592964752
2023-04-17T09:30:00-04:00,186.3,189.69,182.7,184.58,NaN,NaN,NaN,197.66940687379565,NaN,NaN,187.63930000000008,201.74265591410426,173.5359440858959,178.0384704900438,185.65666666666667,185.65666666666667,185.65666666666667,9323943,5992270.833333333,45.772407311832595,44.05027057458616,NaN,NaN,NaN,NaN,5.057825615042847,17.30510567171654,731335609,-0.23735321617336158,-1.7976021795131771,-1.5602489633398156
2023-04-17T13:30:00-04:00,184.58,187.53,183.54,186.99,NaN,NaN,NaN,197.66940687379565,NaN,NaN,187.91150000000007,201.41615819633728,174.40684180366287,178.0384704900438,185.75974613700356,185.9235351181814,185.59595715582572,3692960,6082562.733333333,49.55494609498317,44.50253104303232,NaN,NaN,NaN,NaN,4.981552356825501,16.78609331027285,735028569,0.016729267166544215,-1.5393373793816352,-1.5560666465481794
2023-04-18T09:30:00-04:00,187.14,187.69,183.58,185.24,NaN,NaN,NaN,197.66940687379565,NaN,NaN,188.15330000000006,201.00945519663372,175.2971448033664,178.0384704900438,185.50333333333333,185.50333333333333,185.50333333333333,7621796,6289363.6,46.991702205333695,44.77987088508852,NaN,NaN,NaN,NaN,4.91929861705225,16.266981393675238,727406773,0.07761172040834863,-1.4590519960377435,-1.5366637164460921
2023-04-18T13:30:00-04:00,185.22,186.02,183.83,184.31,NaN,NaN,NaN,197.66940687379565,NaN,NaN,188.35090000000008,200.64886335821114,176.05293664178902,178.0384704900438,185.27899341478226,185.63311844516855,184.92486838439598,3058843,6371603.666666667,45.64061314928797,44.98248242814991,NaN,NaN,NaN,NaN,4.724348715834232,15.784948899691745,724347930,0.06636217040924608,-1.4537110034345346,-1.5200731738437807
2023-04-19T09:30:00-04:00,179.09,182.71,177.66,182.53,NaN,NaN,NaN,195.68812579044294,NaN,NaN,188.34870000000006,200.65078775939753,176.0466122406026,178.0384704900438,180.96666666666667,180.96666666666667,180.96666666666667,8064614,6590459.666666667,43.0871349561862,45.116308118021855,NaN,NaN,NaN,NaN,4.861895236131787,16.465675042667836,716283316,-0.04390486884728051,-1.5749542599028814,-1.531049391055601
2023-04-19T13:30:00-04:00,182.52,183.5,180.05,180.48,NaN,NaN,NaN,195.68812579044294,NaN,NaN,188.29150000000004,200.7122336739809,175.87076632601918,178.0384704900438,181.08794869755573,181.263941786299,180.91195560881246,3829881,6696323.7,40.29130617169393,44.94692607187681,NaN,NaN,NaN,NaN,4.761045576408087,16.88736383126961,712453435,-0.22758447283092864,-1.8155299820942616,-1.587945509263333
2023-04-20T09:30:00-04:00,166.2,169.6,162.66,164.35,NaN,NaN,NaN,183.13485221815154,NaN,NaN,188.01050000000004,201.86643998976498,174.1545600102351,178.0384704900438,165.53666666666666,165.53666666666666,165.53666666666666,19114181,7274778.1,25.997248498746075,43.40742102588536,NaN,NaN,NaN,NaN,5.693828035236081,19.263204117018397,693339254,-1.3456828572943793,-3.270049080881307,-1.9243662235869279
2023-04-20T13:30:00-04:00,164.35,164.6,160.56,162.99,NaN,NaN,NaN,179.3628134809628,NaN,NaN,187.65990000000005,203.05758872136246,172.26221127863764,178.0384704900438,164.7546660656492,166.01709101584336,163.49224111545502,7334301,7493138.033333333,25.185929961387373,41.904411095221164,NaN,NaN,NaN,NaN,5.575697461290646,21.62768140706935,686004953,-2.0451902877566694,-4.480854083282765,-2.435663795526095
2023-04-21T09:30:00-04:00,164.81,165.51,161.32,165.3,NaN,NaN,NaN,179.3628134809628,NaN,NaN,187.26750000000004,203.87682126849077,170.6581787315093,178.0384704900438,164.04333333333332,164.04333333333332,164.04333333333332,11031418,7803737.233333333,29.226058223630815,40.95979702774442,NaN,NaN,NaN,NaN,5.476719071198457,23.602013022834807,697036371,-2.2067914537432682,-5.19415311270518,-2.987361658961912
2023-04-21T13:30:00-04:00,165.29,166,164.69,165.06,NaN,NaN,NaN,179.3628134809628,NaN,NaN,186.8881000000001,204.60558028247493,169.17061971752526,178.0384704900438,164.4016912499195,164.95305152804798,163.85033097179104,4660091,7934142.866666666,29.050528827486758,40.252219096808275,NaN,NaN,NaN,NaN,5.179096280398568,25.311092410002516,692376280,-2.1804773126022527,-5.712958299714728,-3.5324809871124754
2023-04-24T09:30:00-04:00,164.69,165.65,158.61,160.44,NaN,NaN,NaN,178.37781608256918,NaN,NaN,186.49950000000004,205.61297506341973,167.38602493658036,176.58202111362803,161.56666666666666,161.56666666666666,161.56666666666666,11153856,7816528.466666667,25.834005018410537,38.86280409752404,NaN,NaN,NaN,NaN,5.312017974655812,27.403012969426122,681222424,-2.3123125468994914,-6.422871670736839,-4.110559123837348
2023-04-24T13:30:00-04:00,160.43,163.22,160.15,162.53,NaN,NaN,NaN,177.6129153515433,NaN,NaN,186.14810000000008,206.33516683894197,165.9610331610582,176.58202111362803,161.68364416349897,161.8655981795883,161.50169014740965,4610058,7741573.7,29.62986435167265,37.61834290919144,NaN,NaN,NaN,NaN,5.151873833608968,29.345510631748045,685832482,-2.102874972785992,-6.7391528398198375,-4.636277867033845
2023-04-25T09:30:00-04:00,159.82,163.47,158.75,162.69,NaN,NaN,NaN,176.9575555628368,NaN,NaN,185.74590000000006,206.9590191190718,164.53278088092833,176.03861689090243,161.63666666666668,161.63666666666668,161.63666666666668,9879864,7524380.433333334,29.925545331819123,36.60774184161088,NaN,NaN,NaN,NaN,5.121025702636898,31.26188005488323,695712346,-1.8088884913650833,-6.897388481240199,-5.088499989875116
2023-04-25T13:30:00-04:00,162.69,162.95,160.5,160.7,NaN,NaN,NaN,176.9575555628368,NaN,NaN,185.29530000000005,207.63051098266,162.9600890173401,172.72691481017756,161.56653670974038,161.67988592628438,161.45318749319637,3781996,7440983.1,28.33107712326118,35.32274051612373,NaN,NaN,NaN,NaN,4.930238152448547,33.041365947794475,691930350,-1.6104048044097699,-7.101505995387328,-5.491101190977558
2023-04-26T09:30:00-04:00,160.35,160.63,153.22,156.84,NaN,NaN,NaN,172.70351653556,NaN,NaN,184.5115000000001,208.00536951951216,161.01763048048804,172.72691481017756,156.89666666666668,156.89666666666668,156.89666666666668,12464117,7488587,25.493649964480582,33.87425784845573,NaN,NaN,NaN,NaN,5.112363998702222,35.23582409483765,679466233,-1.5978538547162104,-7.488418509372821,-5.89056465465661
2023-04-26T13:30:00-04:00,156.83,157.19,153.14,153.64,NaN,NaN,NaN,170.77858396576178,NaN,NaN,183.63190000000006,208.35768531735516,158.90611468264495,153.40162430624872,156.31061911737814,157.29514681144155,155.32609142331472,4416430,7510639.8,23.401235209790585,32.006135642370545,NaN,NaN,NaN,NaN,5.036480855937778,37.27882862399491,675049803,-1.65673839387786,-7.961487647003935,-6.304749253126075
2023-04-27T09:30:00-04:00,152.6,159.07,152.37,159.03,NaN,NaN,NaN,170.77858396576178,NaN,NaN,182.88590000000008,208.27604247222536,157.4957575277748,153.40162430624872,156.82333333333335,156.82333333333335,156.82333333333335,10351170,7483256.033333333,33.32750217713212,31.030121354641857,NaN,NaN,NaN,NaN,5.155303651942221,38.600010249178645,685400973,-1.2053407145565078,-7.81142514632171,-6.606084431765202
2023-04-27T13:30:00-04:00,159.04,160.48,159.03,160.16,NaN,NaN,NaN,170.77858396576178,NaN,NaN,182.26910000000007,208.3303317199309,156.20786828006922,153.40162430624872,157.68930898902852,159.06979616434234,156.3088218137147,4073203,7475550.833333333,35.22272900036988,30.285986772576276,NaN,NaN,NaN,NaN,4.890639105374919,39.40147280405761,689474176,-0.7268870713081199,-7.514693270900352,-6.787806199592232
2023-04-28T09:30:00-04:00,160.91,165,157.32,164.17,NaN,NaN,NaN,170.77858396576178,NaN,NaN,181.6837000000001,208.02834080680975,155.33905919319045,153.40162430624872,162.16333333333333,162.16333333333333,162.16333333333333,10077319,7469177.5,41.570183592046114,30.17763310370913,NaN,NaN,NaN,NaN,5.089879169276712,38.89805614115366,699551495,-0.07110501015311588,-6.876687462283627,-6.805582452130511
2023-04-28T13:30:00-04:00,164.18,164.91,163.61,164.35,NaN,NaN,NaN,170.77858396576178,NaN,NaN,181.12670000000008,207.7347489784554,154.51865102154477,154.05506557015545,162.75672806546794,163.71058103573364,161.80287509520224,3900044,7472769.833333333,41.84565210278053,30.28865781307246,NaN,NaN,NaN,NaN,4.819173514328374,38.43059781131428,703451539,0.417186298928768,-6.284099578469551,-6.701285877398319
2023-05-01T09:30:00-04:00,163.18,163.27,158.83,161.95,NaN,NaN,NaN,170.77858396576178,NaN,NaN,180.5995000000001,207.65810663448653,153.54089336551365,154.05506557015545,161.35,161.35,161.35,8600768,7411334.6,39.19249039901001,31.23117509166274,NaN,NaN,NaN,NaN,4.869232549019203,38.60100185400019,694850771,0.6093001875481487,-5.939660642963133,-6.548960830511282
2023-05-01T13:30:00-04:00,161.93,162.63,160.56,161.81,NaN,NaN,NaN,170.77858396576178,NaN,NaN,180.02770000000007,207.4397413840323,152.61565861596785,154.05506557015545,161.43534347972886,161.57584944301922,161.2948375164385,3173134,7385939.166666667,39.037004381281946,32.22053755022664,NaN,NaN,NaN,NaN,4.669287366946402,38.759234179351395,691677637,0.7485440812889284,-5.613280728900122,-6.36182481018905
2023-05-02T09:30:00-04:00,161.925,165.49,159.75,161.21,NaN,NaN,NaN,170.77858396576178,NaN,NaN,179.4171000000001,207.11697206396212,151.71722793603806,154.4678735719196,162.15,162.15,162.15,9843797,7391859.2,38.33507615242295,32.8711816879975,NaN,NaN,NaN,NaN,4.7457668407359455,38.10275103682953,681833840,0.8162884827700179,-5.341464206726528,-6.1577526894965455
2023-05-02T13:30:00-04:00,161.21,162.23,158.93,160.26,NaN,NaN,NaN,170.77858396576178,NaN,NaN,178.7855000000001,206.76228539432051,150.80871460567968,154.4678735719196,161.65497319657283,162.4197891249535,160.89015726819216,4123882,7411659.133333334,37.19468421252309,33.45290707264296,NaN,NaN,NaN,NaN,4.642497780683377,37.61424855032533,677709958,0.8114704453035175,-5.143414632867149,-5.954885078170666
2023-05-03T09:30:00-04:00,160.005,165,159.91,164.82,NaN,NaN,NaN,170.77858396576178,NaN,NaN,178.34150000000008,206.4855976582992,150.19740234170095,154.4678735719196,163.2433333333333,163.2433333333333,163.2433333333333,8312291,7312610.166666667,45.565336002121015,34.86228785719371,NaN,NaN,NaN,NaN,4.674462224920278,36.4057575525495,686022249,1.1112100687050352,-4.5658724922893725,-5.677082560994408
2023-05-03T13:30:00-04:00,164.82,164.99,160.29,160.58,NaN,NaN,NaN,170.77858396576178,NaN,NaN,177.76890000000012,206.16901403427536,149.36878596572487,154.4678735719196,162.7265425518017,163.3586718078112,162.09441329579224,5555696,7314909.866666666,40.20024307220725,35.61731490866047,NaN,NaN,NaN,NaN,4.6762863517116875,35.283587340329085,680466553,1.0219995732045737,-4.3995830944886904,-5.421582667693264
2023-05-04T09:30:00-04:00,162.71,162.96,159.65,161.3,NaN,NaN,NaN,170.77858396576178,NaN,NaN,177.14390000000012,205.59075355465285,148.69704644534738,154.4678735719196,161.30333333333334,161.30333333333334,161.30333333333334,8585740,7259236.3,41.46073838508452,36.441257269607995,NaN,NaN,NaN,NaN,4.5786944694465666,34.3612000076511,689052293,1.0078855087588456,-4.161725781744707,-5.1696112905035525
2023-05-04T13:30:00-04:00,161.32,162.28,161.03,161.22,NaN,NaN,NaN,170.77858396576178,NaN,NaN,176.4901000000001,204.8681044745902,148.11209552540998,154.4678735719196,161.34863314131465,161.43413102259683,161.26313526003247,2410237,7197527.733333333,41.35642812868627,37.37163948428121,NaN,NaN,NaN,NaN,4.340930578771812,33.504697484450105,686642056,0.9882290090163668,-3.9343250292330936,-4.92255403824946
2023-05-05T09:30:00-04:00,163.98,169.39,163.53,169.23,NaN,NaN,NaN,170.77858396576178,NaN,NaN,175.93470000000008,203.76708232059713,148.10231767940303,158.0701116896373,167.38333333333333,167.38333333333333,167.38333333333333,9709261,7238190.066666666,53.870438699692045,39.39855296536774,NaN,NaN,NaN,NaN,4.6144355374309685,31.383236161502566,696351317,1.4801615708772164,-3.0723520746529402,-4.552513645530157
2023-05-05T13:30:00-04:00,169.23,170.77,169.15,170.07,NaN,NaN,NaN,170.77858396576178,NaN,NaN,175.43050000000005,202.75149853592316,148.10950146407694,160.90408935170984,168.1824801595785,169.38655714605284,166.97840317310414,4276917,7234393.6,54.95597596738458,41.6524630194816,NaN,NaN,NaN,NaN,4.400547284757328,29.707362380506336,700628234,1.8060140904525515,-2.294996032464468,-4.101010122917019
2023-05-08T09:30:00-04:00,173.71,173.8,169.19,172.21,157.501176944509,157.501176944509,157.501176944509,NaN,NaN,NaN,174.77810000000005,200.78613221237512,148.77006778762498,163.60227148136786,171.73333333333335,171.73333333333335,171.73333333333335,8941957,7221660.733333333,57.68778504852733,43.392483224581255,NaN,NaN,NaN,NaN,4.415508192988949,28.755584316607692,709570191,2.0895358210382495,-1.4890903466192071,-3.5786261676574567
2023-05-08T13:30:00-04:00,172.21,172.46,170.04,171.83,157.56225981066768,NaN,NaN,NaN,NaN,NaN,174.06520000000003,198.34591571926924,149.78448428073082,163.60227148136786,171.6522937414801,171.78242469927946,171.52216278368073,3467894,7214158.533333333,57.026416179259826,44.94988945164482,NaN,NaN,NaN,NaN,4.27297189348974,27.871790400130376,706102297,2.1660797679278594,-0.8710264577476323,-3.0371062256754917
2023-05-09T09:30:00-04:00,168.95,169.83,166.57,167.53,157.56225981066768,NaN,NaN,NaN,NaN,NaN,173.55140000000006,197.26977667632246,149.83302332367765,163.60227148136786,167.97666666666666,167.97666666666666,167.97666666666666,7574053,7212567.1,50.03587320219381,45.55458156665537,NaN,NaN,NaN,NaN,4.343473901097617,26.14687527059,698528244,1.8537793135347256,-0.719882083757085,-2.5736613972918105
2023-05-09T13:30:00-04:00,167.51,169.15,167.255,169.15,157.56225981066768,NaN,NaN,NaN,NaN,NaN,173.04220000000004,196.01167689086452,150.07272310913555,163.60227148136786,168.12963302434594,168.3734732804417,167.88579276825018,2980639,7209960.3,52.40312530065166,46.308686795074735,NaN,NaN,NaN,NaN,4.168582908162074,24.54516836458823,701508883,1.6877054592207594,-0.4640295732658615,-2.151735032486621
2023-05-10T09:30:00-04:00,172.55,174.43,167.37,167.43,157.56225981066768,NaN,NaN,NaN,NaN,NaN,172.54780000000005,194.9069199433235,150.18868005667662,163.66229039876828,169.74333333333334,169.74333333333334,169.74333333333334,10311580,7284859.166666667,49.710167484320706,47.0599494440255,NaN,NaN,NaN,NaN,4.375112700436212,24.165351270060246,691197303,1.4049918515433384,-0.39549521805744803,-1.8004870696007864
2023-05-10T13:30:00-04:00,167.41,169.64,166.69,168.55,157.56225981066768,NaN,NaN,NaN,NaN,NaN,172.06600000000006,193.69895153232503,150.4330484676751,163.66229039876828,169.36105932867574,169.9999363842376,168.72218227311387,3691817,7280257.033333333,51.45941640336546,47.94726458846003,NaN,NaN,NaN,NaN,4.273318936119339,23.626602060418005,694889120,1.242030925233617,-0.24794841305876503,-1.489979338292382
2023-05-11T09:30:00-04:00,168.69,169.97,166.79,169.12,157.56225981066768,NaN,NaN,NaN,NaN,NaN,171.7338000000001,193.0246686116815,150.44293138831867,163.66229039876828,168.62666666666664,168.62666936406495,168.62666396926832,7203078,6883220.266666667,52.367480480563536,48.94957918332722,NaN,NaN,NaN,NaN,4.19522472639653,23.193568499384654,702092198,1.1247407858322016,-0.08405335600212993,-1.2087941418343315
2023-05-11T13:30:00-04:00,169.11,173.56,168.64,172.06,157.67427988098456,NaN,NaN,NaN,NaN,NaN,171.46520000000007,192.39083910230485,150.53956089769528,163.66229039876828,169.66454460634907,171.01434030465623,168.3147489080419,4258676,6780699.433333334,56.85119013221026,50.35361532044773,NaN,NaN,NaN,NaN,4.24699438879678,23.47928453199682,706350874,1.1909091052801952,0.2798422397659124,-0.9110668655142827
2023-05-12T09:30:00-04:00,176.06,177.38,167.23,168.32,158.10544897730347,NaN,NaN,NaN,NaN,NaN,171.12420000000006,191.68487006300904,150.56352993699107,164.15374614733545,170.9766666666667,170.9766666666667,170.9766666666667,13393285,6859428.333333333,50.35729493423739,50.69589810131318,NaN,NaN,NaN,NaN,4.668637646739867,24.358527900207392,692957589,0.9395806628615079,0.2634089630626022,-0.6761716997989057
2023-05-12T13:30:00-04:00,168.33,169.03,167.28,168.01,158.10544897730347,NaN,NaN,NaN,NaN,NaN,170.7830000000001,190.9694438671069,150.5965561328933,164.15374614733545,170.25017888695876,171.49807128364137,169.00228649027616,4539306,6855402.166666667,49.84902182851444,51.38509658390655,NaN,NaN,NaN,NaN,4.460163529115591,25.174968170688633,688418283,0.7191795457977084,0.2228027324482298,-0.4963768133494786
2023-05-15T09:30:00-04:00,167.655,169.76,164.55,168.07,158.10544897730347,NaN,NaN,NaN,NaN,NaN,170.47340000000008,190.3394069908341,150.60739300916606,164.15374614733545,167.46,167.46,167.46,8296570,6760159.3,49.954309050559985,51.991780202869094,NaN,NaN,NaN,NaN,4.513723277035905,25.06863415920877,696714853,0.5516902478090916,0.19323599641188594,-0.35845425139720566
2023-05-15T13:30:00-04:00,168.08,168.13,165.66,166.38,158.10544897730347,NaN,NaN,NaN,NaN,NaN,170.1108000000001,189.59696692527942,150.62463307472078,164.15374614733545,167.25253471586953,167.583881837768,166.92118759397107,3252543,6714908.8,46.963576615237464,52.39229080905132,NaN,NaN,NaN,NaN,4.367743042961911,24.969895434263183,693462310,0.3132067933569263,0.03305424029895221,-0.2801525530579741
2023-05-16T09:30:00-04:00,165.65,169.51,164.35,168.31,158.10544897730347,NaN,NaN,NaN,NaN,NaN,169.71940000000006,188.53688651015526,150.90191348984487,164.15374614733545,167.39000000000001,167.39000000000001,167.39000000000001,7955438,6650761.266666667,50.60087670723317,52.15875066673283,NaN,NaN,NaN,NaN,4.424332825607489,25.148884953024687,701417748,0.2730333551590322,0.06113914089081618,-0.21189421426821603
2023-05-16T13:30:00-04:00,168.32,168.86,166.395,166.54,158.10544897730347,NaN,NaN,NaN,NaN,NaN,169.31360000000006,187.50222227217589,151.12497772782424,164.15374614733545,167.3558297613114,167.41154039418322,167.3001191284396,2992843,6624456.166666667,47.390909546818975,51.61838877954957,NaN,NaN,NaN,NaN,4.28438048092124,25.31508950616037,698424905,0.12251509688893764,-0.05875034315704397,-0.1812654400459816
2023-05-17T09:30:00-04:00,168.4,173.99,167.18,173.46,158.10544897730347,NaN,NaN,NaN,NaN,NaN,169.10860000000008,186.86959051741988,151.34760948258028,164.15374614733545,171.54333333333332,171.54333333333332,171.54333333333332,11251263,6584027.7,58.48043282519637,51.67500647788307,NaN,NaN,NaN,NaN,4.510496160855438,26.38288097718456,709676168,0.46502152083757403,0.40001146100098595,-0.06501005983658809
2023-05-17T13:30:00-04:00,173.46,174.49,173.21,173.85,160.51131067035016,NaN,NaN,NaN,NaN,NaN,168.97500000000008,186.48910825591398,151.46089174408618,164.39765512803768,172.13819998281136,173.14730490342643,171.12909506219628,3909920,6567144.033333333,59.0049106332848,51.81632751031343,NaN,NaN,NaN,NaN,4.27974643508005,27.45193938328955,713586088,0.6808022885776324,0.7859928008854524,0.10519051230782003
2023-05-18T09:30:00-04:00,174.22,175.75,172.45,175.12,160.91761473078876,NaN,NaN,NaN,NaN,NaN,168.78380000000007,185.80986467272737,151.75773532727277,166.02612410243015,174.43999999999997,174.4400019073486,174.43999809265134,9953806,6553898.566666666,60.74393190751169,52.581188846407564,NaN,NaN,NaN,NaN,4.209764546860047,28.64152813401772,723539894,0.8604501437160887,1.180753191952931,0.32030304823684225
2023-05-18T13:30:00-04:00,175.15,177.06,174.09,176.93,162.58681406120743,NaN,NaN,NaN,NaN,NaN,168.6040000000001,185.08351649775707,152.12448350224312,167.79589928194412,174.87977553134837,175.5899689264443,174.16958213625244,3816788,6545351.4,63.143570588642646,53.348363509835494,NaN,NaN,NaN,NaN,4.121209936370043,29.945733916898593,727356682,1.0405335503591877,1.6209699861858269,0.5804364358266392
2023-05-19T09:30:00-04:00,177.185,181.95,176.32,180.45,165.96945887660712,NaN,NaN,NaN,NaN,NaN,168.54280000000008,184.82194594319589,152.26365405680428,171.7237194255553,179.57333333333335,179.57333333333335,179.57333333333335,12419610,6623427.766666667,67.3265251943883,54.60667477484032,NaN,NaN,NaN,NaN,4.228980655200754,31.79145951574241,739776292,1.318206301186048,2.228194312309199,0.9099880111231512
2023-05-19T13:30:00-04:00,180.46,180.57,178.7,180.11,166.81289256403406,NaN,NaN,NaN,NaN,NaN,168.44520000000009,184.38369641088738,152.5067035891128,171.7237194255553,179.62722661255404,179.72184181159096,179.53261141351712,4029539,6627744.266666667,66.54096418618883,55.683928187899134,NaN,NaN,NaN,NaN,4.06048203697213,33.50534757181167,735746753,1.3931494567543918,2.651424832066141,1.258275375311749
2023-05-22T09:30:00-04:00,180.75,186.25,180.12,186,170.10844290203252,NaN,NaN,NaN,NaN,NaN,168.4736000000001,184.5316067305958,152.41559326940438,175.8871804323554,184.12333333333333,184.12333333333333,184.12333333333333,10654086,6696188.2,72.52226574121897,57.12355570651737,NaN,NaN,NaN,NaN,4.209019034331262,35.67777397958425,746400839,1.7315057616540046,3.4226575773792547,1.69115181572525
2023-05-22T13:30:00-04:00,186.01,189.32,186.01,188.94,174.73010458830376,NaN,NaN,NaN,NaN,NaN,168.51260000000005,184.75867069293668,152.26652930706342,179.3697443458843,185.45669391701247,187.33049927932407,183.58288855470087,5394640,6770238.4,74.93123842574354,58.41498772748404,NaN,NaN,NaN,NaN,4.145517674736171,37.944289640188416,751795479,2.025018568643053,4.222425026529066,2.1974064578860135
2023-05-23T09:30:00-04:00,186.2,192.96,186.07,187.51,176.22850892519904,NaN,NaN,NaN,NaN,NaN,168.55800000000008,185.0022753564836,152.11372464351655,181.55479547670745,188.84666666666666,188.84666666666666,188.84666666666666,12844040,6870246.5,71.64129974645029,59.93527378549925,NaN,NaN,NaN,NaN,4.341552126540731,40.30480272407653,738951439,1.991539295735155,4.686830577554957,2.6952912818198023
2023-05-23T13:30:00-04:00,187.5,187.82,185.27,185.8,176.22850892519904,NaN,NaN,NaN,NaN,NaN,168.58780000000007,185.15111864814162,152.02448135185853,181.55479547670745,188.18258812675444,189.30169489985784,187.06348135365104,4522697,6883540.333333333,67.80734995851043,61.21801150907039,NaN,NaN,NaN,NaN,4.213584117502106,42.187000714265366,734428742,1.732454694073934,4.86085964941222,3.1284049553382856
2023-05-24T09:30:00-04:00,182.23,182.93,178.22,182.34,176.22850892519904,NaN,NaN,NaN,NaN,NaN,168.58400000000006,185.13460458109884,152.03339541890128,181.55479547670745,181.16333333333333,181.16333333333333,181.16333333333333,9274616,6915617.833333333,60.72590867885339,61.98741148251992,NaN,NaN,NaN,NaN,4.454042394823385,41.62572123190101,725154126,1.229917159619479,4.665801404862634,3.4358842452431553
2023-05-24T13:30:00-04:00,182.34,184.21,181.65,182.84,176.22850892519904,NaN,NaN,NaN,NaN,NaN,168.63120000000006,185.3300352360244,151.93236476397573,181.55479547670745,181.65314799805688,182.43463785422085,180.8716581418929,3643450,6851876.3,61.35400744663103,63.01529939904803,NaN,NaN,NaN,NaN,4.318753652336,41.27593777412376,728797576,0.8510466100418199,4.49969250779543,3.6486458977536103
2023-05-25T09:30:00-04:00,186.54,186.79,180.58,184.29,176.22850892519904,NaN,NaN,NaN,NaN,NaN,169.03000000000003,186.24523976016403,151.81476023983603,181.55479547670745,183.88666666666666,183.88666666666666,183.88666666666666,7825731,6826542.666666667,63.19241502020347,63.91469499283163,NaN,NaN,NaN,NaN,4.453842677169142,41.283263329670355,736623307,0.6282362242735529,4.4339411780955515,3.8057049538219987
2023-05-25T13:30:00-04:00,184.31,185.78,182.75,184.43,176.22850892519904,NaN,NaN,NaN,NaN,NaN,169.45880000000005,187.11335392355994,151.80424607644017,181.55479547670745,184.00667313804445,184.20058355833416,183.81276271775474,2997312,6846111.833333333,63.37358094340898,65.05631437830235,NaN,NaN,NaN,NaN,4.352139628799917,41.29006563124934,739620619,0.4298883973565033,4.343065450517628,3.9131770531611245
2023-05-26T09:30:00-04:00,184.64,198.6,184.53,197.12,176.97887405975578,NaN,NaN,NaN,NaN,NaN,170.09520000000003,189.32774959281105,150.86265040718902,182.700458065446,193.41666666666666,193.41666666666666,193.41666666666666,14695865,7012331.966666667,75.2601130650732,66.25486296686496,NaN,NaN,NaN,NaN,5.053415369599922,42.542128464378585,754316484,1.0572028275467318,5.234680587594539,4.1774777600478075
2023-05-26T13:30:00-04:00,197.14,197.79,191.9,193.18,180.11869796613053,NaN,NaN,NaN,NaN,NaN,170.65760000000003,190.8870381770704,150.42816182292967,182.700458065446,193.64207885484154,194.0242428550974,193.25991485458567,5112701,7040191.433333334,67.89288284642058,66.88971812494609,NaN,NaN,NaN,NaN,5.113171414628498,43.704758237998604,749203783,1.1054441773554,5.559282981742058,4.453838804386658
2023-05-30T09:30:00-04:00,200.1,204.48,197.54,198.94,185.4121662403973,NaN,NaN,NaN,NaN,NaN,171.4276,192.93337022475438,149.92182977524564,186.29829316188545,200.32000000000002,200.32000000000002,200.32000000000002,9997298,7075369.466666667,72.18036005748755,67.70660584994437,NaN,NaN,NaN,NaN,5.555087742155033,45.233165819757346,759201081,1.4047166557614714,6.209734624088497,4.805017968327026
2023-05-30T13:30:00-04:00,198.91,201.99,197.585,201.18,185.4121662403973,NaN,NaN,NaN,NaN,NaN,172.20060000000004,195.10455333910562,149.29664666089445,186.29829316188545,200.30114274335853,200.33168751507336,200.2705979716437,3810359,7086784.966666667,73.65378803439688,68.45733566749824,NaN,NaN,NaN,NaN,5.472938617715387,46.65240143139046,763011440,1.6178024144072731,6.827270986336117,5.209468571928844
2023-05-31T09:30:00-04:00,199.82,202.99,195.12,198.02,185.4121662403973,NaN,NaN,NaN,NaN,NaN,172.90720000000002,196.75440395853465,149.05999604146538,186.29829316188545,198.71,198.71,198.71,8720823,7125010.633333334,68.16867002486474,68.51748886967513,NaN,NaN,NaN,NaN,5.644157287878575,47.24839322045514,754290617,1.4173950156802286,6.98121234152913,5.563817325848901
2023-05-31T13:30:00-04:00,198.05,203.95,197.88,203.89,185.4121662403973,NaN,NaN,NaN,NaN,NaN,173.77100000000002,198.8823119529817,148.65968804701834,187.04836609888534,199.90381255206194,201.4501088955738,198.35751620855007,5198096,7198925.866666666,72.29599898220346,68.92856278367617,NaN,NaN,NaN,NaN,5.6745746244586766,47.882274880107026,759488713,1.5413667779275793,7.490525798258375,5.949159020330796
2023-06-01T09:30:00-04:00,202.63,207.19,199.38,206.94,186.9801893552298,NaN,NaN,NaN,NaN,NaN,174.77300000000002,201.0721231032509,148.47387689674915,189.76369287910828,204.50333333333333,204.50333333333333,204.50333333333333,10987175,7221445.7,74.17006157560455,69.04626248613229,NaN,NaN,NaN,NaN,5.827105008425915,48.732227003060004,770475888,1.6786754107352646,8.047503283749876,6.368827873014611
2023-06-01T13:30:00-04:00,206.95,209.8,206.45,207.5,192.10449892999208,NaN,NaN,NaN,NaN,NaN,175.85020000000003,202.99718259180844,148.70321740819162,194.18395430328664,205.63276103678805,207.23884518478843,204.02667688878768,5433333,7279496.233333333,74.51099327292681,69.01624497521681,NaN,NaN,NaN,NaN,5.650168936395494,49.71526702384423,775909221,1.6544133664803082,8.436844581114997,6.782431214634689
2023-06-02T09:30:00-04:00,210.14,217.24,209.76,216.54,196.87952170590154,NaN,NaN,NaN,NaN,NaN,177.0004,206.0087794680083,147.99202053199173,199.8771634426293,214.51333333333332,214.51333333333332,214.51333333333332,12879876,7468722.833333333,79.26814728103218,69.5610197991155,NaN,NaN,NaN,NaN,5.94229972665296,51.087703899351446,788789097,2.0675568548958,9.36687728325444,7.299320428358639
2023-06-02T13:30:00-04:00,216.5,216.58,213.52,213.99,198.7677252647242,NaN,NaN,NaN,NaN,NaN,178.07700000000006,208.46812245376773,147.68587754623238,201.15973075410344,214.5592983863047,214.63875995104874,214.47983682156067,4309759,7470425.6,75.01510727805764,70.07585960765459,NaN,NaN,NaN,NaN,5.736421174749177,52.36210956946529,784479338,1.988840888943038,9.785371539537437,7.7965306505943985
2023-06-05T09:30:00-04:00,217.79,221.28,216.4,217.59,202.3037377526913,NaN,NaN,NaN,NaN,NaN,179.14540000000005,211.21538926348262,147.07541073651748,205.29878460328274,218.4233333333333,218.42333714803055,218.42332951863602,10474932,7373147.166666667,76.89949087562948,71.23111547885289,NaN,NaN,NaN,NaN,5.847391090838521,53.79329943013224,794954270,1.9939090286921388,10.288916936459572,8.295007907767433
2023-06-05T13:30:00-04:00,217.61,218.55,214.53,217.57,202.3037377526913,NaN,NaN,NaN,NaN,NaN,180.20980000000003,213.7442017963631,146.67539820363697,205.29878460328274,217.96874321304625,218.6711794078621,217.2663070182304,4387099,7368073.6,76.86480668665271,72.33902971028301,NaN,NaN,NaN,NaN,5.716863155778627,54.559997411208506,790567171,1.8156612774443097,10.56458450457282,8.748923227128511
2023-06-06T09:30:00-04:00,216.14,220.97,212.53,219.79,202.3037377526913,NaN,NaN,NaN,NaN,NaN,181.36660000000006,216.26440958398223,146.4687904160179,205.29878460328274,217.76333333333332,217.76333333333332,217.76333333333332,12704484,7515004.066666666,78.04834678058573,73.40016769316745,NaN,NaN,NaN,NaN,5.911372930365869,55.42352078601264,803271655,1.6706720264291928,10.837263260165003,9.16659123373581
2023-06-06T13:30:00-04:00,219.8,221.91,218.93,221.3,204.0332997114645,NaN,NaN,NaN,NaN,NaN,182.55640000000005,218.73888034836546,146.37391965163465,207.57521771688076,218.42028813544664,219.64765403615164,217.19292223474164,3639820,7527913.3,78.84122945353144,74.50499972960476,NaN,NaN,NaN,NaN,5.701989149625449,56.28352586871762,806911475,1.5050107943563198,11.047854726681209,9.542843932324889
2023-06-07T09:30:00-04:00,228,230.82,223.21,224.78,210.07496790639792,NaN,NaN,NaN,NaN,NaN,183.82780000000005,221.3628388389283,146.2927611610718,214.59217417350462,226.26999999999998,226.26999999999998,226.26999999999998,14907648,7759653.633333334,80.58196925078121,74.88513231429819,NaN,NaN,NaN,NaN,5.974704210366488,57.54575892771344,821819123,1.4573675742548264,11.364553400143421,9.907185825888595
2023-06-07T13:30:00-04:00,224.83,227.24,223.24,224.59,210.07496790639792,NaN,NaN,NaN,NaN,NaN,185.11440000000005,223.7245935058594,146.5042064941407,214.59217417350462,225.97027998773194,226.5030265155371,225.43753345992678,4718450,7817173.866666666,80.19404708034938,75.76378690243597,NaN,NaN,NaN,NaN,5.833653909626024,58.71783248249527,817100673,1.248660832284834,11.468011866244638,10.219351033959803
2023-06-08T09:30:00-04:00,224.13,233.33,223.01,231.86,210.8070368733915,NaN,NaN,NaN,NaN,NaN,186.45520000000008,226.77168719618106,146.1387128038191,216.18419147104296,229.4,229.4,229.4,13443550,7890250.1,83.47256571764356,76.57037302101854,NaN,NaN,NaN,NaN,6.154107201795596,60.060225180942716,830544223,1.4231771688771282,11.998322495056215,10.575145326179086
2023-06-08T13:30:00-04:00,231.85,235.23,230.85,234.85,215.8689897427828,NaN,NaN,NaN,NaN,NaN,187.94060000000007,229.77833347780472,146.10286652219543,219.32335317683436,230.52083969864546,232.3916189011494,228.65006049614152,4825651,7920774.466666667,84.60153180296632,77.35235471877351,NaN,NaN,NaN,NaN,6.027385258810196,61.37719793287159,835369874,1.552358562322123,12.515593529081741,10.963234966759618
2023-06-09T09:30:00-04:00,249.05,252.42,242.02,247.35,228.43358111811085,NaN,NaN,NaN,NaN,NaN,189.66160000000008,233.98009498527497,145.34310501472518,230.90968254146748,247.26333333333332,247.26333333333332,247.26333333333332,17271619,8164701.566666666,88.22331228348153,78.78482916581756,NaN,NaN,NaN,NaN,6.851857740323753,63.05998805048417,852641493,2.2497208333122636,13.775386008399948,11.525665175087685
2023-06-09T13:30:00-04:00,247.37,247.55,243.28,244.44,228.43358111811085,NaN,NaN,NaN,NaN,NaN,191.3260000000001,237.460455323541,145.19154467645922,230.90968254146748,246.7740946155536,247.6817973699447,245.8663918611625,5017500,8204725.3,83.31069405582713,79.57159309964781,NaN,NaN,NaN,NaN,6.667439330300629,64.62257887398157,847623993,2.2780932199920674,14.373281700077769,12.095188480085701
2023-06-12T09:30:00-04:00,247.95,249.92,244.59,247.12,228.83454395265883,NaN,NaN,NaN,NaN,NaN,192.88380000000012,241.139991128598,144.62760887140223,231.7053968265392,247.20999999999998,247.2100046720309,247.20999532796907,9298598,8100691.566666666,84.18416463279846,80.28688617516168,NaN,NaN,NaN,NaN,6.582622235279155,66.12271843395548,856922591,2.2372168857625034,14.89170958728883,12.654492701526326
2023-06-12T13:30:00-04:00,247.11,250.96,246.7,249.84,230.66592831844707,NaN,NaN,NaN,NaN,NaN,194.4792000000001,244.841506514295,144.11689348570522,234.25831746123134,247.90948843481215,248.84724193850653,246.97173493111777,5173699,8138830.233333333,85.03994438266818,81.03895411157177,NaN,NaN,NaN,NaN,6.416720647044931,67.53740788092244,862096290,2.1525332365504912,15.34515924721444,13.192626010663949
2023-06-13T09:30:00-04:00,253.45,259.19,251.34,258.74,236.65156794033584,NaN,NaN,NaN,NaN,NaN,196.20980000000003,249.26698296178103,143.15261703821903,241.15365396898508,256.42333333333335,256.42333333333335,256.42333333333335,12295023,8193528.133333334,87.43556767722418,81.62234128272834,NaN,NaN,NaN,NaN,6.626240600827436,69.0044603253672,874391313,2.4343183715553387,16.235523975108123,13.801205603552784
2023-06-13T13:30:00-04:00,258.75,259.68,255.65,258.75,239.34808757941153,NaN,NaN,NaN,NaN,NaN,197.94819999999999,253.34069663122241,142.55570336877756,243.23592317518808,256.85489112151936,257.56600915849447,256.14377308454425,4528182,8164646.2,87.43800177894619,82.50969088993466,NaN,NaN,NaN,NaN,6.4407948436254765,70.37497767741088,878919495,2.358140063102578,16.748880682431007,14.39074061932843
2023-06-14T09:30:00-04:00,260.17,261.57,255.25,258.1,240.06385632580185,NaN,NaN,NaN,NaN,NaN,199.75960000000003,256.9491250492597,142.5700749507404,245.25473854015044,258.3066666666667,258.3066666666667,258.3066666666667,9872620,8065598.866666666,86.26811402237195,83.17887825755913,NaN,NaN,NaN,NaN,6.4321666405093705,71.68024196573809,869046875,2.01409625967651,16.908360943924066,14.894264684247556
2023-06-14T13:30:00-04:00,258.11,258.68,250.5,256.77,240.06385632580185,NaN,NaN,NaN,NaN,NaN,201.512,260.192637351685,142.831362648315,245.25473854015044,257.04457725707925,258.52132288746395,255.56783162669456,7211096,8155212.166666667,83.79753813030317,83.67407336067701,NaN,NaN,NaN,NaN,6.557011880472987,71.61469929616716,861835779,1.4722083539176118,16.73452512664457,15.262316772726958
2023-06-15T09:30:00-04:00,248.49,258.95,247.3,256.88,240.06385632580185,NaN,NaN,NaN,NaN,NaN,203.30100000000002,263.1586455601115,143.44335443988854,245.25473854015044,254.37666666666667,254.37666666666667,254.37666666666667,12668731,8268349.333333333,83.83876195194237,84.08767444434535,NaN,NaN,NaN,NaN,6.920796746153486,70.76882801634852,874504510,0.9232642324026106,16.41639706323022,15.49313283082761
2023-06-15T13:30:00-04:00,256.89,257.75,254.64,255.84,240.06385632580185,NaN,NaN,NaN,NaN,NaN,205.04680000000005,265.8330124419666,144.26058755803348,245.25473854015044,254.84004766867935,255.59703231209517,254.08306302526353,4747177,8305140.233333333,81.72171708104972,84.29342356059666,NaN,NaN,NaN,NaN,6.648596978571095,69.9833761136598,869757333,0.3231793501571545,15.897107018524054,15.573927668366899
2023-06-16T09:30:00-04:00,258.79,263.46,257.21,260.8,241.242342360914,NaN,NaN,NaN,NaN,NaN,206.8804,268.7425856658811,145.0182143341189,245.9011889060456,260.49,260.49,260.49,11478847,8426910.766666668,83.8201398529262,84.52472146074987,NaN,NaN,NaN,NaN,6.717982908673157,69.59174956574282,881236180,0.10466726276209215,15.704761746819514,15.600094484057422
2023-06-16T13:30:00-04:00,260.82,263.6,259.37,260.53,242.68337225359977,NaN,NaN,NaN,NaN,NaN,208.6498,271.48030577418575,145.81929422581425,247.43795112483653,260.7053420977651,261.02052870981163,260.39015548571854,5358221,8505607.733333332,83.25978946784785,84.7437030598569,NaN,NaN,NaN,NaN,6.540269843767932,69.23594124840007,875877959,-0.1972325640490915,15.353553778996059,15.55078634304515
2023-06-20T09:30:00-04:00,261.5,271.47,261.12,270.75,246.85617351479976,NaN,NaN,NaN,NaN,NaN,210.6984,274.80207207703467,146.59472792296532,253.0703608998692,267.78000000000003,267.78000000000003,267.78000000000003,12073982,8418211.633333333,86.84473595982884,84.98457236287013,NaN,NaN,NaN,NaN,6.854536283498798,69.30431072265468,887951941,0.13432470370674743,15.718692222678584,15.584367518971836
2023-06-20T13:30:00-04:00,270.77,274.75,269.46,274.46,252.82839290049068,NaN,NaN,NaN,NaN,NaN,212.8274,278.17730115493634,147.47749884506368,257.38528871989536,269.28135807493396,271.60898856402434,266.9537275858436,5023322,8415232.333333334,87.86101255034198,85.21739241625411,NaN,NaN,NaN,NaN,6.742783691820314,69.50857322536719,892975263,0.4297806817619243,16.121593371174242,15.691812689412318
2023-06-21T09:30:00-04:00,275.13,276.99,257.78,259.09,252.82839290049068,NaN,NaN,NaN,NaN,NaN,214.6478,279.980138245619,149.31546175438098,257.38528871989536,264.61999999999995,264.61999999999995,264.61999999999995,15330504,8593005.866666667,65.34045461579534,83.58290258284795,NaN,NaN,NaN,NaN,7.63329914240458,67.21075388117238,877644759,-0.5314998025069961,15.027437936278574,15.55893773878557
2023-06-21T13:30:00-04:00,259.07,264.68,258.97,259.46,252.82839290049068,NaN,NaN,NaN,NaN,NaN,216.5094,281.53801233764693,151.48078766235304,257.38528871989536,263.7004860388595,265.2655480512698,262.1354240264492,5291880,8642389.9,65.56924722947441,82.31565638096562,NaN,NaN,NaN,NaN,7.4959206322328225,65.07706449013433,882936639,-1.2243850188521694,14.028456465220358,15.252841484072528
2023-06-22T09:30:00-04:00,250.77,263.72,248.26,262.21,NaN,NaN,NaN,277.9938944730049,277.9938944730049,277.9938944730049,218.38739999999999,283.1627186094824,153.61208139051757,257.38528871989536,258.06333333333333,258.06333333333333,258.06333333333333,12743990,8776495.466666667,67.29715412738324,81.10944134486454,NaN,NaN,NaN,NaN,8.064783444216195,61.359126916924076,895680629,-1.5580464319521372,13.305283444132357,14.863329876084494
2023-06-22T13:30:00-04:00,262.24,265,261.92,264.6,NaN,NaN,NaN,277.9938944730049,NaN,NaN,220.34859999999998,284.6623061609732,156.03489383902678,257.38528871989536,259.4912043736584,261.9830950885887,256.99931365872806,4184325,8742703.1,68.7643053490739,79.9468956996078,NaN,NaN,NaN,NaN,7.708727483915037,58.04515429128544,899864954,-1.6684854978710764,12.777723003745649,14.446208501616725
2023-06-23T09:30:00-04:00,259.32,262.45,252.82,262.12,NaN,NaN,NaN,277.9938944730049,NaN,NaN,222.12179999999998,286.05442524752135,158.18917475247864,257.38528871989536,259.13,259.13,259.13,11644114,8764601.066666666,65.48149077038573,78.37874734911932,NaN,NaN,NaN,NaN,7.999532663635393,54.0267737139361,888220840,-1.9402129296275241,12.02094233958232,13.961155269209844
2023-06-23T13:30:00-04:00,262.12,262.43,254.68,256.54,NaN,NaN,NaN,277.9938944730049,NaN,NaN,223.77559999999997,286.9008407406103,160.65035925938963,257.38528871989536,258.7316082693207,259.31293925923234,258.15027727940907,5468650,8765778.3,58.69210927721594,76.32546931328146,NaN,NaN,NaN,NaN,7.981708901947151,50.29542032068315,882752190,-2.4922010035384723,10.845904014786754,13.338105018325226
2023-06-26T09:30:00-04:00,250.1,258.37,242.65,246.34,NaN,NaN,NaN,273.7591479450023,NaN,NaN,225.19999999999996,287.07102016291657,163.32897983708335,257.38528871989536,249.11999999999998,249.1200026973983,249.11999730260166,11668418,8725396.366666667,48.743183315311306,73.64511711991997,NaN,NaN,NaN,NaN,8.534443980379496,48.111600281624476,871083772,-3.480072268079587,8.988014683225742,12.46808695130533
2023-06-26T13:30:00-04:00,246.38,247.2,240.7,241.01,NaN,NaN,NaN,267.02873212932036,NaN,NaN,226.48159999999996,286.9386111547041,166.0245888452958,257.38528871989536,247.3730847461995,250.14649706803388,244.59967242436514,4629422,8736051.8,44.49842612474756,70.83803769095172,NaN,NaN,NaN,NaN,8.389126553209532,46.26090445337109,866454350,-4.370637016542734,7.004790680626911,11.375427697169645
2023-06-27T09:30:00-04:00,243.2,247.51,240.85,247.28,NaN,NaN,NaN,267.02873212932036,NaN,NaN,227.81819999999996,287.0887442782501,168.54765572174983,257.38528871989536,245.21333333333334,245.21333333333334,245.21333333333334,11003168,8753659.666666666,50.01310399257294,68.42191926528248,NaN,NaN,NaN,NaN,8.265617513694567,44.49648018465765,877457518,-4.4032805840311795,5.8713269671306705,10.27460755116185
2023-06-27T13:30:00-04:00,247.29,250.38,246.6,250.21,NaN,NaN,NaN,267.02873212932036,NaN,NaN,229.22019999999998,287.21296361616163,171.22743638383832,253.49323097591625,246.45544578138606,248.25524843484206,244.65564312793006,5240706,8782113.233333332,52.39358693323756,66.32705282615305,NaN,NaN,NaN,NaN,7.945216262716384,42.42535036268092,882698224,-4.099599576239177,5.1501080808628785,9.249707657102055
2023-06-28T09:30:00-04:00,249.68,259.88,248.9,256.31,NaN,NaN,NaN,267.02873212932036,NaN,NaN,230.6264000000001,287.76238484457764,173.49041515542257,243.41845425966912,255.03,255.03,255.03,11726988,8749530.033333333,56.986235890444085,64.41034540026146,NaN,NaN,NaN,NaN,8.161986529665212,39.532369229748554,894425212,-3.38939048958869,5.012969545116192,8.402360034704882
2023-06-28T13:30:00-04:00,256.33,257.13,254.06,256.37,NaN,NaN,NaN,267.02873212932036,NaN,NaN,231.9750000000001,288.2887996942117,175.66120030578853,243.41845425966912,255.2242891375198,255.57388383752328,254.87469443751633,3622045,8748937.533333333,57.03014632792437,62.5367994616955,NaN,NaN,NaN,NaN,7.798273206117696,36.846029606311355,898047257,-2.839341395684185,4.8531832900996505,7.692524685783836
2023-06-29T09:30:00-04:00,258.1,260.74,253.62,256.41,NaN,NaN,NaN,267.02873212932036,NaN,NaN,233.3530000000001,288.6091592946872,178.09684070531304,243.41845425966912,256.92333333333335,256.92333333333335,256.92333333333335,9255386,8560528.8,57.061616522605476,60.409433787608116,NaN,NaN,NaN,NaN,7.749825119966433,34.78829326278383,907302643,-2.4133168847295554,4.675878579871892,7.089195464601447
2023-06-29T13:30:00-04:00,256.45,257.59,254.69,257.46,NaN,NaN,NaN,267.02873212932036,NaN,NaN,234.7862000000001,288.7363219854026,180.83607801459758,242.28388970160472,256.8357572685957,256.9854176010888,256.6860969361027,3169217,8508887.7,57.932571118298235,58.27168797103355,NaN,NaN,NaN,NaN,7.403409039968829,32.87753808665114,910471860,-2.0174052106488842,4.567438951290342,6.584844161939226
2023-06-30T09:30:00-04:00,260.55,264.45,259.9,263.38,NaN,NaN,NaN,267.02873212932036,NaN,NaN,236.40700000000012,288.8042118723866,184.00978812761366,247.983089409027,262.57666666666665,262.57666666666665,262.57666666666665,8991302,8360479.433333334,62.54544477718428,58.072044411132765,NaN,NaN,NaN,NaN,7.373879822828199,31.896729256016158,919463162,-1.345731926160325,4.902679254238819,6.2484111803991444
2023-06-30T13:30:00-04:00,263.39,263.93,261.63,261.73,NaN,NaN,NaN,267.02873212932036,NaN,NaN,237.9848000000001,288.55412338720635,187.4154766127938,249.60647152722163,262.53498906566494,262.6011380821671,262.4688400491628,3569285,8318600.566666666,60.55245857119055,57.713702364112486,NaN,NaN,NaN,NaN,7.011459835483328,30.98597819899796,915893877,-1.0164593499450678,4.977836992967809,5.994296342912877
2023-07-03T09:30:00-04:00,276.46,284.25,275.11,279.89,256.644861065381,256.644861065381,256.644861065381,NaN,NaN,NaN,239.8968000000001,289.4191851509582,190.37441484904204,261.5311772217773,279.75,279.75,279.75,11751798,8134606.533333333,71.3667096418632,58.00438490086106,NaN,NaN,NaN,NaN,8.119212704377375,31.83399513100008,927645675,0.34748671988121327,6.428654742764394,6.081168022883181
2023-07-05T09:30:00-04:00,278.73,282.93,277.61,280.8,257.55645828968187,NaN,NaN,NaN,NaN,NaN,241.82420000000013,290.0458509198902,193.6025490801101,262.09494177742187,280.44666666666666,280.44666666666666,280.44666666666666,9280747,8276714.766666667,71.78413621148758,58.22008710531918,NaN,NaN,NaN,NaN,7.91926893977899,32.62143942500204,936926422,1.1867990903733547,7.564666885849874,6.3778677954765195
2023-07-05T13:30:00-04:00,280.78,283.85,278.75,282.44,258.9234374583327,NaN,NaN,NaN,NaN,NaN,243.53060000000008,291.3403754707118,195.72082452928834,264.6319534219375,280.82721605065706,281.3968882428925,280.2575438584216,4141474,8104810.633333334,72.56051198413107,58.72573147772955,NaN,NaN,NaN,NaN,7.717892586937635,33.41453763873955,941067896,1.6971650200025916,8.499324070479759,6.802159050477167
2023-07-06T09:30:00-04:00,278.085,279.97,272.88,276.53,258.9234374583327,NaN,NaN,NaN,NaN,NaN,245.19760000000008,291.6622238869946,198.73297611300558,264.6319534219375,276.46,276.46,276.46,9423206,8246460.866666666,65.55976577582766,59.216278370487544,NaN,NaN,NaN,NaN,7.849471687870661,33.182145198839834,931644690,1.4889079236745868,8.663293955070401,7.174386031395814
2023-07-06T13:30:00-04:00,276.53,278.2,275.57,276.53,258.9234374583327,NaN,NaN,NaN,NaN,NaN,246.7494000000001,292.1000917098279,201.39870829017227,264.6319534219375,276.5372847889936,276.67043031092334,276.40413926706384,3174926,7942457.633333334,65.55976577582766,60.417462831952996,NaN,NaN,NaN,NaN,7.476652281594185,32.966352218932954,931644690,1.2149178886653527,8.693033392227505,7.478115503562153
2023-07-07T09:30:00-04:00,278.44,280.78,274.05,279.68,258.9234374583327,NaN,NaN,NaN,NaN,NaN,248.3194000000001,292.6753914167171,203.96340858328307,264.6319534219375,278.17,278.17,278.17,8602519,8078268.866666666,67.498169586968,62.06030165068302,NaN,NaN,NaN,NaN,7.423319975766026,32.99493540907959,940247209,1.1123473289364014,8.868549664732654,7.756202335796253
2023-07-07T13:30:00-04:00,279.67,279.73,273.78,274.41,258.9234374583327,NaN,NaN,NaN,NaN,NaN,249.84720000000013,292.39332161689714,207.30107838310312,264.6319534219375,277.46981627164183,278.4934436468054,276.44618889647825,4025000,7883348.2,61.28365044377056,62.86534068291142,NaN,NaN,NaN,NaN,7.318082834639886,32.97245379034066,936222209,0.5827160996846654,8.484597460402085,7.90188136071742
2023-07-10T09:30:00-04:00,276.46,277.52,265.1,268.58,258.9234374583327,NaN,NaN,NaN,NaN,NaN,251.1410000000001,291.9158093312507,210.36619066874948,264.6319534219375,270.40000000000003,270.40000000000003,270.40000000000003,9052120,7944715.666666667,55.22603095818423,63.06765811326476,NaN,NaN,NaN,NaN,7.682505489308462,31.518417139528935,927170089,-0.22389035907280697,7.622018411876411,7.845908770949218
2023-07-10T13:30:00-04:00,268.59,270.35,267.91,269.54,258.9234374583327,NaN,NaN,NaN,NaN,NaN,252.39300000000011,291.4711095243848,213.31489047561539,264.6319534219375,270.11264535393116,270.6056929238954,269.6195977839669,3074745,7624916.133333334,55.99733167876327,62.997022098144704,NaN,NaN,NaN,NaN,7.308040811500715,30.168240249489482,930244834,-0.7279836536219557,6.9359292039217735,7.663912857543729
2023-07-11T09:30:00-04:00,268.63,270.89,266.67,268.45,258.9234374583327,NaN,NaN,NaN,NaN,NaN,253.6120000000001,290.76775949970386,216.45624050029636,264.6319534219375,268.67,268.67,268.67,6642606,7688097.1,54.842144084840086,62.84073622363868,NaN,NaN,NaN,NaN,7.08746646782209,28.71789120613769,923602228,-1.1452091428478592,6.232401428983906,7.377610571831765
2023-07-11T13:30:00-04:00,268.46,270.17,266.38,269.8,258.9234374583327,NaN,NaN,NaN,NaN,NaN,254.6772000000001,290.5523907679917,218.80200923200854,264.6319534219375,268.70410734845285,268.7560899250592,268.6521247718465,2859689,7400791.833333333,56.05141073556575,62.76857866742155,NaN,NaN,NaN,NaN,6.851933148691942,27.323125211522154,926461917,-1.3277906620250048,5.7178722443005086,7.045662906325513
2023-07-12T09:30:00-04:00,276.3,276.5,271.46,273.395,258.9234374583327,NaN,NaN,NaN,NaN,NaN,255.86530000000013,290.17237812740416,221.55822187259608,264.6319534219375,273.785,273.785,273.785,7714395,7479330.966666667,59.18577941829577,62.85809354599281,NaN,NaN,NaN,NaN,6.841080780928231,26.843569197167227,934176312,-1.2074337028738302,5.536370777733225,6.743804480607055
2023-07-12T13:30:00-04:00,273.41,274.44,271.81,271.99,258.9234374583327,NaN,NaN,NaN,NaN,NaN,256.9533000000001,289.75331863474753,224.15328136525272,263.464160152032,273.5174685909883,273.97157620476145,273.06336097721515,2677527,7166115.8,57.46097350319507,62.49491702642216,NaN,NaN,NaN,NaN,6.540289296576214,26.398267183837653,931498785,-1.21984641851998,5.218996457457081,6.438842875977061
2023-07-13T09:30:00-04:00,274.59,274.96,270.6,274.79,258.9234374583327,NaN,NaN,NaN,NaN,NaN,258.0977000000001,289.2741478547483,226.92125214525186,263.464160152032,273.45,273.45,273.45,7264327,7240815.966666667,59.96494663175681,62.452951887891174,NaN,NaN,NaN,NaN,6.384554346820766,25.75114060150343,938763112,-1.043692345997262,5.1342274434804835,6.177919789477746
2023-07-13T13:30:00-04:00,274.8,279.45,274.63,277.95,258.9234374583327,NaN,NaN,NaN,NaN,NaN,259.2609000000001,288.9373128351092,229.58448716489102,266.8262412691939,275.08491136154424,277.0064523423358,273.16337038075267,5258774,6905091.633333334,62.63787557741751,61.82946374043077,NaN,NaN,NaN,NaN,6.272800464904996,25.727553587976292,944021886,-0.7332294064103202,5.261383031464845,5.9946124378751655
2023-07-14T09:30:00-04:00,277.03,285.3,276.32,283.6,260.80016281494244,NaN,NaN,NaN,NaN,NaN,260.50690000000014,288.9073993540563,232.10640064594403,270.71099301535514,281.74,281.74,281.74,10909586,7092348.5,66.89387361945255,61.480159269571125,NaN,NaN,NaN,NaN,6.466171860268927,26.348320453992248,954931472,-0.19428209021125742,5.751759825111094,5.946041915322351
2023-07-14T13:30:00-04:00,283.6,283.96,278.8,281.39,261.5760645051723,NaN,NaN,NaN,NaN,NaN,261.6391000000001,288.7358941786458,234.54230582135438,270.71099301535514,281.647861024023,281.8039805633507,281.49174148469524,3799973,6794214.6,63.830993691915516,60.85662224869859,NaN,NaN,NaN,NaN,6.372873870249715,26.92474682957849,951131499,-0.04154173153703855,5.894114750901053,5.935656482438092
2023-07-17T09:30:00-04:00,286.625,292.23,283.58,286.46,267.523061573119,NaN,NaN,NaN,NaN,NaN,262.8765000000001,288.7142034776674,237.03879652233272,275.4090355298273,287.42333333333335,287.42333333333335,287.42333333333335,9975163,6987242.533333333,67.50667728117692,60.99568735622355,NaN,NaN,NaN,NaN,6.691954308089024,28.233551522428762,961106662,0.32581196084134856,6.342921433489778,6.017109472648429
2023-07-17T13:30:00-04:00,286.48,290.63,286.3,290.32,268.4190587743409,NaN,NaN,NaN,NaN,NaN,264.0457000000001,289.45059323023787,238.64080676976238,275.4090355298273,287.90142350789995,288.6531278878069,287.149719127993,4035018,6733606,70.00588111939953,61.31326702362154,NaN,NaN,NaN,NaN,6.523243286082663,29.44887016578973,965141680,0.7304618808735075,6.930186823740314,6.199724942866807
2023-07-18T09:30:00-04:00,290.11,291.4,286.01,290.65,268.83523792096173,NaN,NaN,NaN,NaN,NaN,265.1617000000001,290.23875657448224,240.08464342551795,276.20758273908945,289.3533333333333,289.3533333333333,289.3533333333333,8217622,6825238.4,70.21678783525158,61.50745404135608,NaN,NaN,NaN,NaN,6.442297337076758,30.645895250328646,973359302,0.9103347127305721,7.337643333780022,6.42730862104945
2023-07-18T13:30:00-04:00,290.66,295.25,290.33,293.37,273.15249983364527,NaN,NaN,NaN,NaN,NaN,266.0821000000001,291.84537510934564,240.31882489065453,280.63606619127154,290.62918156874747,292.3622540931232,288.8961090443717,4453595,6584744.3,71.96651767169213,62.27051598620762,NaN,NaN,NaN,NaN,6.333561812999847,32.088636624675985,977812897,1.0903417688757244,7.790235832144106,6.699894063268381
2023-07-19T09:30:00-04:00,296.14,299.29,292.5,294.6,276.2242043866614,NaN,NaN,NaN,NaN,NaN,267.0853000000001,293.30193429275187,240.86866570724828,284.20385295301725,295.4633333333333,295.4633333333333,295.4633333333333,9708157,6754035.466666667,72.74625188512863,63.521960338132224,NaN,NaN,NaN,NaN,6.366164540642717,33.739997778255685,987521054,1.1634232583405888,8.154173136194117,6.990749877853529
2023-07-19T13:30:00-04:00,294.59,294.72,289.53,291.13,276.2242043866614,NaN,NaN,NaN,NaN,NaN,267.9655000000001,294.39608185132965,241.53491814867047,284.20385295301725,294.34754024704597,296.0357246016936,292.65935589239837,4240962,6528628.6,67.07788504107742,64.31342843544037,NaN,NaN,NaN,NaN,6.282152787739669,34.54545453831572,983280092,0.863060124778408,8.069575033826538,7.20651490904813
2023-07-20T09:30:00-04:00,279.61,280.92,264.2,266.12,NaN,NaN,NaN,294.8310141848808,294.8310141848808,294.8310141848808,268.2911000000001,294.2167892899655,242.36541071003467,284.20385295301725,270.41333333333336,270.41333333333336,270.41333333333336,13607692,6807528.133333334,41.79812207935469,63.38171257790571,NaN,NaN,NaN,NaN,7.756999017186836,32.759298705663944,969672400,-1.0322248991206084,5.916233785147369,6.948458684267978
2023-07-20T13:30:00-04:00,266.11,266.94,261.2,262.91,NaN,NaN,NaN,286.1114226310226,NaN,NaN,268.37450000000007,294.20340166073527,242.5455983392649,284.20385295301725,268.5433623460503,271.5580121185989,265.52871257350165,5235769,6591154.166666667,39.72858705704945,62.21579660086883,NaN,NaN,NaN,NaN,7.612927658816348,31.396575061311022,964436631,-2.434244371780518,3.90565321954233,6.339897591322848
2023-07-21T09:30:00-04:00,267.94,268,255.8,265.98,NaN,NaN,NaN,284.6031761477943,NaN,NaN,268.5191000000001,294.211447786059,242.8267522139412,284.20385295301725,263.26,263.26,263.26,9891864,6800148.133333334,42.65303871652729,61.034886550742506,NaN,NaN,NaN,NaN,7.940575683186609,30.63381286881441,974328495,-3.0472753114860742,2.530803451965255,5.578078763451329
2023-07-21T13:30:00-04:00,265.93,267.46,259.36,259.98,NaN,NaN,NaN,284.6031761477943,NaN,NaN,268.5567000000001,294.19338789917754,242.92001210082267,284.20385295301725,262.9404991485702,263.404492738684,262.47650555845644,4690274,6647977.733333333,38.70073884033981,59.694869789109994,NaN,NaN,NaN,NaN,7.9519631343875625,29.925533690067553,969638221,-3.7055282831297394,0.9461684095391547,4.651696692668894
2023-07-24T09:30:00-04:00,255.85,267.8,254.13,267.11,NaN,NaN,NaN,284.5695881842506,NaN,NaN,268.7635000000001,294.1824306029939,243.3445693970062,284.20385295301725,263.0133333333334,263.0133333333334,263.0133333333334,9351546,6854055.366666666,45.19918990878795,58.640172880326496,NaN,NaN,NaN,NaN,8.360394339074166,29.74289595143912,978989767,-3.5112472653763134,0.26263761094850224,3.7738848763248156
2023-07-24T13:30:00-04:00,267.16,269.85,266.85,269.15,NaN,NaN,NaN,284.5695881842506,NaN,NaN,269.00890000000004,294.20008284558924,243.81771715441084,284.20385295301725,264.65535449285704,267.20575807050517,262.1049509152089,3876351,6683557,46.93262482860679,57.51836925541145,NaN,NaN,NaN,NaN,7.977509029140296,29.26216720331426,982866118,-3.1096280574434343,-0.11315019547947713,2.996477861963957
2023-07-25T09:30:00-04:00,272.43,272.89,265.42,269.43,NaN,NaN,NaN,284.5695881842506,NaN,NaN,269.2807000000001,294.18934877988875,244.37205122011142,284.20385295301725,269.24666666666667,269.24666666666667,269.24666666666667,8456184,6846453.633333334,47.179589528672004,56.11020610606998,NaN,NaN,NaN,NaN,7.941258384201701,28.36073727473269,991322302,-2.7043384482015798,-0.38394519828801776,2.320393249913562
2023-07-25T13:30:00-04:00,269.4,270.24,265,265.24,NaN,NaN,NaN,284.5695881842506,NaN,NaN,269.3695000000001,294.18807451587077,244.55092548412935,284.20385295301725,268.6508704329977,269.6933932065841,267.60834765941127,2761842,6546788.433333334,43.88808412463392,54.68571256554986,NaN,NaN,NaN,NaN,7.748311356758722,27.56922251162533,988560460,-2.597095476462548,-0.9259760956646232,1.6711193807979248
2023-07-26T09:30:00-04:00,263.205,268.04,261.75,264.38,NaN,NaN,NaN,284.5695881842506,NaN,NaN,269.44650000000007,294.17863684661876,244.71436315338138,280.0560823624138,264.7233333333333,264.7233333333333,264.7233333333333,5898373,6434042.633333334,43.22156893143889,52.95106196914001,NaN,NaN,NaN,NaN,7.644146259847386,27.18818491653272,982662087,-2.463852090334483,-1.4086957321201794,1.0551563582143038
2023-07-26T13:30:00-04:00,264.39,266.38,263.07,264.47,NaN,NaN,NaN,284.5695881842506,NaN,NaN,269.32090000000005,294.08904096293764,244.55275903706246,255.72386588993103,264.69357595329006,264.73350438956936,264.65364751701077,3276099,6405196.8,43.31858258809555,51.044826359761146,NaN,NaN,NaN,NaN,7.334564384144002,26.83436429251815,985938186,-2.2550545887275115,-1.7636618776950854,0.4913927110324259
2023-07-27T09:30:00-04:00,268.31,269.13,262.5,262.92,NaN,NaN,NaN,284.5695881842506,NaN,NaN,269.0901000000001,293.8774481026065,244.30275189739376,252.36025384493058,264.84999999999997,264.84999999999997,264.84999999999997,7264987,6333256.166666667,41.987980069406554,49.028482947915066,NaN,NaN,NaN,NaN,7.284238356705145,26.021061109704863,978673199,-2.1093679844232334,-2.1453172694966156,-0.035949285073382464
2023-07-27T13:30:00-04:00,262.89,263.22,255.3,255.72,NaN,NaN,NaN,281.114222864565,NaN,NaN,269.0227000000001,293.93645244397806,244.10894755602214,252.36025384493058,262.27312803466833,265.56024745439913,258.98600861493753,4464672,6376247.7,36.395468410513814,46.487693714973766,NaN,NaN,NaN,NaN,7.329649902654778,26.083323649962132,974208527,-2.366637324672334,-2.9942459409137996,-0.6276086162414659
2023-07-28T09:30:00-04:00,259.86,267.05,258.25,265.8,NaN,NaN,NaN,281.114222864565,NaN,NaN,269.1495000000001,293.93146911062126,244.36753088937897,252.36025384493058,263.7,263.7,263.7,9069727,6391821.3,47.032166746132766,44.65097334790262,NaN,NaN,NaN,NaN,7.615389195322295,25.48890393752509,983278254,-1.7548218845266386,-2.821135971899764,-1.0663140873731256
2023-07-28T13:30:00-04:00,265.78,267.25,263.9,266.48,NaN,NaN,NaN,281.114222864565,NaN,NaN,269.2349000000001,293.9499639481237,244.5198360518765,252.36025384493058,264.34154342136014,265.33393861432194,263.34914822839835,3790330,6383998.966666667,47.66796520274654,43.264550502307564,NaN,NaN,NaN,NaN,7.310718538513561,24.903040225187144,987068584,-1.2262397631962956,-2.599113791368495,-1.3728740281721996
2023-07-31T09:30:00-04:00,267.4,269.08,263.78,266.58,NaN,NaN,NaN,281.114222864565,NaN,NaN,269.2745000000001,293.9660655437198,244.58293445628038,252.56799197488354,266.47999999999996,266.47999999999996,266.47999999999996,6857724,6310852.433333334,47.76725985107302,43.69091748600174,NaN,NaN,NaN,NaN,7.167095785762593,24.039009488782998,993926308,-0.811755218393903,-2.3875680511645783,-1.5758128327706753
2023-07-31T13:30:00-04:00,266.61,268.33,265.83,267.49,NaN,NaN,NaN,281.114222864565,NaN,NaN,269.3819000000001,293.9946421381659,244.76915786183432,253.87039357990682,266.6520169460823,266.96367271858884,266.3403611735758,2089162,6277999.666666667,48.720771016375224,44.33321634023928,NaN,NaN,NaN,NaN,6.833731801065265,23.23669523355058,996015470,-0.4369703268274443,-2.122025741304981,-1.6850554144775365
2023-08-01T09:30:00-04:00,266.26,266.47,260.25,261.19,NaN,NaN,NaN,281.114222864565,NaN,NaN,269.4749000000001,293.9274644045728,245.02233559542742,253.87039357990682,262.6366666666667,262.6366666666667,262.6366666666667,6973599,6289032.766666667,42.88412485687225,44.34972249312107,NaN,NaN,NaN,NaN,6.8627509581320325,23.232877822289733,989041871,-0.5658446644782391,-2.3923612450753353,-1.8265165805970962
2023-08-01T13:30:00-04:00,261.18,262.17,260.3,261.09,NaN,NaN,NaN,281.114222864565,NaN,NaN,269.76990000000006,293.4423828009207,246.09741719907944,253.87039357990682,262.2637308299274,262.89750983316833,261.62995182668647,2414624,6274197.266666667,42.79648504271756,44.642275793290914,NaN,NaN,NaN,NaN,6.506125889694031,23.229333083261807,986627247,-0.6066878536487972,-2.5848763976580926,-1.9781885440092954
2023-08-02T09:30:00-04:00,255.55,259.52,250.5,253.82,NaN,NaN,NaN,275.8044745892207,NaN,NaN,270.02610000000004,292.70439987366706,247.34780012633306,253.87039357990682,254.61333333333332,254.61333333333332,254.61333333333332,7715368,6274229.7,36.8934746285967,44.04901041613439,NaN,NaN,NaN,NaN,6.797831183287313,24.29657580041176,978911879,-1.0464036421660268,-3.286193096716829,-2.2397894545508024
2023-08-02T13:30:00-04:00,253.82,255.48,252.94,254.18,NaN,NaN,NaN,274.4056348351652,NaN,NaN,270.1641000000001,292.3660416889578,247.96215831104237,253.87039357990682,254.50588670396624,254.68717789325075,254.32459551468173,2710122,6275316.2,37.35427167257082,43.36484233356039,NaN,NaN,NaN,NaN,6.493700384481075,25.28758689490815,981622001,-1.2237606797824925,-3.769490304278918,-2.5457296244964254
2023-08-03T09:30:00-04:00,252.03,258.58,251.98,257.71,NaN,NaN,NaN,274.4056348351652,NaN,NaN,270.31410000000005,292.07165718732995,248.55654281267016,253.87039357990682,256.09,256.09,256.09,6636271,6254381,41.83888523218554,42.98336345523993,NaN,NaN,NaN,NaN,6.501293214160998,25.5485737939606,988258272,-1.0222877936549413,-3.823589366565102,-2.8013015729101607
2023-08-03T13:30:00-04:00,257.7,260.49,257.02,259.31,NaN,NaN,NaN,274.4056348351652,NaN,NaN,270.37410000000006,291.99295581523506,248.75524418476508,253.87039357990682,257.02454857234176,258.3624881812661,255.68660896341743,3237836,6187016.4,43.802605857023494,42.97725786469632,NaN,NaN,NaN,NaN,6.284772270292357,25.40004126757652,991496108,-0.7147712825876296,-3.694765676144698,-2.9799943935570683
2023-08-04T09:30:00-04:00,260.92,264.77,256.5,259.59,NaN,NaN,NaN,274.4056348351652,NaN,NaN,270.4385000000001,291.90877938802515,248.96822061197503,253.87039357990682,260.28666666666663,260.28666666666663,260.28666666666663,7282988,6066129.8,44.15793528696239,43.044141175805144,NaN,NaN,NaN,NaN,6.426574250985759,24.442793834670205,998779096,-0.43951941337452016,-3.5293936602752183,-3.089874246900698
2023-08-04T13:30:00-04:00,259.55,259.89,253.11,253.86,NaN,NaN,NaN,274.4056348351652,NaN,NaN,270.38750000000005,292.0024559564656,248.77254404353445,253.87039357990682,258.6222667059699,260.8576576309305,256.3868757810093,4037551,6074049.066666666,38.757246080617406,42.718331425270996,NaN,NaN,NaN,NaN,6.451818947343917,24.015460007255015,994741545,-0.5814619603173989,-3.8167016972974466,-3.2352397369800476
2023-08-07T09:30:00-04:00,251.44,253.65,242.76,246.72,NaN,NaN,NaN,268.791869145087,NaN,NaN,270.1727000000001,292.4990115816257,247.8463884183744,253.87039357990682,247.71,247.71,247.71,7777089,6000779.933333334,33.29309314845902,42.09726807377474,NaN,NaN,NaN,NaN,6.783831879676496,24.751299272759354,986964456,-1.0661106586058628,-4.567878060237376,-3.5017674016315135
2023-08-07T13:30:00-04:00,246.72,251.57,246.33,251.41,NaN,NaN,NaN,268.791869145087,NaN,NaN,269.93330000000003,292.79608177387655,247.0705182261235,251.2823148639255,248.286713281074,249.21160849160495,247.36181807054302,3023792,5967072.4,39.34251219618692,42.30777120132283,NaN,NaN,NaN,NaN,6.673558173985316,25.434578590727668,989988248,-0.9827620028220831,-4.730219905159117,-3.7474579023370342
2023-08-08T09:30:00-04:00,247.45,250.92,245.01,249.17,NaN,NaN,NaN,268.277663828478,NaN,NaN,269.68210000000005,293.1674150789988,246.19678492100132,250.02818666768886,248.36666666666667,248.36666666666667,248.36666666666667,6373121,5905589.033333333,37.589174718485076,41.63327177077656,NaN,NaN,NaN,NaN,6.654018304414936,26.200231135648515,983615127,-0.9877893805661628,-4.982194628044738,-3.994405247478575
2023-08-08T13:30:00-04:00,249.13,250.46,248.37,249.63,NaN,NaN,NaN,268.277663828478,NaN,NaN,269.0769000000001,293.03364843462344,245.12015156537672,250.02818666768886,248.6632910008075,249.157490614953,248.16909138666202,2295942,5833667.266666667,38.19828850162985,40.95686629212537,NaN,NaN,NaN,NaN,6.328016996956726,26.911194213075014,985911069,-0.8733865364332534,-5.086138418020141,-4.212751881586888
2023-08-09T09:30:00-04:00,250.87,251,242.21,245.17,NaN,NaN,NaN,266.5837081577662,NaN,NaN,268.3643,292.9940239943934,243.73457600560664,250.02818666768886,246.12666666666667,246.12666666666667,246.12666666666667,6511417,5727109.266666667,34.66564732919663,40.021036826277054,NaN,NaN,NaN,NaN,6.503872925745531,28.17078623028201,979399652,-1.0021166105053414,-5.465397644718564,-4.463281034213223
2023-08-09T13:30:00-04:00,245.16,246.64,241.9,242.19,NaN,NaN,NaN,263.98694869604947,NaN,NaN,267.55930000000006,292.91652177289717,242.20207822710296,250.02818666768886,245.3759857985087,246.53818821116673,244.2137833858507,2716581,5676296.566666666,32.50272238635465,38.862604781275586,NaN,NaN,NaN,NaN,6.377882002477992,29.368423622361366,976683071,-1.1797552753289224,-5.937975128374376,-4.758219853045453
2023-08-10T09:30:00-04:00,245.4,251.8,243.8,244.8,NaN,NaN,NaN,263.98694869604947,NaN,NaN,266.9247000000001,292.9319837805073,240.91741621949285,250.02818666768886,246.80000000000004,246.80000000000004,246.80000000000004,8518333,5506651.266666667,36.25420226612896,38.38903888193678,NaN,NaN,NaN,NaN,6.6087475737295645,29.315624716005743,985201404,-1.0193071433214813,-6.032353782197305,-5.0130466388758235
2023-08-10T13:30:00-04:00,244.8,246.19,243,245.37,NaN,NaN,NaN,263.98694869604947,NaN,NaN,266.30150000000003,292.84604296084115,239.75695703915895,250.02818666768886,246.29378030072115,247.14770221204935,245.43985838939295,2993618,5431912.9,37.07672276547272,37.98048443356215,NaN,NaN,NaN,NaN,6.364551318463167,29.36060535711614,988195022,-0.7832285401216135,-5.99208231402784,-5.208853773906227
2023-08-11T09:30:00-04:00,241.8,243.19,238.19,242.39,NaN,NaN,NaN,260.4269827079371,NaN,NaN,265.55570000000006,292.64462644679577,238.46677355320438,244.7065493341511,241.25666666666666,241.25666666666666,241.25666666666666,8023303,5369627.533333333,34.565613926361934,37.81420866911681,NaN,NaN,NaN,NaN,6.422797652858655,29.936120607195065,980171719,-0.7368894235440973,-6.129965553336348,-5.3930761297922505
2023-08-11T13:30:00-04:00,242.36,243.79,241.4,242.56,NaN,NaN,NaN,260.4269827079371,NaN,NaN,264.91870000000006,292.63546653651855,237.2019334634816,236.1174586072683,241.62242630968896,242.21526778086368,241.02958483851424,3053990,5315084.733333333,34.83674811720185,37.63438555801902,NaN,NaN,NaN,NaN,6.134740677654465,30.331866743354098,983225709,-0.6091993533002196,-6.154575321417525,-5.545375968117305
2023-08-14T09:30:00-04:00,235.67,240.66,233.75,238.76,NaN,NaN,NaN,256.7009491202485,NaN,NaN,264.32230000000004,292.9660807008758,235.67851929912425,236.1174586072683,237.72333333333333,237.72333333333333,237.72333333333333,7025617,5237553.766666667,31.67707148651408,36.90854171904249,NaN,NaN,NaN,NaN,6.325830629250575,31.448083431422475,976200092,-0.68918144260976,-6.406852771379505,-5.717671328769745
2023-08-14T13:30:00-04:00,238.77,239.84,237.44,239.79,NaN,NaN,NaN,256.7009491202485,NaN,NaN,263.7273,293.138502301843,234.31609769815702,236.1174586072683,238.038378381157,238.59542880976605,237.48132795254796,2247195,5183248.566666666,33.43929603821138,36.16830530341306,NaN,NaN,NaN,NaN,6.0454141557326775,32.4845703560574,978447287,-0.585325524809237,-6.449328234781291,-5.864002709972054
2023-08-15T09:30:00-04:00,238.67,240.5,233.21,233.93,NaN,NaN,NaN,255.9253585992347,NaN,NaN,263.0369,293.5714415482196,232.50235845178042,236.1174586072683,235.88000000000002,235.88000000000002,235.88000000000002,6894187,5131182,28.87601598485969,35.076739638977145,NaN,NaN,NaN,NaN,6.134313144608915,33.811226458561464,971553100,-0.8100574329445198,-6.876574501152703,-6.066517068208183
2023-08-15T13:30:00-04:00,233.87,234.39,232.61,232.93,NaN,NaN,NaN,251.94625139017856,NaN,NaN,262.2995,293.90706341447367,230.6919365855264,235.13096688581464,235.1816833895375,236.324936467582,234.03843031149302,2572190,5124860.266666667,28.16955679649074,34.320476118682386,NaN,NaN,NaN,NaN,5.823290777136847,35.092790394183986,968980910,-0.9169608756947145,-7.212718162826576,-6.2957572871318614
2023-08-16T09:30:00-04:00,228.11,233.92,226.67,228.57,NaN,NaN,NaN,248.89142178153406,NaN,NaN,261.403,294.2205066085162,228.58549339148388,234.94281880692137,229.72,229.72,229.72,7744086,5186384.033333333,25.2670363829493,33.74718634971741,NaN,NaN,NaN,NaN,5.92519857876993,36.736165361366524,961236824,-1.1567450750492316,-7.7416886309434005,-6.584943555894169
2023-08-16T13:30:00-04:00,228.54,229.46,225.36,225.59,NaN,NaN,NaN,245.72022079146439,NaN,NaN,260.475,294.6390588338098,226.3109411661902,234.94281880692137,228.83807436391402,230.17766022442459,227.49848850340345,3356549,5189065.7,23.48582467385563,32.61456581240803,NaN,NaN,NaN,NaN,5.794827251714935,38.35283138245331,957880275,-1.376541642280655,-8.305620608744988,-6.929078966464333
2023-08-17T09:30:00-04:00,226.12,226.74,221.54,223.89,NaN,NaN,NaN,242.32702893730686,NaN,NaN,259.457,294.8649236894796,224.04907631052038,231.10925504553708,224.05666666666664,224.05666666666664,224.05666666666664,8017669,5214155.1,22.510899197012066,31.537546132302815,NaN,NaN,NaN,NaN,5.752339590878155,40.10615554126208,949862606,-1.487464223136099,-8.788409245384457,-7.300945022248358
2023-08-17T13:30:00-04:00,223.88,223.92,218.83,219.19,NaN,NaN,NaN,239.42943671288384,NaN,NaN,258.2818,295.0316557689695,221.53194423103048,230.07132322914373,222.92884930220444,224.53318256098547,221.32451604342342,3962201,5197406.066666666,20.034717809932545,30.24014822575301,NaN,NaN,NaN,NaN,5.705029620101143,41.89918832448512,945900405,-1.7123947131967938,-9.44143841374435,-7.729043700547557
2023-08-18T09:30:00-04:00,214,217.58,212.36,215.23,NaN,NaN,NaN,233.1351441350255,NaN,NaN,256.9144,294.86263403743556,218.96616596256442,230.07132322914373,215.05666666666673,215.05666666666673,215.05666666666673,11262518,5270499.1,18.216535578330095,29.065211672119684,NaN,NaN,NaN,NaN,5.785384647236774,43.90697975647429,934637887,-1.9458639589198068,-10.161373649197316,-8.215509690277509
2023-08-18T13:30:00-04:00,215.26,216.31,214.17,215.42,NaN,NaN,NaN,232.8712739470698,NaN,NaN,255.595,294.6196540023104,216.57034599768954,226.336046866652,215.11694539215333,215.2219896612146,215.01190112309206,3708676,5267777.3,18.598243395999035,28.07203460138,NaN,NaN,NaN,NaN,5.525000029577006,45.77135751474996,938346563,-1.9031679652048332,-10.594469646783551,-8.691301681578718
2023-08-21T09:30:00-04:00,221.65,229.95,220.58,228.14,NaN,NaN,NaN,232.8712739470698,NaN,NaN,254.42860000000002,293.1787221696137,215.67847783038633,226.336046866652,226.2233333333333,226.22333714803057,226.22332951863604,9799284,5365829.3,39.093289130351025,28.274826520253004,NaN,NaN,NaN,NaN,6.168214313178649,44.43968189045345,948145847,-0.8856421117629019,-9.798354321282346,-8.912712209519444
2023-08-21T13:30:00-04:00,228.13,232.12,228.08,231.23,NaN,NaN,NaN,232.8712739470698,NaN,NaN,253.2468,291.1411789900303,215.35242100996967,226.0518374933216,227.58198800114232,229.5651341583179,225.59884184396674,4599420,5449504.566666666,42.8571459509085,28.687713890641273,NaN,NaN,NaN,NaN,6.016199005094459,42.82697843968996,952745267,0.07700228049955271,-8.816459358895003,-8.893461639394555
2023-08-22T09:30:00-04:00,240.28,240.84,229.56,232.3,215.99597877312047,215.99597877312047,215.99597877312047,NaN,NaN,NaN,252.07980000000003,288.87270594448864,215.28689405551142,222.76335234574307,234.23333333333332,234.23333714803059,234.23332951863605,10942903,5581814.7,44.14434316779223,29.371908836457724,NaN,NaN,NaN,NaN,6.392184790444856,40.00629584150161,963688170,0.8256974417035714,-7.861339837265092,-8.687037278968663
2023-08-22T13:30:00-04:00,232.29,234.19,230.79,233.18,215.99597877312047,NaN,NaN,NaN,NaN,NaN,250.87600000000003,286.09115491943743,215.66084508056264,222.76335234574307,233.88849948909527,234.52327359916666,233.25372537902388,3229341,5608971.933333334,45.23692646431301,30.114778718394234,NaN,NaN,NaN,NaN,6.178457305413081,37.38709057175528,966917511,1.3870382446387133,-6.953239473170271,-8.340277717808984
2023-08-23T09:30:00-04:00,229.25,237.14,229.25,236.67,215.99597877312047,NaN,NaN,NaN,NaN,NaN,249.71740000000005,282.85257015136597,216.58222984863417,222.76335234574307,234.35333333333332,234.35333333333332,234.35333333333332,6747874,5576722.133333334,49.45929491659222,31.38493753482839,NaN,NaN,NaN,NaN,6.300710355026432,34.89364997180607,973665385,1.9649253148420458,-5.884121074256427,-7.849046389098473
2023-08-23T13:30:00-04:00,236.69,238.97,236.51,236.86,219.25257507680962,NaN,NaN,NaN,NaN,NaN,248.63200000000003,279.7648102168756,217.49918978312445,224.24075640102046,235.23344418200682,236.62910929917834,233.8377790648353,2683362,5575830.133333334,49.68673326181982,32.545468765086135,NaN,NaN,NaN,NaN,6.026373901095973,32.83074523399468,976348747,2.3078127168271045,-4.964280493064592,-7.272093209891697
2023-08-24T09:30:00-04:00,238.66,238.92,228.18,232.12,219.25257507680962,NaN,NaN,NaN,NaN,NaN,247.95200000000006,279.01238557391054,216.89161442608957,224.24075640102046,233.07333333333335,233.07333333333335,233.07333333333335,7842685,5616043.933333334,44.327473656675295,33.64914431307296,NaN,NaN,NaN,NaN,6.363061479589116,31.19846810851036,968506062,2.1655511006412125,-4.565154334090181,-6.7307054347313935
2023-08-24T13:30:00-04:00,232.13,233.78,229.86,230.05,219.25257507680962,NaN,NaN,NaN,NaN,NaN,247.29480000000004,278.45180710658906,216.13779289341102,224.24075640102046,232.5913017297616,233.40135756470377,231.78124589481942,2777064,5600684.866666666,42.18742308521946,34.650420476553585,NaN,NaN,NaN,NaN,6.188557088189893,29.682782206274922,965728998,1.8921225011495855,-4.365552308294411,-6.257674809443997
2023-08-25T09:30:00-04:00,231.29,237.76,230.35,234.91,219.25257507680962,NaN,NaN,NaN,NaN,NaN,246.67340000000002,277.5530739905076,215.79372600949242,224.24075640102046,234.34,234.34,234.34,8127666,5628840.8,48.476759592060915,36.308257848632984,NaN,NaN,NaN,NaN,6.297231581890614,27.66937184699237,973856664,1.9887584369926454,-3.7717267632031906,-5.760485200195836
2023-08-25T13:30:00-04:00,234.89,239,234.28,238.6,219.25257507680962,NaN,NaN,NaN,NaN,NaN,246.24580000000003,276.96830044251027,215.5232995574898,224.24075640102046,235.2835015051595,236.66055609920696,233.90644691111206,3815476,5621438.3,52.6854946584963,38.3939485618216,NaN,NaN,NaN,NaN,6.184572183184142,25.769104567998657,977672140,2.2330783893728086,-2.9691372134798257,-5.202215602852634
2023-08-28T09:30:00-04:00,242.6,244.38,235.35,238.99,220.7297690800921,NaN,NaN,NaN,NaN,NaN,245.68340000000003,275.8826284961057,215.48417150389434,227.4802494574864,239.57333333333335,239.57333333333335,239.57333333333335,7450631,5610556.366666666,53.121354044518235,40.580409622357756,NaN,NaN,NaN,NaN,6.387817027242418,24.749776322203694,985122771,2.3414682386272387,-2.2753803045685856,-4.616848543195824
2023-08-28T13:30:00-04:00,239.04,239.68,236.04,238.89,220.7297690800921,NaN,NaN,NaN,NaN,NaN,245.07820000000004,274.57677371196087,215.5796262880392,227.4802494574864,239.24719934589325,239.83067186884082,238.66372682294568,2327793,5587356.4,52.98657015544823,42.93411336132316,NaN,NaN,NaN,NaN,6.191544382439389,23.803257236822652,982794978,2.322370422625701,-1.7138855149136987,-4.0362559375394
2023-08-29T09:30:00-04:00,238.585,254.87,237.78,253.28,226.08554372793515,NaN,NaN,NaN,NaN,NaN,244.75520000000003,273.5247895667632,215.98561043323684,234.0531596527913,248.64333333333332,248.64333333333332,248.64333333333332,9156093,5680122.133333334,66.25509263297812,46.3654388652266,NaN,NaN,NaN,NaN,6.970005497979433,24.546918391381357,991951071,3.1437917437181953,-0.10651625789165564,-3.250308001609851
2023-08-29T13:30:00-04:00,253.3,257.43,253.1,257.39,235.35506446757444,NaN,NaN,NaN,NaN,NaN,244.59819999999996,273.00227680316533,216.1941231968346,238.61152772223303,250.5002909671424,253.68826960603587,247.31231232824894,3106586,5707143.6,68.95048023913608,49.96202721116496,NaN,NaN,NaN,NaN,6.781433676695189,25.446619472042837,995057657,3.785762992040394,1.4818957384406417,-2.303867253599752
2023-08-30T09:30:00-04:00,254.15,260.51,250.6,257.93,235.35506446757444,NaN,NaN,NaN,NaN,NaN,244.46919999999994,272.56970528798615,216.36869471201376,240.5002221777864,256.34666666666664,256.34666666666664,256.34666666666664,8842555,5784848.2,69.29747561953468,52.11946910324951,NaN,NaN,NaN,NaN,7.004902699788389,26.52687528595445,1003900212,4.04514763816251,2.752567294103386,-1.2925803440591246
2023-08-30T13:30:00-04:00,257.93,259.24,254.21,257.04,236.608075269009,NaN,NaN,NaN,NaN,NaN,244.32059999999998,272.0728883842043,216.56831161579566,240.71717774222915,256.47356262247433,256.6862371664679,256.2608880784808,3148055,5799230.666666667,67.94964010165226,53.91179011401692,NaN,NaN,NaN,NaN,6.8638382212320765,27.529969970300943,1000752157,3.9506580732213643,3.645742247467581,-0.3049158257537835
2023-08-31T09:30:00-04:00,255.98,259.92,255.05,257.75,237.61839002950856,NaN,NaN,NaN,NaN,NaN,244.21719999999996,271.72900896706165,216.70539103293828,242.66674219378334,257.5733333333333,257.5733333333333,257.5733333333333,7303686,5758742.433333334,68.47639476368356,55.649793799437724,NaN,NaN,NaN,NaN,6.7214212054297855,28.519867115195236,1008055843,3.732424220822772,4.3606144502746815,0.6281902294519096
2023-08-31T13:30:00-04:00,257.77,261.17,256.81,258.1,239.43187230089453,NaN,NaN,NaN,NaN,NaN,244.26479999999995,271.864147598088,216.66545240191192,245.18739375502665,257.8779809147399,258.37637347322084,257.379588356259,2728943,5749919.933333334,68.74906197346729,57.329232050091605,NaN,NaN,NaN,NaN,6.552748262184801,29.550149674522117,1010784786,3.4165887167627322,4.898926125405325,1.4823374086425924
2023-09-01T09:30:00-04:00,257.26,259.07,245.46,246.63,239.43187230089453,NaN,NaN,NaN,NaN,NaN,243.88139999999996,270.7976098401705,216.96519015982943,245.18739375502665,250.38666666666663,250.38666936406494,250.3866639692683,9496383,5799022.6,52.67057579236986,57.55860925550429,NaN,NaN,NaN,NaN,7.056837672028743,28.40331900884996,1001288403,2.2940231242006126,4.349866313893358,2.0558431896927454
2023-09-01T13:30:00-04:00,246.62,247.07,242.18,244.94,239.43187230089453,NaN,NaN,NaN,NaN,NaN,243.45059999999998,269.58436954363975,217.31683045636018,245.18739375502665,248.52092898727375,251.18041748160434,245.86144049294316,4673725,5853013.766666667,50.78592991477208,57.637123302143735,NaN,NaN,NaN,NaN,6.902063552598117,26.849943904522455,996614678,1.3435696938416917,3.73530530699486,2.3917356131531684
2023-09-05T09:30:00-04:00,244.98,256.91,244.85,255.36,239.43187230089453,NaN,NaN,NaN,NaN,NaN,243.22619999999998,268.74720433447027,217.70519566552971,245.18739375502665,252.37333333333333,252.37333333333333,252.37333333333333,9038510,5920110.2,60.23393307015456,58.77329897453511,NaN,NaN,NaN,NaN,7.270487584555396,26.493951410974287,1005653188,1.3205868134777843,4.0424691300003985,2.7218823165226143
2023-09-05T13:30:00-04:00,255.32,258,255.1,256.5,239.43187230089453,NaN,NaN,NaN,NaN,NaN,243.00639999999996,267.86852694360846,218.14427305639146,245.18739375502665,253.50233667361886,255.35220298046497,251.65247036677275,3366717,5957427.6,61.11350500212955,60.12516196860012,NaN,NaN,NaN,NaN,6.958309899944297,26.26980357514229,1009019905,1.2848915016233002,4.327996693551739,3.043105191928439
2023-09-06T09:30:00-04:00,255.1,255.39,245.06,250.59,239.43187230089453,NaN,NaN,NaN,NaN,NaN,242.79439999999994,267.20945671834784,218.379343281652,245.18739375502665,250.34666666666664,250.3466704813639,250.34666285196937,8654917,6016118.6,54.396206474178506,60.54797960303709,NaN,NaN,NaN,NaN,7.278430621376847,24.660184488961136,1000364988,0.7902564336688167,4.03092573401446,3.240669300345643
2023-09-06T13:30:00-04:00,250.58,252.44,250.16,251.89,239.43187230089453,NaN,NaN,NaN,NaN,NaN,242.61039999999994,266.60622562363994,218.61457437635994,245.18739375502665,250.62964357771162,251.1249692438416,250.13431791158163,2824771,6024537.966666667,55.55347936853369,60.75283565375404,NaN,NaN,NaN,NaN,6.921399862707072,23.165538194650065,1003189759,0.4922206071998749,3.855945059345487,3.363724452145612
2023-09-07T09:30:00-04:00,245,251.19,243.27,250.82,239.43187230089453,NaN,NaN,NaN,NaN,NaN,242.55039999999994,266.4486141458347,218.6521858541652,245.18739375502665,248.42666666666665,248.42666666666665,248.42666666666665,7894292,6029544.833333333,54.33136861826642,60.839265266164624,NaN,NaN,NaN,NaN,7.04272844394228,22.076670669432932,995295467,0.18066317346052108,3.5895534189712635,3.4088902455107424
2023-09-07T13:30:00-04:00,250.88,252.8,250.21,251.48,239.43187230089453,NaN,NaN,NaN,NaN,NaN,242.4963999999999,266.30127740275526,218.69152259724453,245.18739375502665,249.3947429833396,250.82121504310865,247.96827092357054,3635849,6038854.833333333,54.98911981482869,60.98230452754894,NaN,NaN,NaN,NaN,6.7246764122321165,20.85359492003078,998931316,-0.0130441957701537,3.39258500079805,3.4056291965682037
2023-09-08T09:30:00-04:00,251.22,256.51,246.68,247.33,239.43187230089453,NaN,NaN,NaN,NaN,NaN,242.2887999999999,265.7377360577463,218.8398639422535,245.18739375502665,250.17333333333332,250.17333333333332,250.17333333333332,8680544,6060950.666666667,50.10267079790963,59.82856011075834,NaN,NaN,NaN,NaN,6.946485239929821,19.489136113180486,990250772,-0.4296641999228461,2.868548946664646,3.298213146587492
2023-09-08T13:30:00-04:00,247.35,248.88,246.84,248.45,239.43187230089453,NaN,NaN,NaN,NaN,NaN,242.07159999999993,265.0829674030937,219.06023259690616,240.1305644820589,249.60717615958777,250.5441030897092,248.67024922946632,3169637,6034531.866666666,51.35891611805009,58.57201981639505,NaN,NaN,NaN,NaN,6.596022008506261,18.22213864967664,993420409,-0.6268632361168494,2.5146341014414304,3.1414973375582798
2023-09-11T09:30:00-04:00,264.08,272.52,260.62,271.89,244.34367292952925,NaN,NaN,NaN,NaN,NaN,242.31759999999994,266.3146910103731,218.32050898962677,248.47447287646787,268.3433333333333,268.3433333333333,268.3433333333333,13352959,6104213.233333333,68.96785589180877,58.54847555012892,NaN,NaN,NaN,NaN,7.844163293612956,19.296215785553343,1006773368,0.7496430433751451,4.078551141777211,3.3289080984020663
2023-09-11T13:30:00-04:00,271.91,274.85,271.88,273.63,251.74396052364156,NaN,NaN,NaN,NaN,NaN,242.7129999999999,268.07072395149436,217.35527604850543,254.12857830117431,269.69138003487404,271.94333224026025,267.43942782948784,4784858,6140085.966666667,69.84068214946666,58.683549982115665,NaN,NaN,NaN,NaN,7.496008772640605,20.450505745752274,1011558226,1.6538067002846568,5.396166473757887,3.7423597734732303
2023-09-12T09:30:00-04:00,270.75,278.39,268.33,270.55,251.74396052364156,NaN,NaN,NaN,NaN,NaN,243.18959999999993,269.7002200485804,216.67897995141945,256.7828626409394,272.42333333333335,272.42333333333335,272.42333333333335,10466883,6162339.266666667,66.28659648361769,58.527135819253814,NaN,NaN,NaN,NaN,7.679151003166276,21.026517605791824,1001091343,1.9031468996001841,6.12129339797346,4.218146498373276
2023-09-12T13:30:00-04:00,270.59,270.94,266.6,267.37,251.74396052364156,NaN,NaN,NaN,NaN,NaN,243.5087999999999,270.7810342729792,216.23656572702058,256.7828626409394,271.3488214857941,273.1578027187959,269.53984025279226,3692935,6132123.1,62.73680453324089,58.09768885923764,NaN,NaN,NaN,NaN,7.440640217225826,21.32097053959523,997398408,1.7182661933380103,6.365979240045789,4.6477130467077785
2023-09-13T09:30:00-04:00,270.05,274.98,268.11,272.17,251.74396052364156,NaN,NaN,NaN,NaN,NaN,243.96879999999993,272.3603758322812,215.57722416771867,256.7828626409394,271.75333333333333,271.75333333333333,271.75333333333333,8615062,6054528.4,65.72085372223272,59.02985156851356,NaN,NaN,NaN,NaN,7.45273734456684,21.92477988123225,1006013470,1.7762646688805601,6.868043882808479,5.091779213927919
2023-09-13T13:30:00-04:00,272.19,273.69,270,271.28,251.74396052364156,NaN,NaN,NaN,NaN,NaN,244.40179999999992,273.76912570460206,215.0344742953978,256.7828626409394,271.7288562286458,271.7708918260879,271.68682063120366,2921084,6044253.166666667,64.68649084003562,60.02274877746095,NaN,NaN,NaN,NaN,7.183970391383494,22.485459984180913,1003092386,1.6162837606964695,7.112133914798505,5.495850154102036
2023-09-14T09:30:00-04:00,271.39,276.17,270.44,274.71,252.31013771910082,NaN,NaN,NaN,NaN,NaN,244.99259999999992,275.56192104185754,214.42327895814233,259.4324765377288,273.7733333333333,273.7733333333333,273.7733333333333,8598342,6105935.433333334,66.85179328616806,60.49545307860477,NaN,NaN,NaN,NaN,7.080115363427532,23.21747182267742,1011690728,1.600072531378948,7.495940818325721,5.895868286946773
2023-09-14T13:30:00-04:00,274.69,276.7,274.65,276.02,255.35490418641436,NaN,NaN,NaN,NaN,NaN,245.6691999999999,277.43458741209065,213.90381258790916,262.284981230183,274.3228293421445,275.22071821094625,273.4249404733427,3220317,6123833.933333334,67.66721571710025,60.96357527253125,NaN,NaN,NaN,NaN,6.720821408896994,23.943348369885655,1014911045,1.535882834668251,7.815721830282087,6.279838995613836
2023-09-15T09:30:00-04:00,277.65,278.98,271.65,274.59,255.35490418641436,NaN,NaN,NaN,NaN,NaN,246.26499999999993,279.04414733485567,213.48585266514422,263.7829849841464,275.0733333333333,275.0733333333333,275.0733333333333,8757373,6154323.533333333,65.76539542705972,61.77566019773705,NaN,NaN,NaN,NaN,6.764334165404355,24.090397648146443,1006153672,1.2666251075451278,7.863120380045245,6.596495272500118
2023-09-15T13:30:00-04:00,274.58,275.03,271.02,274.45,255.35490418641436,NaN,NaN,NaN,NaN,NaN,246.84659999999994,280.5602014356243,213.13299856437558,263.7829849841464,274.5709675063756,275.3044642527672,273.837470759984,4107879,6198684.033333333,65.57109208622549,62.49120396328646,NaN,NaN,NaN,NaN,6.567596010732615,24.1157482467392,1002045793,0.9623875382633429,7.799479695329296,6.837092157065953
2023-09-18T09:30:00-04:00,270.98,271.41,263.76,267.27,255.35490418641436,NaN,NaN,NaN,NaN,NaN,247.34419999999992,281.51138919431565,213.17701080568418,263.7829849841464,267.48,267.48,267.48,8160074,6199764.3,56.37232047412612,62.636986238705006,NaN,NaN,NaN,NaN,6.862053438537428,22.95756605704078,993885719,0.20070408855209543,7.087972267756072,6.887268179203977
2023-09-18T13:30:00-04:00,267.28,268.43,264.72,265.21,255.35490418641436,NaN,NaN,NaN,NaN,NaN,247.79719999999995,282.29763247033446,213.29676752966543,263.7829849841464,267.12471486712116,267.7221763763885,266.5272533578538,2885548,6168766.7,54.03034356912815,62.56850222115497,NaN,NaN,NaN,NaN,6.636906764356182,21.882111166606528,991000171,-0.4814798782265184,6.2854183314208285,6.766898209647347
2023-09-19T09:30:00-04:00,264.34,267.85,261.2,266.05,255.35490418641436,NaN,NaN,NaN,NaN,NaN,248.34299999999996,283.1166645753661,213.56933542463383,263.7829849841464,265.0333333333333,265.0333333333333,265.0333333333333,7199086,6160381.866666666,54.85397509519829,62.90788109953274,NaN,NaN,NaN,NaN,6.637841995473599,20.347395214918503,998199257,-0.8919052833626973,5.6520166054439755,6.543921888806673
2023-09-19T13:30:00-04:00,266.06,267.5,265.23,266.47,255.35490418641436,NaN,NaN,NaN,NaN,NaN,248.87659999999994,283.9266153746057,213.82658462539416,263.7829849841464,265.4183872362699,266.0331829957262,264.8035914768136,2823961,6176920.8,55.28536116685191,63.18834146016143,NaN,NaN,NaN,NaN,6.325853281511199,18.922301831208195,1001023218,-1.1352530952152913,5.124855519787559,6.26010861500285
2023-09-20T09:30:00-04:00,267.05,273.93,265.32,271.58,255.35490418641436,NaN,NaN,NaN,NaN,NaN,249.62959999999993,284.9792679384707,214.27993206152917,263.7829849841464,270.27666666666664,270.27666666666664,270.27666666666664,7588766,6124676.566666666,60.26070453293473,62.56640207738472,NaN,NaN,NaN,NaN,6.489006618546114,18.5127322266593,1008611984,-0.9592308992712111,5.061069990913836,6.020300890185047
2023-09-20T13:30:00-04:00,271.58,273.55,262.47,262.58,255.35490418641436,NaN,NaN,NaN,NaN,NaN,250.22259999999991,285.4262834004651,215.01891659953475,263.7829849841464,268.5363776827323,270.5528033182486,266.51995204721595,5652616,6209544.233333333,49.75917026986192,61.13200837169867,NaN,NaN,NaN,NaN,6.8169347172213905,17.66541148110529,1002959368,-1.4278640365769029,4.235470844463919,5.6633348810408215
2023-09-21T09:30:00-04:00,257.85,260.85,254.21,259.92,NaN,NaN,NaN,278.16171845143134,278.16171845143134,278.16171845143134,250.84959999999992,285.60219943313825,216.0970005668616,263.7829849841464,258.32666666666665,258.32666666666665,258.32666666666665,8395520,6194643.066666666,47.14417789850782,59.764692758476535,NaN,NaN,NaN,NaN,6.927867951705575,17.092207577882057,994563848,-1.8681297447067067,3.328172700157438,5.196302444864145
2023-09-21T13:30:00-04:00,259.92,260.25,255.22,255.66,NaN,NaN,NaN,278.11482215818444,NaN,NaN,251.4509999999999,285.4672291267006,217.43477087329921,263.7829849841464,257.95439444933663,258.5367712532941,257.3720176453792,3430526,6204058.766666667,43.22624120197108,58.371081091957265,NaN,NaN,NaN,NaN,6.792305955155177,16.55994681060334,991133322,-2.365386258409023,2.2395696218528656,4.604955880261889
2023-09-22T09:30:00-04:00,257.4,257.78,249.64,249.64,NaN,NaN,NaN,274.2734666055397,NaN,NaN,251.96599999999992,285.0648915826523,218.86710841734757,260.8673879873171,252.35333333333332,252.35333333333332,252.35333333333332,8224678,6234758.5,38.3730515752112,56.4176666528843,NaN,NaN,NaN,NaN,6.888569815501235,16.75555918696717,982908644,-2.9792243913908623,0.880925391023311,3.8601497824141733
2023-09-22T13:30:00-04:00,249.68,250.45,244.495,244.73,NaN,NaN,NaN,267.9133090325606,NaN,NaN,252.47679999999988,284.3003830641402,220.65321693585958,258.80912329568406,250.21729452464578,253.01294884950778,247.42164019978378,4801426,6303841.266666667,34.92852370918901,54.29209757210953,NaN,NaN,NaN,NaN,6.821886257251145,17.490287239365806,978107218,-3.5563273536647593,-0.5852594096667758,2.9710679439979835
2023-09-25T09:30:00-04:00,243.36,247.07,238.32,245.24,NaN,NaN,NaN,263.3998631674442,NaN,NaN,253.07699999999988,283.1519605486067,223.00203945139305,258.80912329568406,243.54333333333332,243.54333333333332,243.54333333333332,7259988,6229294.766666667,35.57541066132761,52.058070241763794,NaN,NaN,NaN,NaN,6.959608667447491,18.74751238035231,985367206,-3.726155404415843,-1.6866263115218203,2.0395290928940226
2023-09-25T13:30:00-04:00,245.25,247.1,244.03,247.03,NaN,NaN,NaN,263.3998631674442,NaN,NaN,253.70919999999987,281.8585493608697,225.55985063913005,258.80912329568406,244.14233272582152,245.21223375065574,243.0724317009873,2275629,6149358.233333333,37.908531336913825,49.932449928893334,NaN,NaN,NaN,NaN,6.681779476915527,19.9093687059331,987642835,-3.541629492225645,-2.387507772388034,1.1541217198376112
2023-09-26T09:30:00-04:00,242.95,249.55,241.67,245.06,NaN,NaN,NaN,263.3998631674442,NaN,NaN,254.04759999999987,281.3534562392809,226.74174376071886,258.80912329568406,245.42666666666665,245.42666666666665,245.42666666666665,6694112,6071211.633333334,36.3483739580847,47.831234109680835,NaN,NaN,NaN,NaN,6.767366657135848,20.52253525661484,980948723,-3.3765568602161746,-3.066574355432607,0.3099825047835675
2023-09-26T13:30:00-04:00,245.06,245.43,242.91,244.13,NaN,NaN,NaN,263.3998631674442,NaN,NaN,254.30559999999986,280.98069704875167,227.63050295124802,258.80912329568406,245.07551164971483,245.6435407208092,244.50748257862045,2558289,6044264.033333333,35.60342816294711,45.690686686589515,NaN,NaN,NaN,NaN,6.463983324483288,21.091904196533598,978390434,-3.1582643210288595,-3.6378478965025067,-0.4795835754736474
2023-09-27T09:30:00-04:00,244.36,245.33,234.58,234.98,NaN,NaN,NaN,260.2814352830567,NaN,NaN,254.35919999999987,280.86746100370095,227.85093899629882,255.91329863654727,238.29666666666665,238.29666666666665,238.29666666666665,8562616,6041187.333333333,29.251438979328114,43.753480865532524,NaN,NaN,NaN,NaN,6.770127372734481,22.43760493679216,969827818,-3.435440704021306,-4.77388445550028,-1.338443751478974
2023-09-27T13:30:00-04:00,234.96,242.29,234.75,240.49,NaN,NaN,NaN,258.95068822473587,NaN,NaN,254.50539999999987,280.6225610126431,228.38823898735663,243.09951112739026,238.60883883003575,239.0298614472408,238.1878162128307,4707431,6103942.666666667,36.5881822700875,42.50761220131533,NaN,NaN,NaN,NaN,6.825118274682017,23.68718419560368,974535249,-3.0652403487495485,-5.169994187415909,-2.104753838666361
2023-09-28T09:30:00-04:00,240.02,247.55,238.64,246.07,NaN,NaN,NaN,258.95068822473587,NaN,NaN,254.69339999999985,280.42682343646425,228.95997656353546,243.09951112739026,244.08666666666667,244.08666666666667,244.08666666666667,8266670,6116355.266666667,43.03120987724627,41.66312897146161,NaN,NaN,NaN,NaN,6.974038397919018,23.79942455307593,982801919,-2.297229770799351,-4.97629105216555,-2.6790612813661987
2023-09-28T13:30:00-04:00,246.1,247.14,244.22,246.4,NaN,NaN,NaN,258.95068822473587,NaN,NaN,254.88419999999988,280.2243556711936,229.54404432880617,239.9896089019122,244.60350155744405,245.42837265571237,243.77863045917573,3245354,6103338.766666667,43.39749549121243,40.81399570891593,NaN,NaN,NaN,NaN,6.684464226639087,23.903647742157304,986047273,-1.6499467194258073,-4.741494680648458,-3.0915479612226506
2023-09-29T09:30:00-04:00,250,254.77,248,249.23,NaN,NaN,NaN,258.95068822473587,NaN,NaN,255.22639999999984,279.77748918480864,230.675310815191,237.62245782414658,250.66666666666666,250.66666936406497,250.66666396926834,9768949,6139618.933333334,46.570158400121066,39.8360995565721,NaN,NaN,NaN,NaN,6.80485963902201,22.658781598317816,995816222,-0.9489602680995244,-4.277748296347056,-3.3287880282475317
2023-09-29T13:30:00-04:00,249.22,251.15,246.36,250.3,NaN,NaN,NaN,258.95068822473587,NaN,NaN,255.63139999999984,279.1544385826406,232.1083614173591,237.62245782414658,250.23786483657176,250.88208701347637,249.59364265966715,4328025,6178231.866666666,47.76237115619488,39.69347104845303,NaN,NaN,NaN,NaN,6.660941093377581,21.726933799468537,1000144247,-0.3612166501074725,-3.7803088408818724,-3.4190921907744
2023-10-02T09:30:00-04:00,244.88,254.28,242.62,250.32,NaN,NaN,NaN,258.95068822473587,NaN,NaN,255.93959999999984,278.7619609506195,233.11723904938023,237.62245782414658,249.07333333333338,249.07333333333338,249.07333333333338,9394352,6046278.3,47.785823659751486,39.739302888541864,NaN,NaN,NaN,NaN,7.018016729564896,21.353065349705126,1009538599,0.058552800977173636,-3.345901189552933,-3.4044539905301066
2023-10-02T13:30:00-04:00,250.32,251.74,247.88,251.61,NaN,NaN,NaN,258.95068822473587,NaN,NaN,256.19979999999987,278.5165210817429,233.88307891825684,237.62245782414658,249.4064853601604,249.98469201545046,248.8282787048703,3118786,5990742.566666666,49.36489541179386,40.1777781892435,NaN,NaN,NaN,NaN,6.792444106024547,21.005901789210533,1012657385,0.43194926955362023,-2.8645174035880814,-3.2964666731417016
2023-10-03T09:30:00-04:00,248.63,250.02,244.46,247.84,NaN,NaN,NaN,258.95068822473587,NaN,NaN,256.37679999999983,278.2813074594324,234.47229254056725,237.62245782414658,247.44000000000003,247.44000000000003,247.44000000000003,8829061,5936148.5,45.074650145406316,40.656463801400285,NaN,NaN,NaN,NaN,6.81798381273708,21.12906761768267,1003828324,0.4328041125196651,-2.75546153249212,-3.188265645011785
2023-10-03T13:30:00-04:00,247.83,248.36,245.19,246.61,NaN,NaN,NaN,258.95068822473587,NaN,NaN,256.5311999999998,278.0458523615986,235.016547638401,237.62245782414658,247.24103482344358,247.56300964489145,246.91906000199572,3371513,5925434.433333334,43.73903438481484,41.285785992516416,NaN,NaN,NaN,NaN,6.557413540398719,21.243435886978222,1000456811,0.36122268758009834,-2.7367372855366625,-3.097959973116761
2023-10-04T09:30:00-04:00,248.2,258.45,247.6,257.14,NaN,NaN,NaN,258.95068822473587,NaN,NaN,256.60839999999985,278.1035262792372,235.1132737207625,240.31795310385309,254.39666666666665,254.39666666666665,254.39666666666665,11648817,6026559.6,55.810853670451884,42.73117477888244,NaN,NaN,NaN,NaN,6.934741144655952,19.886885445568474,1012105628,0.9976644567419064,-1.8508794021893777,-2.848543858931284
2023-10-04T13:30:00-04:00,257.15,261.85,256.41,261.33,238.68542812371925,238.68542812371925,238.68542812371925,NaN,NaN,NaN,256.6871999999998,278.2220606830986,235.15233931690094,244.62436248308248,255.89449536967237,258.33265849373674,253.456332245608,4396232,6075731.2,59.531771444683464,44.27569192943741,NaN,NaN,NaN,NaN,6.82797392003767,19.107493286498407,1016501860,1.6376402503604974,-0.8014935459806622,-2.4391337963411597
2023-10-05T09:30:00-04:00,260,263.6,256.25,259.49,239.40745411809567,NaN,NaN,NaN,NaN,NaN,256.7183999999998,278.2648897781638,235.17191022183582,246.144489986466,259.78000000000003,259.78000000000003,259.78000000000003,9884890,6118616.133333334,57.25188743086244,45.768800034635824,NaN,NaN,NaN,NaN,6.865261497177839,18.62256456757276,1006616970,1.857729487220166,-0.11697193731595235,-1.9747014245361183
2023-10-05T13:30:00-04:00,259.47,262.39,259.01,260.01,240.65416074909132,NaN,NaN,NaN,NaN,NaN,256.7777999999998,278.34387531843663,235.21172468156297,246.73559198917275,259.98603498701567,260.30180978834454,259.6702601856868,4208224,6151546.366666666,57.74440123986728,47.35029811155869,NaN,NaN,NaN,NaN,6.616314247379421,18.172273614284656,1010825194,1.9494800687095992,0.46214866135088073,-1.4873314073587185
2023-10-06T09:30:00-04:00,253.96,260.28,250.66,259.79,240.65416074909132,NaN,NaN,NaN,NaN,NaN,256.8185999999998,278.3995916398779,235.23760836012167,246.73559198917275,256.91,256.91,256.91,11274504,6235450.733333333,57.4428635734149,49.36397129685061,NaN,NaN,NaN,NaN,6.83086322970946,17.34948582353164,999550690,1.90431241961265,0.8930591171570939,-1.0112533024555561
2023-10-06T13:30:00-04:00,259.79,261.65,258.76,260.51,240.65416074909132,NaN,NaN,NaN,NaN,NaN,256.8667999999998,278.4697781058194,235.26382189418018,246.73559198917275,257.8488492835969,259.3679016491549,256.32979691803894,4306691,6242077.8,58.21195546902273,50.908526525345984,NaN,NaN,NaN,NaN,6.549372999015927,16.364694213307835,1003857381,1.831343129714229,1.2779256096872302,-0.5534175200269988
2023-10-09T09:30:00-04:00,255.31,256.61,252.05,255.78,240.65416074909132,NaN,NaN,NaN,NaN,NaN,257.0497999999998,278.4569444111644,235.64265558883514,246.73559198917275,254.81333333333336,254.81333333333336,254.81333333333336,7971427,6235789.566666666,51.61295863351211,51.52150857936497,NaN,NaN,NaN,NaN,6.6858463562290735,16.363583112703388,995885954,1.3927932114797514,1.1875739943226904,-0.20521921715706098
2023-10-09T13:30:00-04:00,255.81,261.35,255.8,259.66,240.65416074909132,NaN,NaN,NaN,NaN,NaN,257.3442,278.4802454541535,236.20815454584653,246.73559198917275,256.39021549835064,258.3940751320128,254.38635586468848,4936282,6304147.366666666,56.01750201066156,52.422937616468474,NaN,NaN,NaN,NaN,6.606143045069856,15.60107986237147,1000822236,1.294389577269154,1.4127677544293817,0.11837817716022758
2023-10-10T09:30:00-04:00,257.8,268.94,257.66,264.37,242.66808092419572,NaN,NaN,NaN,NaN,NaN,257.5244,278.7431774049309,236.30562259506914,250.52514758301214,263.6566666666667,263.6566666666667,263.6566666666667,11020084,6431513.966666667,60.6948063454035,53.43184104113151,NaN,NaN,NaN,NaN,6.9399899704220065,15.110438927782516,1011842320,1.464360010559787,1.9488281903599614,0.4844681798001743
2023-10-10T13:30:00-04:00,264.39,265.58,262.8,263.61,244.11680451855045,NaN,NaN,NaN,NaN,NaN,257.6666,278.95120574593864,236.3819942540614,250.52514758301214,263.73763650420716,263.8824592585545,263.59281374985983,3444751,6452206.966666667,59.5935401925519,54.27692454372844,NaN,NaN,NaN,NaN,6.642847829677576,14.654843774235626,1008397569,1.44121178535828,2.2859829114980244,0.8447711261397444
2023-10-11T09:30:00-04:00,266.2,268.6,261.04,261.97,244.62831340407095,NaN,NaN,NaN,NaN,NaN,257.8942,279.11453254781895,236.6738674521811,251.9224944531278,263.87000000000006,263.87000000000006,263.87000000000006,8464930,6481412.433333334,57.18242334852014,54.948110235783346,NaN,NaN,NaN,NaN,6.708358698986321,14.617947147625463,999932639,1.238789637214213,2.393258172657511,1.1544685354432977
2023-10-11T13:30:00-04:00,261.96,264.13,260.9,262.96,244.62831340407095,NaN,NaN,NaN,NaN,NaN,258.11560000000003,279.3117174407002,236.91948255929987,251.9224944531278,263.55034435994946,264.0828272962612,263.0178614236377,3050540,6394676.566666666,58.27976495902238,55.584886632013955,NaN,NaN,NaN,NaN,6.4599045062015845,14.559647928140041,1002983179,1.0996303744510914,2.529006503507162,1.4293761290560707
2023-10-12T09:30:00-04:00,262.85,265.4,259.641,259.74,244.62831340407095,NaN,NaN,NaN,NaN,NaN,258.29400000000004,279.3914197474466,237.19658025255347,251.9224944531278,261.59366666666665,261.59366666666665,261.59366666666665,9005231,6415000.266666667,53.47902071037806,56.18519881522622,NaN,NaN,NaN,NaN,6.409839898615753,14.677895841059271,993977948,0.7362393764147068,2.3496753495744542,1.6134359731597474
2023-10-12T13:30:00-04:00,259.74,260.38,256.64,258.91,244.62831340407095,NaN,NaN,NaN,NaN,NaN,258.4426000000001,279.4504247555491,237.4347752444511,251.9224944531278,260.61457738140683,262.00383039151404,259.2253243712996,4472772,6449741.8,52.28348592051262,56.79551678206178,NaN,NaN,NaN,NaN,6.219137048714629,14.235600367953975,989505176,0.4022000054513384,2.1161859799739204,1.713985974522582
2023-10-13T09:30:00-04:00,258.89,259.6,251.53,251.55,244.62831340407095,NaN,NaN,NaN,NaN,NaN,258.5270000000001,279.38896663787494,237.66503336212523,251.9224944531278,254.2266666666667,254.2266666666667,254.2266666666667,8259136,6450890.4,43.08547251774266,55.886560985439694,NaN,NaN,NaN,NaN,6.351341545235014,13.454986173949363,981246040,-0.3135774783968339,1.3220141265265397,1.6355916049233736
2023-10-13T13:30:00-04:00,251.52,252.49,250.22,251.14,244.62831340407095,NaN,NaN,NaN,NaN,NaN,258.58080000000007,279.3522183781441,237.80938162185603,251.9224944531278,253.30009588725537,254.6670901269931,251.93310164751765,3794534,6417327.333333333,42.63549425981463,54.67968404366336,NaN,NaN,NaN,NaN,6.0598171491468,12.931364916969038,977451506,-0.7868513073992718,0.6520274706742839,1.4388787780735557
2023-10-16T09:30:00-04:00,250.03,254.17,248.47,251.93,244.62831340407095,NaN,NaN,NaN,NaN,NaN,258.18160000000006,278.6799473909454,237.68325260905473,251.9224944531278,251.5233333333333,251.5233333333333,251.5233333333333,6618842,6395955.8,43.85229810431737,53.72257052033871,NaN,NaN,NaN,NaN,6.034115924207741,12.714906498849837,984070348,-1.0049441575822562,0.18269858109573534,1.1876427386779915
2023-10-16T13:30:00-04:00,251.96,255.39,251.71,253.87,244.62831340407095,NaN,NaN,NaN,NaN,NaN,257.7864,277.8351520848559,237.73764791514412,251.9224944531278,252.2020501967568,253.1956661829085,251.2084342106051,3088319,6423045.466666667,46.834691815620644,52.943305561463944,NaN,NaN,NaN,NaN,5.86596478676433,12.283759274340177,987158667,-0.9759809419255798,-0.03233343872898331,0.9436475031965965
2023-10-17T09:30:00-04:00,250.09,257.18,247.08,254.41,244.62831340407095,NaN,NaN,NaN,NaN,NaN,257.46360000000004,277.19719845948,237.73000154052008,251.9224944531278,252.89,252.89,252.89,8107408,6470155.333333333,47.667945962871144,52.24509716071082,NaN,NaN,NaN,NaN,6.16839587342402,12.596665157320015,995266075,-0.8808063414535885,-0.15736042362038916,0.7234459178331993
2023-10-17T13:30:00-04:00,254.425,256.2,253.67,254.92,244.62831340407095,NaN,NaN,NaN,NaN,NaN,257.2146,276.75516179745335,237.6740382025467,251.9224944531278,253.46683370983428,254.38553041673555,252.548137002933,3196237,6491420.266666667,48.48907162490496,51.55060545755955,NaN,NaN,NaN,NaN,5.908510453893733,12.887220620087003,998462312,-0.7490279316259117,-0.21283899669919037,0.5361889349267214
2023-10-18T09:30:00-04:00,252.77,254.6,243.02,245.23,NaN,NaN,NaN,268.0563289001552,268.0563289001552,268.0563289001552,256.67580000000004,276.02185038347676,237.3297496165233,250.55489645000176,247.61666666666667,247.61666666666667,247.61666666666667,9009045,6506301.233333333,36.70479495053517,50.4857366230612,NaN,NaN,NaN,NaN,6.336473992901323,14.478861242030597,989453267,-1.2504479899955934,-1.0268710525677704,0.22357693742782297
2023-10-18T13:30:00-04:00,245.22,245.26,242.08,242.5,NaN,NaN,NaN,262.47513213196635,NaN,NaN,256.10020000000003,275.3864141396385,236.81398586036158,250.55489645000176,246.30270556855768,248.29562240779754,244.30978872931783,3916205,6479927.033333333,34.18417311678158,48.9262131306412,NaN,NaN,NaN,NaN,6.111011564836941,16.052535833015842,985537062,-1.675438349041702,-1.8707209988743045,-0.19528264983260252
2023-10-19T09:30:00-04:00,225.85,230.62,218.67,221.255,NaN,NaN,NaN,245.84489885324058,NaN,NaN,255.03110000000004,275.931224907761,234.13097509223908,246.63391716000143,223.515,223.515,223.515,16141817,6742431.933333334,21.69701424055806,46.14065655172367,NaN,NaN,NaN,NaN,7.3766535959200175,19.131279388034116,969395245,-3.208010739036891,-4.205296073628716,-0.9972853345918253
2023-10-19T13:30:00-04:00,221.28,221.41,216.78,220.11,NaN,NaN,NaN,239.96263072354785,NaN,NaN,253.91290000000004,276.14192787708,231.68387212292006,244.56813372800116,222.363116186402,224.20017074351233,220.5260616292917,6346374,6845799.266666667,21.24654990694944,43.40158581703778,NaN,NaN,NaN,NaN,7.180464053354301,22.077864413484566,963048871,-4.064407363338794,-6.077794538765318,-2.013387175426524
2023-10-20T09:30:00-04:00,217.01,218.86,210.42,215.36,NaN,NaN,NaN,235.8804656906593,NaN,NaN,252.72830000000005,276.67029787904016,228.78630212095993,242.8676620599914,214.88,214.8800026973983,214.87999730260168,12446329,6935045.266666667,19.44312025851829,40.70592131060908,NaN,NaN,NaN,NaN,7.359716620971853,25.092104887923668,950602542,-4.672895462767922,-7.854506503886427,-3.1816110411185043
2023-10-20T13:30:00-04:00,215.38,215.7,211.34,211.94,NaN,NaN,NaN,234.38953543199295,NaN,NaN,251.47810000000004,277.2135913603759,225.74260863962417,242.8676620599914,214.37588374672924,215.21072872297393,213.54103877048456,4538277,6942053.666666667,18.2424827378388,37.84611543766739,NaN,NaN,NaN,NaN,7.145451148045291,27.8910424713314,946064265,-4.998573383075299,-9.429827769962628,-4.431254386887329
2023-10-23T09:30:00-04:00,209.97,216.9,202.51,213.61,NaN,NaN,NaN,231.58819291235693,NaN,NaN,250.40490000000003,277.8362177583577,222.97358224164236,242.8676620599914,211.00666666666666,211.00666666666666,211.00666666666666,12526678,7046464.533333333,20.813885068668625,35.51289146325957,NaN,NaN,NaN,NaN,7.662918923184914,30.838696245404932,958590943,-4.793694118633723,-10.423372035179483,-5.62967791654576
2023-10-23T13:30:00-04:00,213.6,215.41,211.42,212.03,NaN,NaN,NaN,231.58819291235693,NaN,NaN,249.34130000000002,278.46564670924045,220.2169532907596,242.8676620599914,211.4625501664807,212.28694294153536,210.63815739142603,3830675,7070194.166666667,20.167603266902717,33.218899845144584,NaN,NaN,NaN,NaN,7.400567571528849,33.575803321330355,954760268,-4.463493607827592,-11.20904492633025,-6.745551318502658
2023-10-24T09:30:00-04:00,216.54,222.05,214.11,217.68,NaN,NaN,NaN,231.58819291235693,NaN,NaN,248.3739,278.4129529338071,218.33484706619288,242.8676620599914,217.9466666666667,217.9466666666667,217.9466666666667,10461284,7124601.6,28.69409394959152,32.19094423313379,NaN,NaN,NaN,NaN,7.587669887848217,34.83090401543708,965221552,-3.600478909877215,-11.246149955849177,-7.6456710459719615
2023-10-24T13:30:00-04:00,217.7,218.32,215.68,216.55,NaN,NaN,NaN,231.58819291235693,NaN,NaN,247.37550000000002,278.24912681966634,216.5018731803337,237.98412964799314,217.6783935421087,218.1498123833902,217.20697470082717,3387860,7125146.5,28.04885442663347,31.149041387906568,NaN,NaN,NaN,NaN,7.234264895859058,35.996354659964744,961833692,-2.873224799227822,-11.23720204500674,-8.363977245778917
2023-10-25T09:30:00-04:00,215.91,220.09,214.12,214.48,NaN,NaN,NaN,231.58819291235693,NaN,NaN,246.23350000000002,277.66063262453355,214.80636737546652,230.37730371839453,216.23000000000002,216.23000000000002,216.23000000000002,8070912,7005883,26.857422162689573,29.935121677790296,NaN,NaN,NaN,NaN,7.143960260440553,36.73450560353398,953762780,-2.3226266002672524,-11.267260496112982,-8.94463389584573
2023-10-25T13:30:00-04:00,214.46,215.77,212.2,212.35,NaN,NaN,NaN,231.58819291235693,NaN,NaN,245.22889999999998,277.69578252912675,212.76201747087322,206.79884297471563,215.444893983754,216.69950720247382,214.1902807650342,3160527,6964692.833333333,25.65006267266503,28.42193388186489,NaN,NaN,NaN,NaN,6.888677384694801,37.55752305431704,950602253,-1.9101514957574377,-11.332323265542527,-9.42217176978509
2023-10-26T09:30:00-04:00,211.4,214.8,204.88,205.86,NaN,NaN,NaN,230.8313500307563,NaN,NaN,244.14770000000001,278.14989164759845,210.14550835240158,202.40764026416886,208.51333333333332,208.51333333333332,208.51333333333332,8820998,6929229.766666667,22.352797106788998,26.613708963573313,NaN,NaN,NaN,NaN,7.1052004286451735,38.796445277353605,941781255,-1.8797632901238028,-11.771875882439844,-9.89211259231604
2023-10-26T13:30:00-04:00,205.835,209.57,205.23,205.59,NaN,NaN,NaN,228.0290159384492,NaN,NaN,243.1463,278.6494108952452,207.64318910475478,202.40764026416886,207.99947938052847,208.78565370438793,207.21330505666901,3768421,6914569.666666667,22.224797961714145,24.73768941620254,NaN,NaN,NaN,NaN,6.907686112313376,39.94687305588756,938012834,-1.689222520684801,-12.003640743172042,-10.314418222487241
2023-10-27T09:30:00-04:00,210.6,212.41,206.66,208.09,NaN,NaN,NaN,228.0290159384492,NaN,NaN,242.31530000000004,279.0937002050114,205.5368997949887,202.40764026416886,209.0533333333333,209.0533333333333,209.0533333333333,7926930,6802983.866666666,26.42588031632151,24.00348122804442,NaN,NaN,NaN,NaN,6.901422818576706,40.410632254843286,945939764,-1.2276646803168827,-11.848999072883345,-10.621334392566462
2023-10-27T13:30:00-04:00,208.09,208.37,205.77,207.3,NaN,NaN,NaN,227.10854551416548,NaN,NaN,241.56670000000005,279.6196676955684,203.51373230443167,202.40764026416886,208.44925196959764,209.3363074955762,207.5621964436191,3676159,6781966.133333334,25.948888882695144,23.41524663989539,NaN,NaN,NaN,NaN,6.594178331535512,40.91052872670145,942263605,-0.827596232866771,-11.655829683649927,-10.828233450783156
2023-10-30T09:30:00-04:00,209.25,210.87,194.67,196.6,NaN,NaN,NaN,224.10679344533978,NaN,NaN,240.59390000000008,280.6554010847066,200.5323989152935,202.40764026416886,200.7133333333333,200.71333603073163,200.713330635935,11818149,6910190.2,20.540839242781118,23.332662711482747,NaN,NaN,NaN,NaN,7.280308450711549,42.109494167438704,930445456,-1.1175871839599978,-12.225217430733153,-11.107630246773155
2023-10-30T13:30:00-04:00,196.61,198.88,195.57,197.39,NaN,NaN,NaN,218.04330283418798,NaN,NaN,239.6011000000001,281.3981519194824,197.80404808051776,202.40764026416886,199.7796950451318,201.30737662286916,198.25201346739445,4414089,6892783.766666667,21.83609680966356,23.37477320453375,NaN,NaN,NaN,NaN,6.9967149899464385,43.22281921955187,934859545,-1.089080028022602,-12.468980281801407,-11.379900253778805
2023-10-31T09:30:00-04:00,196.04,201.16,194.07,199.74,NaN,NaN,NaN,218.04330283418798,NaN,NaN,238.6947000000001,281.9201082877179,195.4692917122823,202.40764026416886,198.32333333333335,198.32333333333335,198.32333333333335,9753682,6850570.366666666,25.71525300760524,23.82278268661139,NaN,NaN,NaN,NaN,7.003378204950264,43.75512481828366,944613227,-0.7604010319145296,-12.330401543671968,-11.570000511757438
2023-10-31T13:30:00-04:00,199.74,202.8,199.45,200.92,NaN,NaN,NaN,218.04330283418798,NaN,NaN,237.83050000000006,282.2966600883182,193.3643399116819,202.40764026416886,199.09782500988052,200.32953380617062,197.86611621359043,3856435,6864293.166666667,27.656711474223087,24.495227596353125,NaN,NaN,NaN,NaN,6.742422618882389,43.89060517577942,948469662,-0.33374359667626763,-11.987180007602774,-11.653436410926506
2023-11-01T09:30:00-04:00,204.03,204.75,197.85,201.09,NaN,NaN,NaN,218.04330283418798,NaN,NaN,237.15270000000007,282.78975578627893,191.51564421372123,199.83911221133508,201.23000000000002,201.23000000000002,201.23000000000002,8958481,6880744.866666666,27.948871530992434,25.004869486519112,NaN,NaN,NaN,NaN,6.753678146105075,43.59046521584638,957428143,0.06826356698821101,-11.568106952191243,-11.636370519179454
2023-11-01T13:30:00-04:00,201.08,205.99,199.86,205.68,NaN,NaN,NaN,218.04330283418798,NaN,NaN,236.4565000000001,282.9231928562801,189.9898071437201,197.09528976906807,202.2603416627224,203.53745648527195,200.98322684017285,5830919,6973424.166666667,35.5205531521445,26.101508764036385,NaN,NaN,NaN,NaN,6.70912970709757,43.03964433640857,963259062,0.7156650257773229,-10.7417892369578,-11.457454262735123
2023-11-02T09:30:00-04:00,212.94,218.11,211.44,216.93,193.726908565957,193.726908565957,193.726908565957,NaN,NaN,NaN,235.8737000000001,282.57385104086745,189.17354895913275,199.22267711896478,215.49333333333334,215.49333333333334,215.49333333333334,11065126,7042087.333333333,49.5221337800265,27.589225894781737,NaN,NaN,NaN,NaN,7.117763299447744,40.36339029890249,974324188,1.9063315160908338,-9.074539867621581,-10.980871383712415
2023-11-02T13:30:00-04:00,216.95,219.2,216.62,218.54,197.46682181295893,NaN,NaN,NaN,NaN,NaN,235.31650000000008,282.16556138867577,188.46743861132435,202.8001416951718,216.16931875237393,217.3176358168667,215.02100168788115,3834488,7020811.2,51.15675928470548,29.239790527501164,NaN,NaN,NaN,NaN,6.79363734948719,37.71884273051461,978158676,2.7555421041272687,-7.536443753553328,-10.291985857680597
2023-11-03T09:30:00-04:00,221.15,226.36,218.5,219.34,201.844239003279,NaN,NaN,NaN,NaN,NaN,234.7187000000001,281.60513875621024,187.83226124378996,209.31011335613746,221.40000000000003,221.40000000000003,221.40000000000003,10680943,7101538.1,51.98873231851375,31.034884110060037,NaN,NaN,NaN,NaN,6.869806110238106,35.746561279907596,988839619,3.288244979901217,-6.181679632804077,-9.469924612705293
2023-11-03T13:30:00-04:00,219.33,220.82,218.4,219.92,201.844239003279,NaN,NaN,NaN,NaN,NaN,234.1111000000001,280.96149377806603,187.26070622193419,209.31011335613746,221.01259367701434,221.72205944244885,220.30312791157982,3184785,7081213.133333334,52.61886632284871,32.9612272279303,NaN,NaN,NaN,NaN,6.551962816649669,33.89979481666687,992024404,3.573107326911856,-5.003540454065472,-8.576647780977328
2023-11-06T09:30:00-05:00,223.96,226.31,215,215.81,201.844239003279,NaN,NaN,NaN,NaN,NaN,233.4209000000001,280.31258411093665,186.52921588906358,209.31011335613746,219.04,219.04,219.04,8562484,7146001.2,47.828436934741916,34.780915787069794,NaN,NaN,NaN,NaN,6.891822615460407,32.85128348515281,983461920,3.3802463993514404,-4.3513397817880275,-7.731586181139468
2023-11-06T13:30:00-05:00,215.82,219.76,215.01,219.32,201.844239003279,NaN,NaN,NaN,NaN,NaN,232.77510000000012,279.53620745010033,186.0139925498999,209.31011335613746,218.75754797293197,219.21086618318142,218.30422976268252,3324167,7153862.8,51.859276792270265,36.89766427496666,NaN,NaN,NaN,NaN,6.738835285784664,31.877665820175473,986786087,3.376654199830879,-3.5107684313508685,-6.887422631181748
2023-11-07T09:30:00-05:00,219.98,220.95,215.73,219.25,201.844239003279,NaN,NaN,NaN,NaN,NaN,232.20330000000013,278.91273714539733,185.49386285460292,209.31011335613746,218.64333333333332,218.64333333333332,218.64333333333332,7867246,7145857.4,51.77336679393733,38.70819902336779,NaN,NaN,NaN,NaN,6.630347051085759,31.119951437177246,978918841,3.2557169669202706,-2.8177764225314093,-6.07349338945168
2023-11-07T13:30:00-05:00,219.25,223.11,219.21,222.2,201.844239003279,NaN,NaN,NaN,NaN,NaN,231.71510000000012,278.3221724457124,185.10802755428784,209.31011335613746,219.6403932080543,221.00449964849173,218.27628676761685,4203090,7179419.166666667,55.14569652256665,40.79368528335861,NaN,NaN,NaN,NaN,6.435322261722491,30.682025514246813,983121931,3.2528787772181964,-2.0073949179289343,-5.260273695147131
2023-11-08T09:30:00-05:00,223.15,224.14,217.64,219.98,201.844239003279,NaN,NaN,NaN,NaN,NaN,230.97190000000012,277.11637723790847,184.82742276209177,209.31011335613746,220.58666666666667,220.58666666666667,220.58666666666667,9025513,7179968.1,52.18815614854718,43.05420791948476,NaN,NaN,NaN,NaN,6.439942100170884,29.95701425494797,974096418,2.9868602717743418,-1.526698355429204,-4.513558627203546
2023-11-08T13:30:00-05:00,219.99,222.95,219.89,222.11,202.17914656506622,NaN,NaN,NaN,NaN,NaN,230.1875000000001,275.56816955213276,184.80683044786747,209.51703497250503,220.89916798388444,221.38356038064768,220.4147755871212,3756479,7174643.9,54.69855333189115,45.40152624250101,NaN,NaN,NaN,NaN,6.198517664444393,29.283789514170472,977852897,2.8406297515713574,-0.9627714377393488,-3.8034011893107063
2023-11-09T09:30:00-05:00,219.75,220.8,207.02,209.13,202.17914656506622,NaN,NaN,NaN,NaN,NaN,229.1803000000001,274.1483987550048,184.21220124499538,209.51703497250503,212.3166666666667,212.3166666666667,212.3166666666667,11603660,7023372,40.680853045760614,46.47049767379782,NaN,NaN,NaN,NaN,6.8336235455555085,27.905326381143276,966249237,1.8063863952528902,-1.5454181952445936,-3.351804590497484
2023-11-09T13:30:00-05:00,209.09,210.54,206.68,209.95,202.17914656506622,NaN,NaN,NaN,NaN,NaN,228.17910000000012,272.5825573289044,183.77564267109585,209.51703497250503,211.34154417259649,212.83420470072645,209.84888364446653,4952121,6976896.9,41.69736607200018,47.473401573639045,NaN,NaN,NaN,NaN,6.621221863730114,26.671307734912137,971201358,1.1463371833636673,-1.9188831112928995,-3.0652202946565668
2023-11-10T09:30:00-05:00,210.03,213.68,205.68,213.23,202.17914656506622,NaN,NaN,NaN,NaN,NaN,227.24790000000013,270.907224506453,183.58857549354727,209.51703497250503,210.86333333333334,210.86333333333334,210.86333333333334,10106054,6898887.733333333,45.705296651952814,48.741717653707646,NaN,NaN,NaN,NaN,6.719706016320821,25.00069195161067,981307412,0.9098052008946502,-1.9279637935382539,-2.837768994432904
2023-11-10T13:30:00-05:00,213.23,215.37,213.22,214.7,202.17914656506622,NaN,NaN,NaN,NaN,NaN,226.33170000000013,269.07354748510267,183.5898525148976,209.51703497250503,211.87626891765765,213.48461125873322,210.26792657658208,4008559,6881230.466666667,47.448877876554334,49.59374084830835,NaN,NaN,NaN,NaN,6.3932984437264775,23.25387865581228,985315971,0.8335414087081499,-1.7958422335477167,-2.6293836422558665
2023-11-13T09:30:00-05:00,215.59,225.4,211.62,222.12,202.17914656506622,NaN,NaN,NaN,NaN,NaN,225.6585000000001,267.57622437764064,183.74077562235956,209.51703497250503,219.71333333333334,219.71333603073165,219.71333063593502,11764895,6855837.7,55.25905871678884,50.00352120093423,NaN,NaN,NaN,NaN,6.9209199834603,22.992371926231453,997080866,1.239543777522857,-1.0799539203522954,-2.3194976978751525
2023-11-13T13:30:00-05:00,222.13,224.98,221.78,223.65,203.31161163451156,NaN,NaN,NaN,NaN,NaN,224.93830000000014,265.71642441051904,184.16017558948127,209.51703497250503,220.6868410927291,222.33287474726524,219.04080743819299,4115186,6865321.4,56.68846243129976,50.39864285426239,NaN,NaN,NaN,NaN,6.655139984641707,22.749544248763545,1001196052,1.5478267070556648,-0.38471431405557155,-1.9325410211112364
2023-11-14T09:30:00-05:00,235.03,236.36,230.72,236.091,212.65062928748833,NaN,NaN,NaN,NaN,NaN,224.37272000000007,263.70639269511287,185.0390473048873,216.6992041726659,234.39033333333333,234.39033603073165,234.39033063593502,12055221,6918452.633333334,66.15673219017418,51.410642845095275,NaN,NaN,NaN,NaN,7.087629985738729,23.680123233774033,1013251273,2.4714870043632136,1.1568177343427806,-1.314669270020433
2023-11-14T13:30:00-05:00,236.11,238.13,234.06,237.41,215.60014613805703,NaN,NaN,NaN,NaN,NaN,223.8487200000001,261.7495382751538,185.9479017248464,220.36636333813271,235.08461739042727,236.0875233593111,234.08171142154345,5777356,6998102.5,66.9808829547539,52.43650117594565,NaN,NaN,NaN,NaN,6.8720849867573905,24.69385133874956,1019028629,3.017021039096677,2.4566070288504136,-0.5604140102462636
2023-11-15T09:30:00-05:00,239.31,246.7,236.45,242.3,220.6140031317817,NaN,NaN,NaN,NaN,NaN,223.4553200000001,260.15450788297915,186.75613211702108,227.36409067050616,241.81666666666666,241.81667048136393,241.8166628519694,13466481,7177954.8,69.9067354347598,54.0135224973755,NaN,NaN,NaN,NaN,7.113364630560434,26.280181450420535,1032495110,3.517971538682924,3.8370504131073915,0.3190788744244676
2023-11-15T13:30:00-05:00,242.32,244.46,242.17,242.95,222.99450298942799,NaN,NaN,NaN,NaN,NaN,223.0551200000001,258.435108349662,187.67513165033822,227.84627253640494,242.14724578935994,242.73530590750448,241.5591856712154,4255607,7214457.466666667,70.28367459268257,55.32955091169067,NaN,NaN,NaN,NaN,6.768838585520404,27.753202268400727,1036750717,3.6861122258597065,4.926719156749101,1.2406069308893946
2023-11-16T09:30:00-05:00,239.48,240.88,233.53,233.74,222.99450298942799,NaN,NaN,NaN,NaN,NaN,222.5351200000001,256.47820287151035,188.5920371284898,227.84627253640494,236.04999999999998,236.04999999999998,236.04999999999998,10553119,7272194.833333333,59.00579233554402,55.84615273609114,NaN,NaN,NaN,NaN,6.958207257983232,27.596788089471776,1026197598,2.9991963969258597,4.989602427046719,1.9904060301208597
2023-11-16T13:30:00-05:00,233.76,234.5,230.96,233.46,222.99450298942799,NaN,NaN,NaN,NaN,NaN,222.02612000000008,254.50371596186733,189.54852403813283,227.84627253640494,235.1020441177364,236.52258060431643,233.68150763115636,4699507,7303231.033333333,58.69742015264027,56.09984728109641,NaN,NaN,NaN,NaN,6.714049596698715,27.0527666746576,1021498091,2.3754129343467576,4.959672198054307,2.584259263707549
2023-11-17T09:30:00-05:00,231.99,237.08,226.55,236.52,222.99450298942799,NaN,NaN,NaN,NaN,NaN,221.72552000000007,253.37209711978156,190.0789428802186,227.84627253640494,233.38333333333333,233.38333333333333,233.38333333333333,11563243,7424441.466666667,61.090640615749614,56.73573902875372,NaN,NaN,NaN,NaN,6.986617482648806,25.896909437326926,1033061334,2.0316363263602986,5.123804671657922,3.0921683452976234
2023-11-17T13:30:00-05:00,236.53,237.38,233.45,234.46,222.99450298942799,NaN,NaN,NaN,NaN,NaN,221.39192000000006,252.12979753463637,190.65404246536374,227.84627253640494,233.87778107154386,234.65410267091565,233.10145947217208,4690694,7458259.3,58.627782062558026,57.01639822380137,NaN,NaN,NaN,NaN,6.768287662459606,24.85882983538805,1028370640,1.5500069791608544,5.029677069248692,3.4796700900878372
2023-11-20T09:30:00-05:00,234.085,236.16,231.01,233.87,222.99450298942799,NaN,NaN,NaN,NaN,NaN,221.0307200000001,250.7316544231164,191.32978557688378,227.84627253640494,233.67999999999998,233.67999999999998,233.67999999999998,8333613,7342108.1,57.90771868796257,58.24688862681579,NaN,NaN,NaN,NaN,6.652695686569635,23.527300205018932,1020037027,1.0975011982813152,4.851546587939481,3.754045389658166
2023-11-20T13:30:00-05:00,233.86,237.1,233.37,235.71,222.99450298942799,NaN,NaN,NaN,NaN,NaN,220.6675200000001,249.17335948383587,192.16168051616435,227.84627253640494,234.19065553745048,234.97433536762702,233.40697570727394,3538442,7312919.866666666,59.57521716873602,59.52387799086835,NaN,NaN,NaN,NaN,6.4439317089575185,22.416896205976887,1023575469,0.8395461011622904,4.803478016111029,3.9639319149487386
2023-11-21T09:30:00-05:00,235.09,243.61,233.35,240.35,222.99450298942799,NaN,NaN,NaN,NaN,NaN,220.3863200000001,247.81211435331323,192.96052564668696,227.84627253640494,239.10333333333332,239.10333603073164,239.103330635935,10285933,7330661.566666666,63.501836790718954,60.79505942935164,NaN,NaN,NaN,NaN,6.716508015460555,22.19452334853054,1033861402,0.8938299992950354,5.081219414067533,4.187389414772498
2023-11-21T13:30:00-05:00,240.38,242.21,240.01,241.26,222.99450298942799,NaN,NaN,NaN,NaN,NaN,220.1131200000001,246.40620806401887,193.82003193598132,227.84627253640494,239.60336645166876,240.48561830192833,238.7211146014092,3304122,7312251.133333334,64.23555735851923,61.99410796377771,NaN,NaN,NaN,NaN,6.393900300070517,21.988034266616076,1037165524,0.9008964935255097,5.313510031679385,4.412613538153876
2023-11-22T09:30:00-05:00,242.04,244.01,231.45,234.18,222.99450298942799,NaN,NaN,NaN,NaN,NaN,219.89212000000006,245.51423295155604,194.27000704844409,227.84627253640494,236.54666666666665,236.54666666666665,236.54666666666665,10340862,7358330.5,54.97565064851245,61.97386453032939,NaN,NaN,NaN,NaN,6.8343359929226235,20.449953197718404,1026824662,0.36604113719430575,4.8701649596467576,4.504123822452452
2023-11-22T13:30:00-05:00,234.18,234.82,231.4,234.21,222.99450298942799,NaN,NaN,NaN,NaN,NaN,219.72632000000004,244.8638129042319,194.58882709576818,227.72482638578134,235.8223835207666,237.12582633979486,234.51894070173836,3192931,7270397.566666666,55.005248872267465,61.85363499039851,NaN,NaN,NaN,NaN,6.590454850571007,19.014611094327613,1030017593,-0.02753302676320235,4.469707538998449,4.497240565761651
2023-11-24T09:30:00-05:00,233.74,238.75,232.36,235.54,222.99450298942799,NaN,NaN,NaN,NaN,NaN,220.01202000000004,245.53428284165108,194.489757158349,227.72482638578134,235.54999999999995,235.55000381469722,235.5499961853027,7558525,7153510.866666666,56.37447121474787,61.154902063582355,NaN,NaN,NaN,NaN,6.576136646958791,18.23357545571022,1037576118,-0.2288973520869897,4.2111188756529145,4.440016227739904
2023-11-27T09:30:00-05:00,236.84,238.32,232.1,237.45,222.99450298942799,NaN,NaN,NaN,NaN,NaN,220.35882000000004,246.34402162150596,194.37361837849411,227.72482638578134,235.95666666666662,235.95666666666662,235.95666666666662,8272565,7301446.766666667,58.33533069390319,60.53736261637873,NaN,NaN,NaN,NaN,6.550698315033164,17.465921634468803,1045848683,-0.2616964752254498,4.112895633708092,4.374592108933542
2023-11-27T13:30:00-05:00,237.43,237.95,235.72,236.19,222.99450298942799,NaN,NaN,NaN,NaN,NaN,220.77542000000005,247.09247769599426,194.45836230400585,227.72482638578134,236.13304552048817,236.42611287274786,235.83997816822847,2996390,7045295,56.5302020130217,59.581895943397434,NaN,NaN,NaN,NaN,6.242077006816508,16.753100229030345,1042852293,-0.3888283461511044,3.8885566762446615,4.277385022395766
2023-11-28T09:30:00-05:00,236.72,244,234.01,243.82,222.99450298942799,NaN,NaN,NaN,NaN,NaN,221.41302000000005,248.37967408237182,194.44636591762827,227.93131224807428,240.61,240.61,240.61,12522136,7356540.033333333,63.82934053264023,59.120872081965835,NaN,NaN,NaN,NaN,6.5097857920439015,16.944314875124693,1055374429,-0.0001964433195471571,4.277139468246332,4.27733591156588
2023-11-28T13:30:00-05:00,243.81,246.99,243.65,246.74,226.01484034746727,NaN,NaN,NaN,NaN,NaN,222.07562000000004,249.8585244727567,194.2927155272434,232.4650497984594,242.17362179791937,244.55266779557527,239.79457580026346,5409239,7251431.866666666,66.17045746223275,59.632633876729315,NaN,NaN,NaN,NaN,6.283372521183623,17.491884626109787,1060783668,0.39075272552094464,4.76577681846706,4.3750240929461155
2023-11-29T09:30:00-05:00,249.21,252.75,245.37,247.13,229.62598396803693,NaN,NaN,NaN,NaN,NaN,222.77762000000007,251.2743419697679,194.28089803023224,237.44003983876752,248.41666666666666,248.41666666666666,248.41666666666666,11658966,7529258.5,66.48249354643707,60.18871054771479,NaN,NaN,NaN,NaN,6.361703055384793,18.63408781457336,1072442634,0.6003108163981361,5.125412613443785,4.525101797045649
2023-11-29T13:30:00-05:00,247.12,247.5,242.75,244.16,229.62598396803693,NaN,NaN,NaN,NaN,NaN,223.30722000000003,252.38365193320578,194.23078806679428,237.44003983876752,247.47187362016905,249.0597080911686,245.8840391491695,4127841,7404611.666666667,61.8070458172549,60.23988234782232,NaN,NaN,NaN,NaN,6.246581408571593,19.175008634906355,1068314793,0.46939553212663476,5.111846212203943,4.642450680077308
2023-11-30T09:30:00-05:00,245.09,245.22,239.1,239.69,229.62598396803693,NaN,NaN,NaN,NaN,NaN,223.77002000000005,253.13668469448476,194.40335530551533,237.44003983876752,241.33666666666667,241.33666666666667,241.33666666666667,9226136,7572046.533333333,55.48278312362566,60.015239566470015,NaN,NaN,NaN,NaN,6.237539879387908,18.995822309910153,1059088657,0.035144584812947244,4.6863814110934925,4.651236826280545
2023-11-30T13:30:00-05:00,239.72,241.85,236.91,240.05,229.62598396803693,NaN,NaN,NaN,NaN,NaN,224.28142,253.8728636554616,194.6899763445384,237.44003983876752,240.78946226344377,241.5951017444462,239.98382278244134,4256352,7413074.5,55.87438284002694,59.87000129161747,NaN,NaN,NaN,NaN,6.144858459431629,18.441344145295837,1063345009,-0.2583079126618886,4.328351935453185,4.586659848115073
2023-12-01T09:30:00-05:00,233.09,240.19,231.91,238.89,229.62598396803693,NaN,NaN,NaN,NaN,NaN,224.81222000000002,254.48056490102806,195.143875098972,237.44003983876752,236.99666666666667,236.99666666666667,236.99666666666667,11202278,7661267.8,54.219341767443986,59.487438762953744,NaN,NaN,NaN,NaN,6.297368569472227,17.13803963706308,1052142731,-0.5445415176916502,3.90598295100051,4.45052446869216
2023-12-01T13:30:00-05:00,238.9,239.07,236.62,238.75,229.62598396803693,NaN,NaN,NaN,NaN,NaN,225.47002000000003,254.88576223571962,196.05427776428044,237.44003983876752,237.28401935338715,237.78189888013642,236.78613982663788,3731542,7398863.866666666,54.011402637544194,58.809550609155544,NaN,NaN,NaN,NaN,6.022556528795639,15.927828307989808,1048411189,-0.7449104848735333,3.519386362600244,4.264296847473777
2023-12-04T09:30:00-05:00,235.75,239.36,233.29,236.46,229.62598396803693,NaN,NaN,NaN,NaN,NaN,226.08742,255.10131869449432,197.0735213055057,237.44003983876752,236.37,236.37,236.37,8382997,7513226.4,50.593432554902414,57.835113123182914,NaN,NaN,NaN,NaN,6.025945348167381,15.328199366175758,1040028192,-1.0164676637061723,2.9937122678410617,4.010179931547234
2023-12-04T13:30:00-05:00,236.46,237.58,235.43,235.59,229.62598396803693,NaN,NaN,NaN,NaN,NaN,226.63742000000002,255.30635212964773,197.9684878703523,237.44003983876752,236.32288881296716,236.39897716854887,236.24680045738546,3213742,7283482.666666667,49.316570093550325,57.430893083542756,NaN,NaN,NaN,NaN,5.749092109012568,14.771401063062712,1036814450,-1.225470940378357,2.4783412560742875,3.7038121964526445
2023-12-05T09:30:00-05:00,233.85,246.66,233.7,240.07,229.62598396803693,NaN,NaN,NaN,NaN,NaN,227.29282,255.66021932158654,198.92542067841347,237.44003983876752,240.14333333333335,240.14333333333335,240.14333333333335,12479603,7565850.8,55.53915876734556,57.46902950461976,NaN,NaN,NaN,NaN,6.2641569583688135,14.627194102220162,1049294053,-1.0400927483372464,2.4036962610310866,3.443789009368333
2023-12-05T13:30:00-05:00,240.15,240.45,237.58,238.89,229.62598396803693,NaN,NaN,NaN,NaN,NaN,228.13862,255.29084761510265,200.98639238489736,237.44003983876752,239.81053827651792,240.33838074035924,239.2826958126766,4960733,7339045.4,53.67008660323518,57.275859175226,NaN,NaN,NaN,NaN,6.021717175628182,14.493287638580657,1044333320,-0.9760791187404623,2.223690110942755,3.199769229683217
2023-12-06T09:30:00-05:00,242.96,246.56,241.35,242.42,229.62598396803693,NaN,NaN,NaN,NaN,NaN,229.03922,255.0137759662987,203.0646640337013,232.87703187101403,243.44333333333333,243.44333333333333,243.44333333333333,11813295,7595649.033333333,58.201793389938146,57.26632079637136,NaN,NaN,NaN,NaN,6.139451663083313,15.168682737533784,1056146615,-0.6886842675691391,2.3389138952217934,3.0275981627909325
2023-12-06T13:30:00-05:00,242.43,243.12,239.18,239.41,229.62598396803693,NaN,NaN,NaN,NaN,NaN,229.83261999999996,254.5730388772631,205.09220112273684,231.1555389275111,242.7405486260975,243.9756309637322,241.50546628846283,3824933,7321306.1,53.40492202282766,57.043086511357494,NaN,NaN,NaN,NaN,5.982347972863076,15.381616216152372,1052321682,-0.6921419779394302,2.1624206903666447,2.854562668306075
2023-12-07T09:30:00-05:00,241.61,244.08,236.98,239.97,229.62598396803693,NaN,NaN,NaN,NaN,NaN,230.61361999999994,254.08689485593933,207.14034514406055,231.1555389275111,240.34333333333336,240.34333333333336,240.34333333333336,9956693,7460617.333333333,54.16185076163749,56.352551527714446,NaN,NaN,NaN,NaN,6.062180260515715,15.169200466365387,1062278375,-0.6483125888396004,2.0441719322565746,2.692484521096175
2023-12-07T13:30:00-05:00,239.99,242.86,239.92,242.6,229.62598396803693,NaN,NaN,NaN,NaN,NaN,231.44382,253.57976447296943,209.30787552703055,231.1555389275111,240.64697344479953,241.23695721094913,240.05698967864993,2637262,7099643.366666666,57.64203654073946,55.74337860475064,NaN,NaN,NaN,NaN,5.839167384764594,14.97195727013462,1064915637,-0.4435619712637946,2.1380320570164315,2.581594028280226
2023-12-08T09:30:00-05:00,240.27,245.27,239.28,242.51,229.62598396803693,NaN,NaN,NaN,NaN,NaN,232.18041999999997,253.264171871392,211.09666812860794,231.50869274470853,242.35333333333335,242.35333333333335,242.35333333333335,9858355,7286401.633333334,57.48120446838434,55.10042938488972,NaN,NaN,NaN,NaN,5.849941142995696,15.152641323438552,1055057282,-0.3212554890773882,2.180024666933491,2.5012801560108793
2023-12-08T13:30:00-05:00,242.57,244.73,242.5,243.76,229.62598396803693,NaN,NaN,NaN,NaN,NaN,232.71701999999996,253.58550685838085,211.84853314161907,232.6059541957668,242.6918332441531,243.26529003725747,242.1183764510487,3434948,7049129.266666667,59.18457771793989,54.91311023493865,NaN,NaN,NaN,NaN,5.591373918496003,15.32041937293506,1058492230,-0.17078702588420436,2.287796373655624,2.4585833995398283
2023-12-11T09:30:00-05:00,242.75,243.43,237.46,238.72,229.62598396803693,NaN,NaN,NaN,NaN,NaN,233.12061999999997,253.65464059369754,212.5865994063024,232.6059541957668,239.86999999999998,239.87000381469724,239.8699961853027,9224889,7199975.333333333,50.41473912555007,54.55110709221896,NaN,NaN,NaN,NaN,5.641990067174858,14.438763181760212,1049267341,-0.41157883129662487,1.9441098604190472,2.355688691715672
2023-12-11T13:30:00-05:00,238.74,240.67,238.12,239.61,229.62598396803693,NaN,NaN,NaN,NaN,NaN,233.52602,253.75385058853186,213.29818941146812,232.6059541957668,239.76746410820638,239.94308453391034,239.59184368250243,3144582,6919353.3,51.77371275420599,54.25820208608889,NaN,NaN,NaN,NaN,5.4211336338052245,13.620082432812138,1052411923,-0.5056054709216156,1.7236818530636526,2.229287323985268
2023-12-12T09:30:00-05:00,238.47,238.99,233.88,234.69,229.62598396803693,NaN,NaN,NaN,NaN,NaN,233.82142,253.67373903870006,213.96910096129992,232.6059541957668,235.85333333333332,235.85333333333332,235.85333333333332,9092077,7066066.066666666,44.511191360492326,53.56476277130663,NaN,NaN,NaN,NaN,5.4431955171048525,13.226182160271716,1043319846,-0.8723417657628998,1.1388601167816432,2.011201882544543
2023-12-12T13:30:00-05:00,234.69,237.51,234.54,237.01,229.62598396803693,NaN,NaN,NaN,NaN,NaN,234.24542000000002,253.43541558557172,215.05542441442833,232.6059541957668,236.00119517333644,236.22937886310785,235.77301148356503,3817738,6915536.9,48.20102547927774,53.14973583143046,NaN,NaN,NaN,NaN,5.266538694454505,12.86041762148418,1047137584,-0.9267541372705543,0.85275921095635,1.7795133482269043
2023-12-13T09:30:00-05:00,234.14,236.9,228.2,230.33,NaN,NaN,NaN,249.83077720773971,249.83077720773971,249.83077720773971,234.46561999999997,253.2130722680386,215.71816773196136,232.6059541957668,231.81000000000003,231.81000000000003,231.81000000000003,9970835,7129950,39.96127690672718,52.39029614227508,NaN,NaN,NaN,NaN,5.51964307342204,13.553163198822194,1037166749,-1.354802252143001,0.08601053304815309,1.440812785191154
2023-12-13T13:30:00-05:00,230.31,240.3,230.01,239.27,NaN,NaN,NaN,249.83077720773971,NaN,NaN,234.86602,253.14581879315938,216.5862212068406,232.6059541957668,233.8996435140508,236.24262065694606,231.55666637115556,7931217,7051459.466666667,51.829475320780425,52.569789372791526,NaN,NaN,NaN,NaN,5.860382853891896,13.467453712549807,1045097966,-0.994679245718838,0.1974637280426066,1.1921429737614446
2023-12-14T09:30:00-05:00,241.15,253.88,240.8,249.56,228.2628248995595,228.2628248995595,228.2628248995595,NaN,NaN,NaN,235.41322,253.78145702499287,217.04498297500712,233.91983370935608,248.08,248.08,248.08,15079318,7443966,61.30968873721897,52.981970084925344,NaN,NaN,NaN,NaN,6.485355507185331,13.739534402800263,1060177284,-0.07100317159205027,1.1033890092713818,1.1743921808634321
2023-12-14T13:30:00-05:00,249.55,252.15,247.2,251.14,230.7899692223068,NaN,NaN,NaN,NaN,NaN,236.03642,254.38227524891994,217.69056475108005,233.91983370935608,248.6003123718845,249.50212118963245,247.69850355413658,5019738,7266595.2,62.52911918605947,53.61475812655565,NaN,NaN,NaN,NaN,6.375687256672094,13.992180758032829,1065197022,0.6017864001641582,1.92662518106863,1.3248387809044717
2023-12-15T09:30:00-05:00,251.13,253.67,248.28,252.79,232.21337971220194,NaN,NaN,NaN,NaN,NaN,236.65002,255.14335302783226,218.15668697216776,236.22049357398788,251.57999999999998,251.58000381469725,251.57999618530272,9406776,7473723.366666666,63.8118420310094,54.01547588663217,NaN,NaN,NaN,NaN,6.3052810240526584,14.422367139164352,1074603798,1.0851520751625796,2.6812788748576963,1.5961267996951167
2023-12-15T13:30:00-05:00,252.8,254.1,250.6,253.23,233.96390790710186,NaN,NaN,NaN,NaN,NaN,237.53202000000002,254.86104794037428,220.20299205962576,238.3903948591903,251.8632131691628,252.33325604383745,251.39317029448816,3415016,7335606.4,64.16414002803913,54.78399145843298,NaN,NaN,NaN,NaN,6.104903808048897,14.878864847204799,1078018814,1.3447590397142537,3.277075599337934,1.9323165596236802
2023-12-18T09:30:00-05:00,253.84,258.74,252.56,254.15,237.2569120931427,NaN,NaN,NaN,NaN,NaN,238.41602000000003,254.49086183182595,222.3411781681741,243.08231588735225,255.14999999999998,255.15000381469724,255.1499961853027,9012749,7360279.2,64.9328525755009,55.553348730851795,NaN,NaN,NaN,NaN,6.110267821759691,15.890754949102837,1087031563,1.4780768541866953,3.7799126273570494,2.301835773170354
2023-12-18T13:30:00-05:00,254.17,254.97,251.36,252.02,237.2569120931427,NaN,NaN,NaN,NaN,NaN,239.19182,254.0259593693836,224.35768063061641,243.08231588735225,254.45035958134665,255.53032205387294,253.37039710882036,3782594,7386486,61.63630610779599,55.838653699927264,NaN,NaN,NaN,NaN,5.931677263062569,16.57099745154352,1083248969,1.3272376251062261,3.960882804553137,2.6336451794469107
2023-12-19T09:30:00-05:00,253.46,258.33,253.01,256.23,237.58065750635518,NaN,NaN,NaN,NaN,NaN,240.02241999999995,253.89787069013613,226.14696930986378,243.71008216790545,255.85666666666665,255.85666666666665,255.85666666666665,8359086,7247717.666666667,65.37773403445813,56.402691526075394,NaN,NaN,NaN,NaN,5.958700315700955,17.619335182373973,1091608055,1.4077804533857754,4.39337074617913,2.9855902927933546
2023-12-19T13:30:00-05:00,256.23,257.26,255.2,257.23,238.68199125606634,NaN,NaN,NaN,NaN,NaN,240.72461999999996,254.45794173592196,226.99129826407795,244.53406573432434,256.02082613674713,256.3192514941026,255.72240077939165,2529410,7151723.366666666,66.2204352179485,56.905252776076004,NaN,NaN,NaN,NaN,5.680221721722314,18.592791646716538,1094137465,1.4210635671813803,4.76191975177008,3.3408561845886995
2023-12-20T09:30:00-05:00,256.41,259.84,254.88,256.84,239.9332643807906,NaN,NaN,NaN,NaN,NaN,241.38841999999994,254.963935831615,227.81290416838488,247.17925258745947,257.18666666666667,257.18666666666667,257.18666666666667,8553035,7048192.333333333,65.55033108644307,57.98636648756837,NaN,NaN,NaN,NaN,5.628777313027862,19.816490918616072,1085584430,1.2995478281734356,4.965290969805494,3.6657431416320585
2023-12-20T13:30:00-05:00,256.84,257.44,247,247.17,239.9332643807906,NaN,NaN,NaN,NaN,NaN,241.60999999999996,255.19408480538922,228.0259151946107,247.17925258745947,254.36366958346227,257.6505553544532,251.07678381247132,6309165,7120903.133333334,51.606017000362954,57.974388219436726,NaN,NaN,NaN,NaN,5.972436076383014,19.24266963441778,1079275265,0.5047229829501854,4.29664687031979,3.791923887369605
2023-12-21T09:30:00-05:00,251.94,254,248.55,251.25,239.9332643807906,NaN,NaN,NaN,NaN,NaN,241.88679999999997,255.67969871781872,228.0939012821812,247.17925258745947,251.26666666666662,251.2666704813639,251.26666285196936,9211280,7120407.933333334,55.871424673059956,58.78583345604869,NaN,NaN,NaN,NaN,6.033690642355657,18.709835584805077,1088486545,0.20588957760836646,4.049285859380063,3.843396281771697
2023-12-21T13:30:00-05:00,251.26,254.79,251.09,254.59,239.9332643807906,NaN,NaN,NaN,NaN,NaN,242.13259999999994,256.37684195807066,227.8883580419292,247.17925258745947,251.82438485811255,252.78820219795784,250.86056751826726,3084325,7081340.366666666,59.05313625368539,59.56098422564924,NaN,NaN,NaN,NaN,5.866998453615966,18.34170135170615,1091570870,0.18590500352043415,4.0757775361722395,3.8898725326518053
2023-12-22T09:30:00-05:00,256.7,258.22,254.26,255.53,239.9332643807906,NaN,NaN,NaN,NaN,NaN,242.38419999999994,257.11345637770125,227.6549436222986,247.17925258745947,256.00333333333333,256.00333333333333,256.00333333333333,6712072,6931666.833333333,59.928803849285444,60.98723615011769,NaN,NaN,NaN,NaN,5.730784278357684,18.530258043929695,1098282942,0.1881589907893746,4.125071271138523,3.9369122803491488
2023-12-22T13:30:00-05:00,255.53,255.76,251.37,252.52,239.9332643807906,NaN,NaN,NaN,NaN,NaN,242.75979999999996,257.5458634328407,227.97373656715922,247.17925258745947,255.05567373190743,256.37580732456775,253.73554013924712,3458801,6922575.466666667,55.81280000723329,61.27175934200719,NaN,NaN,NaN,NaN,5.635013972760706,18.080495915653675,1094824141,-0.0482751047333414,3.876568399432472,3.924843504165813
2023-12-26T09:30:00-05:00,254.46,257.82,252.92,257.72,239.9332643807906,NaN,NaN,NaN,NaN,NaN,243.24500000000003,258.3668947225492,228.12310527745086,247.17925258745947,256.15333333333336,256.15333333333336,256.15333333333336,7128599,6880762.2,60.81929656911973,61.2367313300001,NaN,NaN,NaN,NaN,5.611084403277796,17.99252925073534,1101952740,0.10213304825455882,4.0525098144840115,3.9503767662294527
2023-12-26T13:30:00-05:00,257.72,257.96,256.18,256.68,240.30518523625165,NaN,NaN,NaN,NaN,NaN,243.64820000000003,259.10275619032285,228.19364380967718,247.17925258745947,256.3553728607942,256.6990555501251,256.01169017146333,2463551,6855755.833333333,59.37044979567302,61.01111208782964,NaN,NaN,NaN,NaN,5.33743551732938,17.933617617545757,1099489189,0.08866678021331698,4.061210241496099,3.9725434612827817
2023-12-27T09:30:00-05:00,258.22,263.34,257.53,262.84,243.5240404527856,NaN,NaN,NaN,NaN,NaN,244.21580000000006,260.3485865367344,228.08301346326573,250.94688795538366,261.2366666666666,261.2366666666666,261.2366666666666,9041650,6741157.4,64.72989541726685,61.07668732970517,NaN,NaN,NaN,NaN,5.431904408948708,18.689140194025462,1108530839,0.43247821382840446,4.513141228568287,4.080663014739883
2023-12-27T13:30:00-05:00,262.85,263.19,260.14,261.45,245.10681134129536,NaN,NaN,NaN,NaN,NaN,244.76740000000007,261.3278443466895,228.20695565331062,251.75051036430696,261.3273746488672,261.4826955283529,261.1720537693815,3083749,6678591.266666667,62.71942048366911,60.97349307653588,NaN,NaN,NaN,NaN,5.261768379738087,19.390696872185192,1105447090,0.4993921585968115,4.704903212985897,4.205511054389086
2023-12-28T09:30:00-05:00,263.66,265.12,256.48,256.7,245.10681134129536,NaN,NaN,NaN,NaN,NaN,245.18720000000005,261.87166656743426,228.50273343256583,251.75051036430696,259.43333333333334,259.43333333333334,259.43333333333334,8901465,6581530.266666667,56.2857912945636,60.35584584218322,NaN,NaN,NaN,NaN,5.503070638328223,19.14707043253954,1096545625,0.1736788160236582,4.422609574418658,4.248930758395
2023-12-28T13:30:00-05:00,256.71,257.19,252.71,253.02,245.10681134129536,NaN,NaN,NaN,NaN,NaN,245.44060000000002,262.2081555332284,228.67304446677161,251.75051036430696,257.7700736112786,260.1701872069361,255.36996001562107,4274822,6596526.566666666,51.848395166015024,59.65670934634172,NaN,NaN,NaN,NaN,5.42999416416192,18.112232718070857,1092270803,-0.3131622210355731,3.8574779821005336,4.170640203136107
2023-12-29T09:30:00-05:00,255.09,255.19,247.45,249.82,245.10681134129536,NaN,NaN,NaN,NaN,NaN,245.61180000000004,262.3799191264798,228.84368087352027,251.75051036430696,250.82000000000002,250.82000000000002,250.82000000000002,8410008,6544970.4,48.283742706480936,58.43570996577193,NaN,NaN,NaN,NaN,5.594994581007498,17.441850283378702,1083860795,-0.8441277251267971,3.1154805467276105,3.9596082718544077
2023-12-29T13:30:00-05:00,249.84,251.03,248.12,248.5,245.10681134129536,NaN,NaN,NaN,NaN,NaN,245.89820000000003,262.3619228791021,229.43447712089798,251.75051036430696,250.41213671246035,251.1104119755502,249.7138614493705,2869276,6552704.2,46.85278779713366,57.05230657857087,NaN,NaN,NaN,NaN,5.403209253792676,16.819352308307415,1080991519,-1.2530143554050377,2.3933403275981107,3.6463546830031484
2024-01-02T09:30:00-05:00,250.13,251.24,244.41,248.34,NaN,NaN,NaN,264.7281719414976,264.7281719414976,264.7281719414976,246.1808,262.31407584342105,230.04752415657893,251.75051036430696,247.99666666666667,247.99666666666667,247.99666666666667,8070324,6493103.166666667,46.67223080294123,55.703870844035016,NaN,NaN,NaN,NaN,5.505122878521772,16.858818994753697,1072921195,-1.487065436622625,1.787522887224867,3.274588323847492
2024-01-02T13:30:00-05:00,248.39,249.38,246.06,248.4,NaN,NaN,NaN,264.30757321688407,NaN,NaN,246.43800000000002,262.2921426762821,230.58385732371792,251.75051036430696,247.98380443609335,248.0056602033578,247.9619486688289,2795062,6471773.633333334,46.755096135485516,55.35737649654378,NaN,NaN,NaN,NaN,5.349042672913074,16.895466632168105,1075716257,-1.581834429415582,1.2972952870780148,2.8791297164935967
2024-01-03T09:30:00-05:00,245,245.67,236.32,240.16,NaN,NaN,NaN,258.47586534338933,NaN,NaN,246.49220000000005,262.24124507072804,230.74315492927207,251.75051036430696,240.71666666666667,240.71666666666667,240.71666666666667,9583784,6483736.8,38.01796306980726,54.08212923916859,NaN,NaN,NaN,NaN,5.82982533913357,18.25057950181101,1066132473,-2.110417449375634,0.2411079047740543,2.3515253541496883
2024-01-03T13:30:00-05:00,240.17,241.61,238,238.43,NaN,NaN,NaN,256.98355328232617,NaN,NaN,246.53700000000003,262.18096024029256,230.8930397597075,251.75051036430696,240.35367519930608,240.9582705225637,239.74907987604846,3454620,6494071.4,36.476760133216125,52.46953094484935,NaN,NaN,NaN,NaN,5.671266386338316,19.508898595050855,1062677853,-2.4629344421277226,-0.7271426985099652,1.7357917436177575
2024-01-04T09:30:00-05:00,239.18,242.69,237.73,241.16,NaN,NaN,NaN,256.98355328232617,NaN,NaN,246.4838,262.1823532530844,230.78524674691565,251.75051036430696,240.52666666666664,240.52666666666664,240.52666666666664,7648129,6445939.8,40.570976630933664,51.08682900068137,NaN,NaN,NaN,NaN,5.620461644457008,20.405802660177827,1070325982,-2.3963768303040447,-1.2596792942622983,1.1366975360417464
2024-01-04T13:30:00-05:00,241.17,241.79,237.8,237.92,NaN,NaN,NaN,256.6370702427807,NaN,NaN,246.30740000000003,262.1876376858751,230.42716231412498,251.64840829144558,240.1107082079965,240.73624440699214,239.48517200900088,3381818,6431409.133333334,37.483226311573176,49.777573736705655,NaN,NaN,NaN,NaN,5.504000098424363,21.2386421492243,1066944164,-2.446170060607536,-1.9210150397176733,0.5251550208898624
2024-01-05T09:30:00-05:00,236.97,240.11,235,237.82,NaN,NaN,NaN,254.32833977719974,NaN,NaN,246.1212,262.17585696425584,230.06654303574416,244.17272663315646,237.64333333333335,237.64333333333335,237.64333333333335,6985963,6331913.4,37.388644830497135,48.103955755375466,NaN,NaN,NaN,NaN,5.475857234251196,22.388544888664036,1059958201,-2.3603167204891236,-2.4252408797215423,-0.06492415923241857
2024-01-05T13:30:00-05:00,237.82,239.38,236.7,237.41,NaN,NaN,NaN,254.32833977719974,NaN,NaN,245.9862,262.2171028165392,229.75529718346084,240.90618130652516,237.693485986648,237.77622980814743,237.61074216514857,2566510,6153089.833333333,36.97667487913879,46.50440040419444,NaN,NaN,NaN,NaN,5.2761531460903965,23.456311718143784,1057391691,-2.208347148430448,-2.825358094770479,-0.6170109463400306
2024-01-08T09:30:00-05:00,236.16,240,235.3,238.93,NaN,NaN,NaN,253.9228984333576,NaN,NaN,245.97099999999998,262.22686380356254,229.7151361964374,238.14794504522013,238.07666666666668,238.07666666666668,238.07666666666668,6834465,5878261.4,39.6323473964427,44.71171840270701,NaN,NaN,NaN,NaN,5.234999349941082,24.64054753403562,1064226156,-1.89470233813895,-2.9853888690137182,-1.0906865308747682
2024-01-08T13:30:00-05:00,238.94,241.25,238.67,240.46,NaN,NaN,NaN,253.9228984333576,NaN,NaN,245.9792,262.2235180663256,229.73488193367442,237.5193560361761,238.65469901503587,239.57711156828614,237.7322864617856,2683851,5800398.5,42.269359414577,43.25099975491471,NaN,NaN,NaN,NaN,5.045356539231006,25.342505959991467,1066910007,-1.4912078133962452,-2.9546962976200746,-1.4634884842238294
2024-01-09T09:30:00-05:00,238.2,238.95,232.04,234.17,NaN,NaN,NaN,251.80617398576592,NaN,NaN,245.88479999999998,262.34621730957366,229.42338269042628,236.7434848289409,235.0533333333333,235.0533333333333,235.0533333333333,8922434,5784253.766666667,35.4193349724454,41.760538589049126,NaN,NaN,NaN,NaN,5.286402500714507,26.860620491846767,1057987573,-1.548204444850945,-3.398744040287511,-1.8505395954365658
2024-01-09T13:30:00-05:00,234.18,235.15,233.32,234.87,NaN,NaN,NaN,250.0543024409584,NaN,NaN,245.80720000000002,262.4381292777009,229.17627072229917,230.42453642687863,234.89698390058118,235.16232678079987,234.63164102036248,3097855,5773681.733333333,36.649736769180436,40.67492013213238,NaN,NaN,NaN,NaN,5.039516607806329,28.27029827142668,1061085428,-1.4412260130258172,-3.6520721117188373,-2.21084609869302
2024-01-10T09:30:00-05:00,235.1,235.5,231.29,233.45,NaN,NaN,NaN,249.06933414818752,NaN,NaN,245.747,262.5338916717738,228.96010832822623,230.42453642687863,233.41333333333333,233.41333333333333,233.41333333333333,7640091,5727926.466666667,35.18526741623944,39.739314754257975,NaN,NaN,NaN,NaN,4.980265421534448,29.814515816262567,1053445337,-1.3690877761112503,-3.922205818832083,-2.5531180427208326
2024-01-10T13:30:00-05:00,233.48,235.25,232.78,233.96,NaN,NaN,NaN,249.06933414818752,NaN,NaN,245.7144,262.58618053911067,228.84261946088935,230.42453642687863,233.58001852613086,233.84355045137215,233.31648660088956,3056512,5703723.733333333,36.17174878785665,38.976383396452476,NaN,NaN,NaN,NaN,4.800960748567702,31.24843210789589,1056501849,-1.196279784833854,-4.04846777376315,-2.852187988929296
2024-01-11T09:30:00-05:00,230.57,230.91,225.37,226.64,NaN,NaN,NaN,243.9146515689064,NaN,NaN,245.44580000000005,263.07890163980824,227.81269836019183,230.42453642687863,227.64,227.64,227.64,9041783,5726480.3,29.282795011789958,37.73428083994167,NaN,NaN,NaN,NaN,5.071606409384295,33.3209073647521,1047460066,-1.4663985663536825,-4.685186196871399,-3.2187876305177165
2024-01-11T13:30:00-05:00,226.66,228.65,226.32,227.2,NaN,NaN,NaN,242.86034922486525,NaN,NaN,245.21200000000002,263.4849877141064,226.93901228589363,230.42453642687863,227.5674758435094,227.68092753303767,227.45402415398115,3694856,5765328.5,30.375263598556828,36.56429280158962,NaN,NaN,NaN,NaN,4.87577738014256,35.24534867469002,1051154922,-1.4937497854300266,-5.08597486230525,-3.592225076875223
2024-01-12T09:30:00-05:00,220.07,225.34,217.3,219.27,NaN,NaN,NaN,237.34646971464406,NaN,NaN,244.74900000000002,264.4024977039682,225.0955022960318,230.42453642687863,220.63666666666663,220.6366704813639,220.63666285196936,10231502,5821277.4,24.583644610986894,35.60469862595959,NaN,NaN,NaN,NaN,5.23465042441809,37.67424955204019,1040923420,-1.905912611352779,-5.974615841066196,-4.068703229713417
2024-01-12T13:30:00-05:00,219.29,219.37,217.15,218.79,NaN,NaN,NaN,233.86072109125115,NaN,NaN,244.33660000000003,265.2461398744177,223.42706012558236,230.42453642687863,220.08070773200603,221.03675130801923,219.12466415599283,3459947,5726303.466666667,24.281847973345876,34.73363347168315,NaN,NaN,NaN,NaN,5.019318251245369,39.93851776327276,1037463473,-2.0578760851961446,-6.641048336208598,-4.583172251012454
2024-01-16T09:30:00-05:00,215.1,223.49,212.19,221.21,NaN,NaN,NaN,233.86072109125115,NaN,NaN,243.96140000000003,265.82249677394725,222.1003032260528,230.42453642687863,218.96333333333334,218.96333333333334,218.96333333333334,9842643,5747348.9,29.013396891267575,33.908092061707,NaN,NaN,NaN,NaN,5.467938376156414,42.31582481155822,1047306116,-1.8490239287137928,-6.894452161904695,-5.045428233190902
2024-01-16T13:30:00-05:00,221.26,221.32,219.22,219.98,NaN,NaN,NaN,233.86072109125115,NaN,NaN,243.50900000000001,266.3770829979236,220.64091700207643,226.0796291415029,219.23855312986777,219.74577104891114,218.7313352108244,2897890,5741134.4,28.05384140097533,33.23456456809287,NaN,NaN,NaN,NaN,5.227371349288098,44.52332421353758,1044408226,-1.6536880738401365,-7.112538325491073,-5.4588502516509365
2024-01-17T09:30:00-05:00,214.88,215.56,212.34,212.8,NaN,NaN,NaN,230.2377590182266,NaN,NaN,242.91479999999999,267.34634722566653,218.4832527743334,225.1557701204495,213.5666666666667,213.5666666666667,213.5666666666667,8067203,5786305.433333334,23.225107578462868,32.22288333580472,NaN,NaN,NaN,NaN,5.39970196719609,46.89468058231926,1036341023,-1.8530098133382635,-7.775112518323766,-5.922102704985503
2024-01-17T13:30:00-05:00,212.79,215.65,212.01,215.56,NaN,NaN,NaN,229.87376997194357,NaN,NaN,242.35080000000002,267.952240846951,216.74935915304903,225.1557701204495,213.81356478814837,214.19623401824362,213.43089555805312,3358238,5782953.333333333,28.331767575799844,31.60538995699479,NaN,NaN,NaN,NaN,5.274008969539227,49.11035235343316,1039699261,-1.6506755497149381,-7.985447142129175,-6.334771592414237
2024-01-18T09:30:00-05:00,216.87,217.45,208.74,209.29,NaN,NaN,NaN,229.5972349732189,NaN,NaN,241.7622,268.9731293600924,214.55127063990759,225.1557701204495,211.82666666666668,211.82666666666668,211.82666666666668,9449416,5860313.9,24.366645097415898,30.51498264992145,NaN,NaN,NaN,NaN,5.519436900286423,51.30048705898433,1030249845,-1.779709061943974,-8.559407919844205,-6.779698857900231
2024-01-18T13:30:00-05:00,209.29,212,209.23,211.82,NaN,NaN,NaN,226.7448606562544,NaN,NaN,241.2064,269.67658251012654,212.73621748987347,218.53961609635957,211.62054029326143,211.97334942102066,211.2677311655022,3225466,5885711.066666666,28.70268975241622,29.545934816909966,NaN,NaN,NaN,NaN,5.323048550265965,53.334183571281855,1033475311,-1.544021567942103,-8.70972581782786,-7.165704249885756
2024-01-19T09:30:00-05:00,209.98,213.18,207.55,210.67,NaN,NaN,NaN,226.52941244460646,NaN,NaN,240.726,270.4047603514691,211.04723964853088,217.58869287708765,210.46666666666667,210.46666666666667,210.46666666666667,8664897,5873152.633333334,27.91917888418338,29.010209382034102,NaN,NaN,NaN,NaN,5.344973653818395,55.29158818818969,1024810414,-1.3234190063176303,-8.819978007782794,-7.4965590014651635
2024-01-19T13:30:00-05:00,210.67,212.81,210.24,212.145,NaN,NaN,NaN,226.52941244460646,NaN,NaN,240.2287,270.95466262511445,209.50273737488556,211.54095430167013,210.85534407296927,211.4389593510428,210.27172879489575,3843162,5898466.4,30.53824837990119,28.573674497085587,NaN,NaN,NaN,NaN,5.146761249974224,57.1091781896041,1028653576,-0.9532980317355353,-8.688181541134583,-7.734883509399047
2024-01-22T09:30:00-05:00,212.26,217.8,207.62,207.81,NaN,NaN,NaN,226.52941244460646,NaN,NaN,239.77829999999997,271.70810373318903,207.84849626681094,208.1206107530689,211.07666666666668,211.07666666666668,211.07666666666668,9539465,5919733.066666666,27.3884905789364,28.016761865849656,NaN,NaN,NaN,NaN,5.506278303547495,56.97381090425535,1019114111,-0.8774720333820429,-8.8317235511266,-7.954251517744558
2024-01-22T13:30:00-05:00,207.8,209.66,206.27,208.75,NaN,NaN,NaN,224.13052344567058,NaN,NaN,239.16789999999997,272.25901325356085,206.07678674643907,208.1206107530689,210.30131526189078,211.5696140053763,209.03301651840525,3565152,5896077.4,29.096246112128625,27.511368817583367,NaN,NaN,NaN,NaN,5.355115567579816,56.97453309767665,1022679263,-0.6514412359211477,-8.768553062645992,-8.117111826724845
2024-01-23T09:30:00-05:00,211.35,215.65,208.26,208.32,NaN,NaN,NaN,224.13052344567058,NaN,NaN,238.34309999999996,272.3987657776645,204.28743422233546,207.9744886024551,210.74333333333337,210.74333333333337,210.74333333333337,7912263,5879485.9,28.762988916334052,27.47423981076509,NaN,NaN,NaN,NaN,5.50046445560983,55.19411002755813,1014767000,-0.42905932131184876,-8.653435978364655,-8.224376657052806
2024-01-23T13:30:00-05:00,208.33,209.67,207.75,209.15,NaN,NaN,NaN,224.13052344567058,NaN,NaN,237.50329999999997,272.3177428425903,202.68885715740961,202.99094772816161,210.23269710012752,211.0709399034414,209.39445429681365,2936191,5881716.4,30.41961211841955,27.477407562183856,NaN,NaN,NaN,NaN,5.2447169944948415,53.61053526549685,1017703191,-0.13923391382251893,-8.398419049330954,-8.259185135508435
2024-01-24T09:30:00-05:00,211.86,212.72,208.56,210.84,NaN,NaN,NaN,224.13052344567058,NaN,NaN,236.66429999999997,271.9829864993586,201.34561350064132,202.99094772816161,210.7066666666667,210.7066666666667,210.7066666666667,7040318,5847382.866666666,33.79558018440426,28.135402960285095,NaN,NaN,NaN,NaN,5.1672372091737815,51.335951348314104,1024743509,0.23287117476895958,-7.968096167047236,-8.200967341816195
2024-01-24T13:30:00-05:00,210.85,211.06,206.78,207.76,NaN,NaN,NaN,224.13052344567058,NaN,NaN,235.7549,271.6573299172064,199.85247008279353,202.99094772816161,209.91431150348092,210.9603636930821,208.86825931387975,4039479,5888863.433333334,30.85714620178568,28.605067119459367,NaN,NaN,NaN,NaN,5.103863122804226,49.50605490831524,1020704030,0.3321001929119465,-7.785842100676263,-8.117942293588209
2024-01-25T09:30:00-05:00,189.66,192.83,180.06,181.93,NaN,NaN,NaN,205.17129042973707,NaN,NaN,234.31049999999996,272.8505897897241,195.77041021027583,202.99094772816161,184.93999999999997,184.93999999999997,184.93999999999997,20046160,6237609.3,17.28438276637891,27.76728039625303,NaN,NaN,NaN,NaN,6.71787289974678,50.191706348662514,1000657870,-1.1975147478818862,-9.614835728440568,-8.417320980558681
2024-01-25T13:30:00-05:00,181.92,183.49,180.21,182.56,NaN,NaN,NaN,200.17236813747633,NaN,NaN,232.92129999999997,273.7474931024678,192.0951068975322,202.99094772816161,184.26761803736613,185.47858144021623,183.05665463451604,6180182,6328461.366666666,18.229122124133454,27.065514733621466,NaN,NaN,NaN,NaN,6.472310549764868,50.82838268612784,1006838052,-1.9765278204625965,-10.887980756136926,-8.91145293567433
2024-01-26T09:30:00-05:00,185.48,186.55,182.51,183.51,NaN,NaN,NaN,200.17236813747633,NaN,NaN,231.46689999999995,274.01300924115185,188.92079075884803,202.99094772816161,184.18999999999997,184.18999999999997,184.18999999999997,10466931,6422421.433333334,19.71817281041278,26.815019393046462,NaN,NaN,NaN,NaN,6.298574081924522,50.77936226383265,1017304983,-2.219314471964278,-11.685596025629678,-9.4662815536654
2024-01-26T13:30:00-05:00,183.5,183.63,182.1,183.23,NaN,NaN,NaN,200.17236813747633,NaN,NaN,229.9869,273.9693363531621,186.0044636468379,202.99094772816161,183.87289478626852,184.40301510967817,183.34277446285887,3745219,6434534.8,19.60485619580163,26.19166858018945,NaN,NaN,NaN,NaN,5.9579616475013415,50.76255837844715,1013559764,-2.186714973601008,-12.19967527066666,-10.012960297065652
2024-01-29T09:30:00-05:00,185.61,190.9,183.68,187.42,NaN,NaN,NaN,200.17236813747633,NaN,NaN,228.59849999999997,273.47624781559364,183.7207521844063,201.12120654602342,187.33333333333334,187.33333333333334,187.33333333333334,10154041,6540137.4,26.419315775300504,26.338287914324063,NaN,NaN,NaN,NaN,6.080250101251247,49.31219215234742,1023713805,-1.6929687681742571,-12.129171257283474,-10.436202489109217
2024-01-29T13:30:00-05:00,187.45,191.48,187.4,190.95,NaN,NaN,NaN,200.17236813747633,NaN,NaN,227.47409999999996,273.2426029551987,181.7055970448012,201.12120654602342,188.0265111320555,189.17920302237746,186.87381924173354,3671992,6576986.8,31.673846564280794,26.55051340088582,NaN,NaN,NaN,NaN,5.937375094019013,47.85981155363391,1027385797,-0.9743287724664391,-11.654113454692265,-10.679784682225826
2024-01-30T09:30:00-05:00,195.36,196.35,190.61,192.08,NaN,NaN,NaN,200.17236813747633,NaN,NaN,226.29069999999996,272.595667682097,179.98573231790292,200.573572189455,193.01333333333335,193.01333333333335,193.01333333333335,9265240,6658012.633333334,33.315507230368794,26.935965425613347,NaN,NaN,NaN,NaN,5.923276873017654,45.65477371244833,1036651037,-0.3033437028020014,-11.058964310728328,-10.755620607926327
2024-01-30T13:30:00-05:00,192.1,192.39,191.14,191.585,NaN,NaN,NaN,200.17236813747633,NaN,NaN,225.03059999999994,271.61481881453057,178.4463811854693,200.573572189455,192.76205001736025,193.27743243217836,192.24666760254215,2202545,6641969.1,32.942120048234585,27.107670544780017,NaN,NaN,NaN,NaN,5.5894713820878215,43.60723857420458,1034448492,0.19958571430084504,-10.50613846505027,-10.705724179351115
2024-01-31T09:30:00-05:00,186.96,191.85,185.85,191.31,NaN,NaN,NaN,200.17236813747633,NaN,NaN,223.74619999999996,270.4370978949861,177.0553021050138,199.202857751564,189.67,189.67,189.67,7075411,6580401.666666667,32.72270101468233,27.488685575904725,NaN,NaN,NaN,NaN,5.618794854795834,42.327530275015754,1027373081,0.5844017028860726,-9.975222050743525,-10.559623753629598
2024-01-31T13:30:00-05:00,191.31,193.97,187.13,187.23,NaN,NaN,NaN,200.17236813747633,NaN,NaN,222.44039999999998,269.4899440505002,175.39085594949975,181.5198154419408,189.57173417967823,189.68406144480028,189.45940691455618,5414848,6657634.766666667,29.575221508710243,27.522898104231984,NaN,NaN,NaN,NaN,5.70602379373899,40.75062167237009,1021958233,0.6308556121945141,-9.771054238386455,-10.401909850580969
2024-02-01T09:30:00-05:00,188.41,189.88,184.28,187.185,NaN,NaN,NaN,200.17236813747633,NaN,NaN,221.02969999999996,267.9931191860004,174.06628081399953,181.5198154419408,187.11500000000004,187.11500000000004,187.11500000000004,7548019,6654565.7,29.541470798597658,27.5785039529651,NaN,NaN,NaN,NaN,5.698450665614777,39.622264776471674,1014410214,0.7188619606427586,-9.50333239977752,-10.222194360420279
2024-02-01T13:30:00-05:00,187.2,189.02,186.9,188.82,NaN,NaN,NaN,200.17236813747633,NaN,NaN,219.67249999999996,266.35779152741804,172.98720847258187,181.5198154419408,187.43595867808676,187.94606039768527,186.92585695848825,2988255,6652290.466666667,32.55313537632199,27.730898471386702,NaN,NaN,NaN,NaN,5.442847046642293,38.57450480170886,1017398469,0.9338743781246226,-9.0548513877645,-9.988725765889123
2024-02-02T09:30:00-05:00,185.08,186.81,182,185.27,NaN,NaN,NaN,200.17236813747633,NaN,NaN,218.12109999999996,264.1156322093838,172.1265677906161,181.5198154419408,184.69333333333336,184.69333333333336,184.69333333333336,9730676,6675253.566666666,29.595194396736446,27.43087091512471,NaN,NaN,NaN,NaN,5.541215114739272,38.16557730541209,1007667793,0.8841973574390369,-8.883479069090328,-9.767676426529365
2024-02-02T13:30:00-05:00,185.29,188.68,184.77,187.87,NaN,NaN,NaN,200.17236813747633,NaN,NaN,216.64949999999996,261.7033944487602,171.59560555123971,181.5198154419408,185.45102103329873,186.57104885968965,184.3309932069078,4453135,6700529.533333333,34.30353993158489,27.677041895824658,NaN,NaN,NaN,NaN,5.424699749400752,37.39253632258066,1012120928,1.0616856441546823,-8.44056937133601,-9.502255015490693
2024-02-05T09:30:00-05:00,184.33,184.68,175.01,181.31,NaN,NaN,NaN,197.33197520911602,NaN,NaN,215.14169999999996,259.77740967779096,170.50599032220893,181.5198154419408,180.33333333333334,180.33333524068198,180.3333314259847,12289129,6769117.1,29.02870513656464,28.51592206512364,NaN,NaN,NaN,NaN,5.955792624443556,37.655341868094425,999831799,0.7852629184411768,-8.520676367439222,-9.305939285880399
2024-02-05T13:30:00-05:00,181.38,182.33,179.29,181.01,NaN,NaN,NaN,197.33197520911602,NaN,NaN,213.70149999999998,258.00123432200246,169.4017656779975,181.5198154419408,180.44854002994305,180.67062797543542,180.22645208445067,3306942,6764016.933333334,28.810521018638823,29.271736271874026,NaN,NaN,NaN,NaN,5.74752172269759,37.89937558892863,996524857,0.6365369023686185,-8.510268157919626,-9.146805060288244
2024-02-06T09:30:00-05:00,177.29,186.49,177.14,182.73,NaN,NaN,NaN,197.33197520911602,NaN,NaN,212.35969999999998,256.2645946433089,168.45480535669108,180.1569455062737,182.12,182.12,182.12,11224438,6810076.766666667,31.967722901884244,30.146704135550557,NaN,NaN,NaN,NaN,6.004841599647763,37.265183483476214,1007749295,0.7031060580762407,-8.267922487692942,-8.971028545769183
2024-02-06T13:30:00-05:00,182.74,185.76,182.36,185.07,NaN,NaN,NaN,197.33197520911602,NaN,NaN,211.0911,254.40727371329115,167.77492628670888,180.1569455062737,182.68669603528946,183.6710910663929,181.702301004186,3719856,6837475.633333334,36.11853882341747,31.326252894665974,NaN,NaN,NaN,NaN,5.818781485387207,36.67629081412755,1011469151,0.9390928219894565,-7.797162518282363,-8.73625534027182
2024-02-07T09:30:00-05:00,188.13,189.44,182.68,189.2,NaN,NaN,NaN,197.33197520911602,NaN,NaN,209.90829999999997,252.3115312264067,167.50506877359325,180.1569455062737,187.10666666666665,187.10666666666665,187.10666666666665,10021254,6902610.666666667,42.75689467839272,32.493222816315416,NaN,NaN,NaN,NaN,5.886011379288121,35.38685887405343,1021490405,1.3809896801808303,-7.010018240045781,-8.391007920226611
2024-02-07T13:30:00-05:00,189.21,189.79,187.4,187.66,NaN,NaN,NaN,197.33197520911602,NaN,NaN,208.69349999999997,250.08433392491725,167.3026660750827,176.87964512401518,187.41634981242902,187.93451019693308,186.89818942792496,3579553,6909987.833333333,41.04415121149822,33.16253029111666,NaN,NaN,NaN,NaN,5.63629628076754,34.12016969798899,1017910852,1.5637883241451949,-6.436272515045118,-8.000060839190313
2024-02-08T09:30:00-05:00,188.84,191.61,185.58,188.91,NaN,NaN,NaN,197.33197520911602,NaN,NaN,207.6685,248.42507410774436,166.91192589225562,177.8953133498316,188.70000000000002,188.70000000000002,188.70000000000002,7424628,6842494.9,43.03867944486339,33.85704259215199,NaN,NaN,NaN,NaN,5.66441797499843,32.94395832021487,1025335480,1.7490937121603007,-5.813693698989937,-7.562787411150238
2024-02-08T13:30:00-05:00,188.9,190.21,188.69,189.52,NaN,NaN,NaN,197.33197520911602,NaN,NaN,206.69029999999998,246.7891614007944,166.59143859920556,178.47825067986528,188.8893846395899,189.22193676018304,188.55683251899677,2407935,6815243.866666666,44.03372778120084,34.649300287363864,NaN,NaN,NaN,NaN,5.3683881196414,31.851762040853178,1027743415,1.8814264209217173,-5.211004384998091,-7.0924308059198085
2024-02-09T09:30:00-05:00,190.22,194.12,189.48,193.14,NaN,NaN,NaN,197.33197520911602,NaN,NaN,205.72990000000001,244.76661663908277,166.69318336091726,182.41460054389222,192.24666666666667,192.24666666666667,192.24666666666667,8501442,6809795.366666666,49.65440942334618,35.85870803083986,NaN,NaN,NaN,NaN,5.3163603968098725,29.976129684296183,1036244857,2.161422798019979,-4.390652308394834,-6.552075106414813
2024-02-09T13:30:00-05:00,193.13,193.71,192.19,193.57,NaN,NaN,NaN,197.33197520911602,NaN,NaN,204.84290000000001,242.9171829264067,166.76861707359333,183.58568043511377,192.4690907910738,192.86015787238642,192.07802370976117,2750134,6773361.1,50.293003226260055,37.338549582093414,NaN,NaN,NaN,NaN,5.045191797037739,28.23447106749326,1038994991,2.3107893616056643,-3.663588404407733,-5.974377766013397
2024-02-12T09:30:00-05:00,192.11,194.72,187.7,188.79,NaN,NaN,NaN,197.33197520911602,NaN,NaN,203.8623,241.00286048096308,166.72173951903693,183.58568043511377,190.4033333333333,190.4033333333333,190.4033333333333,8111267,6725754.5,43.66290435296374,38.34722340740528,NaN,NaN,NaN,NaN,5.186249525820758,27.427231858628925,1030883724,2.032692861852257,-3.4335116886980757,-5.466204550550333
2024-02-12T13:30:00-05:00,188.78,189.1,187.29,187.96,NaN,NaN,NaN,197.33197520911602,NaN,NaN,202.87329999999997,239.00782014957593,166.738779850424,183.58568043511377,189.80297096785506,190.80914870521613,188.796793230494,2887794,6703175.9,42.612434340825544,39.06574476201268,NaN,NaN,NaN,NaN,4.94508884540499,26.74692154981479,1027995930,1.7486959272594635,-3.280334641476003,-5.029030568735466
2024-02-13T09:30:00-05:00,183.99,187.26,183.07,184.37,NaN,NaN,NaN,197.33197520911602,NaN,NaN,201.78209999999996,236.772435756608,166.79176424339192,183.58568043511377,184.9,184.9,184.9,6713112,6663204.2,38.318276133791336,39.68882202894516,NaN,NaN,NaN,NaN,4.941153927876063,26.787100896712555,1021282818,1.295765919134011,-3.4093231698179522,-4.705089088951963
2024-02-13T13:30:00-05:00,184.35,184.51,182.11,184.04,NaN,NaN,NaN,197.33197520911602,NaN,NaN,200.65369999999996,234.1907634260087,167.11663657399123,183.58568043511377,184.4817284145357,185.10488271529945,183.85857411377194,3024471,6666146.866666666,37.93979792137955,39.948554742501926,NaN,NaN,NaN,NaN,4.759642933027771,26.96617657650317,1018258347,0.9657875441624455,-3.4978546587489063,-4.463642202911352
2024-02-14T09:30:00-05:00,185.3,187.06,183.35,186.2,NaN,NaN,NaN,197.33197520911602,NaN,NaN,199.69429999999997,232.06555570687914,167.3230442931208,183.58568043511377,185.53666666666663,185.53666666666663,185.53666666666663,6175183,6637309.033333333,41.979426473615824,40.87360626657702,NaN,NaN,NaN,NaN,4.684668437811502,26.463398853795855,1024433530,0.886875640296279,-3.3550476525410033,-4.241923292837282
2024-02-14T13:30:00-05:00,186.21,188.89,185.94,188.72,NaN,NaN,NaN,197.33197520911602,NaN,NaN,198.77129999999994,229.67662173008637,167.8659782699135,183.58568043511377,186.2706088354172,187.34726187917417,185.19395579166022,2869604,6598313.2,46.36576187166443,42.12755204179313,NaN,NaN,NaN,NaN,4.560763549396394,25.54233982150092,1027303134,0.9904170189432171,-3.003902019158261,-3.994319038101478
2024-02-15T09:30:00-05:00,189.19,198.34,188.84,198.11,178.28226841212998,178.28226841212998,178.28226841212998,NaN,NaN,NaN,198.06449999999998,227.3384927751596,168.79050722484035,186.20702845758598,195.09666666666666,195.09666666666666,195.09666666666666,9174140,6235912.533333333,58.84950045549783,44.047679009908386,NaN,NaN,NaN,NaN,4.9221375815823665,24.595945757707018,1036477274,1.6390587598996245,-1.9454955882269473,-3.584554348126572
2024-02-15T13:30:00-05:00,198.12,200.88,197.04,200.49,183.82443802976042,NaN,NaN,NaN,NaN,NaN,197.39509999999996,224.82803564240157,169.96216435759834,189.25362276606876,196.52400488620498,198.57459782984338,194.47341194256657,4444882,6178069.2,61.30773198896918,45.84690709316208,NaN,NaN,NaN,NaN,4.844842040040769,24.10455619846117,1040922156,2.1442584058889667,-0.9042313407653637,-3.0484897466543304
2024-02-16T09:30:00-05:00,202.08,203.17,197.4,199.41,185.05059993749862,NaN,NaN,NaN,NaN,NaN,196.85049999999995,222.99018731641877,170.71081268358114,190.98389821285502,199.99333333333334,199.99333333333334,199.99333333333334,9123091,6133274.533333333,59.568740046124105,47.04775319085718,NaN,NaN,NaN,NaN,4.9109247514664265,23.981160521835392,1031799065,2.307371609987539,-0.16427523416990653,-2.4716468441574455
2024-02-16T13:30:00-05:00,199.41,201.36,198.77,199.96,185.1698908494305,NaN,NaN,NaN,NaN,NaN,196.30569999999997,220.98731607432003,171.6240839256799,190.98389821285502,200.00274533361545,200.01876160459503,199.98672906263587,3150526,6113451.433333334,60.188065904826324,48.415175668952045,NaN,NaN,NaN,NaN,4.745144412075967,23.866578822111457,1034949591,2.3462848213243417,0.4612091824979814,-1.88507563882636
2024-02-20T09:30:00-05:00,196.13,198.58,189.13,190.55,185.1698908494305,NaN,NaN,NaN,NaN,NaN,195.73129999999998,219.57084595289314,171.89175404710682,190.98389821285502,192.75333333333333,192.75333333333333,192.75333333333333,8347951,6053248.433333334,46.93990101473009,48.693834352513946,NaN,NaN,NaN,NaN,5.179776954070541,22.45701041804935,1026601640,1.664340399176111,0.19534986014377864,-1.4689905390323323
2024-02-20T13:30:00-05:00,190.52,193.86,189.95,193.77,185.1698908494305,NaN,NaN,NaN,NaN,NaN,195.23089999999996,218.14582515283692,172.315974847163,190.98389821285502,192.6937114740014,192.79350887882242,192.59391406918036,2979562,6030167.433333334,50.92090671416746,49.18577570486871,NaN,NaN,NaN,NaN,5.089078600208361,21.14812547142025,1029581202,1.3685487567471788,0.24169540690164126,-1.1268533498455375
2024-02-21T09:30:00-05:00,193.29,199.44,191.95,192.83,185.1698908494305,NaN,NaN,NaN,NaN,NaN,194.6633,216.34908267990525,172.97751732009473,190.98389821285502,194.74,194.74,194.74,8466229,6003533.733333333,49.747489176034335,49.19242425863215,NaN,NaN,NaN,NaN,5.260572985907764,20.28668758976914,1021114973,1.0616954013654134,0.20026590186122917,-0.8614294995041842
2024-02-21T13:30:00-05:00,192.81,194.86,192.3,194.84,185.1698908494305,NaN,NaN,NaN,NaN,NaN,194.16049999999998,214.6052942762961,173.71570572370388,190.98389821285502,194.5583689359465,194.8768295205836,194.2399083513094,2753968,6021914.5,52.27976997720716,49.33433616941409,NaN,NaN,NaN,NaN,5.067674915485782,19.486780985378825,1023868941,0.9498368282295255,0.3258665357827226,-0.6239702924468029
2024-02-22T09:30:00-05:00,194.01,197.4,191.37,197.27,185.1698908494305,NaN,NaN,NaN,NaN,NaN,193.8499,213.61306690108333,174.08673309891665,190.98389821285502,195.34666666666666,195.34666666666666,195.34666666666666,7847977,6047666.7,55.21778852127307,50.15968503857904,NaN,NaN,NaN,NaN,5.136412421522512,19.151909510450448,1031716918,0.9906995667096142,0.6144041659402149,-0.3762954007693994
2024-02-22T13:30:00-05:00,197.28,198.31,196.51,197.37,185.1698908494305,NaN,NaN,NaN,NaN,NaN,193.4861,212.28339707059177,174.6888029294082,190.98389821285502,195.91718906217233,196.83592466452495,194.9984534598197,3026370,5968050.766666667,55.339646108290324,51.068771593397955,NaN,NaN,NaN,NaN,4.898097248556619,18.98496015367994,1034743288,0.9741898109279125,0.8414418628904912,-0.1327479480374213
2024-02-23T09:30:00-05:00,195.37,197.57,192.72,193.97,185.1698908494305,NaN,NaN,NaN,NaN,NaN,193.17970000000003,211.42800199333718,174.93139800666287,190.98389821285502,194.75333333333333,194.75333333333333,194.75333333333333,6668776,5938742.666666667,50.32548160881213,51.92642912732801,NaN,NaN,NaN,NaN,4.894661730802574,18.029368593950284,1028074512,0.6970033569127183,0.7385062481034765,0.041502891190758284
2024-02-23T13:30:00-05:00,193.97,194.09,191.72,191.91,185.1698908494305,NaN,NaN,NaN,NaN,NaN,192.78150000000002,210.23711173376785,175.3258882662322,190.98389821285502,194.123016890685,195.11134427930878,193.1346895020612,2712450,5929549.166666667,47.5163122999587,52.61046586865509,NaN,NaN,NaN,NaN,4.714328750030963,16.941837400380848,1025362062,0.35488742841601045,0.48511217671077134,0.13022474829476088
2024-02-26T09:30:00-05:00,192.28,201.78,192,199.23,185.1698908494305,NaN,NaN,NaN,NaN,NaN,192.55270000000002,209.35197858094048,175.75342141905955,190.31611857028403,197.67,197.67,197.67,9493713,5921650.4,56.754020810707,53.66579403559018,NaN,NaN,NaN,NaN,5.082590982171609,17.1829367100828,1034855775,0.5878100718727783,0.8649873381357338,0.27717726626295547
2024-02-26T13:30:00-05:00,199.25,200,198.53,199.38,185.1698908494305,NaN,NaN,NaN,NaN,NaN,192.29739999999998,208.26534767526854,176.32945232473142,188.59886574704169,197.98335197059012,198.62648396415278,197.34021997702746,2253724,5848336.7,56.921348138987604,54.419764483256124,NaN,NaN,NaN,NaN,4.8245487691593505,17.406814640520324,1037109499,0.7100331743969471,1.1647187342591394,0.4546855598621923
2024-02-27T09:30:00-05:00,204.07,205.6,198.34,198.61,186.75229321633657,NaN,NaN,NaN,NaN,NaN,192.1134,207.5657972819773,176.66100271802273,192.84909259763336,200.85,200.85,200.85,8138444,5709980.533333333,55.72931320752082,54.19689396554348,NaN,NaN,NaN,NaN,4.998509571362254,18.366440629802554,1028971055,0.6961342523310289,1.3248533752759784,0.6287191229449495
2024-02-27T13:30:00-05:00,198.6,200.91,198.26,199.71,186.75229321633657,NaN,NaN,NaN,NaN,NaN,191.93259999999998,206.80271691144733,177.06248308855263,192.84909259763336,200.51169240902172,201.058876954534,199.96450786350943,3110980,5703448.466666667,57.11111331148183,53.8971354885801,NaN,NaN,NaN,NaN,4.830758887693522,19.238569965139213,1032082035,0.7153976873999178,1.5229662321948467,0.8075685447949289
2024-02-28T09:30:00-05:00,200.42,205.3,198.45,202.81,186.75229321633657,NaN,NaN,NaN,NaN,NaN,191.82240000000002,206.2810817158439,177.36371828415614,192.84909259763336,202.18666666666664,202.18666666666664,202.18666666666664,8240689,5603990.166666667,60.82236860029622,53.98668038530668,NaN,NaN,NaN,NaN,4.974990395715415,20.57906870598611,1040322724,0.8804416159573436,1.9081205647416084,1.0276789487842648
2024-02-28T13:30:00-05:00,202.81,203.73,201.3,202.14,187.72728469914472,NaN,NaN,NaN,NaN,NaN,191.68220000000002,205.59160058521826,177.7727994147818,192.84909259763336,202.2335392442317,202.31917637938304,202.14790210908038,2468749,5562286.6,59.62155080023043,53.946215020692684,NaN,NaN,NaN,NaN,4.793205367450027,21.823817536772523,1037853975,0.885606761008346,2.1346874000446974,1.2490806390363514
2024-02-29T09:30:00-05:00,204.19,205.28,198.45,200.61,187.72728469914472,NaN,NaN,NaN,NaN,NaN,191.47760000000002,204.52822163117375,178.4269783688263,192.84909259763336,201.4466666666667,201.4466666666667,201.4466666666667,7316189,5472117.766666667,56.860794794905814,54.654850290705234,NaN,NaN,NaN,NaN,4.938690698346455,22.244627525563068,1030537786,0.733390548654369,2.1658188248543127,1.4324282761999436
2024-02-29T13:30:00-05:00,200.62,202.19,199.84,201.8,187.72728469914472,NaN,NaN,NaN,NaN,NaN,191.3584,203.91135669394876,178.80544330605122,192.84909259763336,201.40302878497883,201.47728627724842,201.32877129270923,2526572,5437018.4,58.471482698234674,55.19417714671003,NaN,NaN,NaN,NaN,4.753784219893136,22.63537965801143,1033064358,0.6624226760134655,2.2604566212167754,1.5980339452033099
2024-03-01T09:30:00-05:00,200.5,204.42,198.5,204.27,187.72728469914472,NaN,NaN,NaN,NaN,NaN,191.8052,204.57247754222143,179.0379224577786,192.84909259763336,202.39666666666665,202.39666936406496,202.39666396926833,7208385,5429810.3,61.670435399789504,56.04581616269255,NaN,NaN,NaN,NaN,4.837085347043626,23.325447827924116,1040272743,0.7262767562291532,2.5058798904897515,1.7796031342605982
2024-03-01T13:30:00-05:00,204.27,204.51,202.47,202.66,189.06234372043562,NaN,NaN,NaN,NaN,NaN,192.20719999999997,205.05029918361313,179.3641008163868,193.9801521039312,202.63843345024014,203.0112493506759,202.26561754980438,3031394,5450592.266666667,58.506835120583744,56.49060653007659,NaN,NaN,NaN,NaN,4.6372935365405095,23.979509804768053,1037241349,0.6092558881471055,2.54117299444448,1.9319171062973746
2024-03-04T09:30:00-05:00,198.71,199.75,186.85,187.35,NaN,NaN,NaN,207.41965523843214,207.41965523843214,207.41965523843214,192.284,204.96302567235077,179.60497432764922,193.9801521039312,191.3166666666667,191.3166666666667,191.3166666666667,11711410,5557591.2,38.356643371267964,55.286239019361936,NaN,NaN,NaN,NaN,5.4353439982161875,23.156842922822474,1025529939,-0.49069007783610763,1.3185545090022401,1.8092445868383478
2024-03-04T13:30:00-05:00,187.35,190.14,186.72,188.13,NaN,NaN,NaN,204.10013722993367,NaN,NaN,192.382,204.85363742257334,179.91036257742667,193.9801521039312,190.5340872543048,191.84743157635708,189.22074293225253,4158233,5604527.833333333,39.49987167611225,54.15482655992065,NaN,NaN,NaN,NaN,5.291390855486459,22.411892565875853,1029688172,-1.1211088748788722,0.40785849323975754,1.5289673681186298
2024-03-05T09:30:00-05:00,183.085,184.59,177.57,180.65,NaN,NaN,NaN,197.47785826493666,NaN,NaN,192.24660000000003,205.07274040777975,179.4204595922203,193.9801521039312,180.93666666666664,180.93666666666664,180.93666666666664,9836192,5662025.333333333,33.150528211132865,52.92804417437213,NaN,NaN,NaN,NaN,5.667720080094569,22.88490028086549,1019851980,-1.948768212854976,-0.9069928979500901,1.0417753149048858
2024-03-05T13:30:00-05:00,180.63,181.9,179.26,180.84,NaN,NaN,NaN,196.5925010710759,NaN,NaN,192.04440000000002,205.25881207773105,178.829987922269,193.9801521039312,180.86388192326046,180.9836911960492,180.74407265047174,3630169,5686771.166666667,33.44318751626653,51.92282097553698,NaN,NaN,NaN,NaN,5.451454360087816,23.324121730498725,1023482149,-2.3627437121310693,-1.9116543252589508,0.4510893868721185
2024-03-06T09:30:00-05:00,180,181.55,173.71,179.88,NaN,NaN,NaN,193.98375102239063,NaN,NaN,191.80040000000005,205.4466541145937,178.1541458854064,193.9801521039312,178.38,178.38,178.38,8600222,5749674.833333333,32.665061120697814,50.20218099767918,NaN,NaN,NaN,NaN,5.6220647629386855,24.320834191569126,1014881927,-2.5637340585000787,-2.7535781862529802,-0.18984412775290127
2024-03-06T13:30:00-05:00,179.9,180.07,176.19,176.51,NaN,NaN,NaN,193.98375102239063,NaN,NaN,191.49890000000002,205.801229780848,177.19657021915205,193.9801521039312,178.14425229428744,178.50572664577425,177.78277794280064,3658050,5770794.133333334,30.024134513636795,48.28095145301126,NaN,NaN,NaN,NaN,5.497631565585921,25.246352905420217,1011223877,-2.768650492448709,-3.6506572433137876,-0.8820067508650785
2024-03-07T09:30:00-05:00,174.28,179.78,173.71,179,NaN,NaN,NaN,192.97860372081462,NaN,NaN,191.25270000000003,205.97713971226327,176.5282602877368,193.9801521039312,177.49666666666667,177.49666666666667,177.49666666666667,7839305,5826264.866666666,34.25372333396977,46.74698074775762,NaN,NaN,NaN,NaN,5.538515025186927,26.36016646247013,1019063182,-2.5850038394711494,-4.113261550204015,-1.5282577107328659
2024-03-07T13:30:00-05:00,179.02,180.04,178.22,178.57,NaN,NaN,NaN,192.97860372081462,NaN,NaN,191.07950000000005,206.1878630152322,175.9711369847679,193.9801521039312,177.91050074612085,178.56427541904867,177.25672607319302,3141043,5835312.833333333,33.87295853385531,45.08711254935572,NaN,NaN,NaN,NaN,5.272906809102146,27.33033642434592,1015922139,-2.3478962640418617,-4.463128040785193,-2.1152317767433315
2024-03-08T09:30:00-05:00,181.51,182.72,174.7,176.1,NaN,NaN,NaN,192.97860372081462,NaN,NaN,190.85780000000003,206.50399738594933,175.21160261405072,193.9801521039312,177.84,177.84,177.84,7633093,5783944.6,31.693576159114087,43.006484517842715,NaN,NaN,NaN,NaN,5.469127751309137,28.595780581901035,1008289046,-2.214546692707413,-4.883415142627598,-2.668868449920185
2024-03-08T13:30:00-05:00,176.05,176.8,174.9,175.34,NaN,NaN,NaN,191.49817656446885,NaN,NaN,190.58820000000003,206.8191801010311,174.35721989896896,183.42112168314497,177.26313809589197,178.21878031788526,176.3074958738987,2781337,5728493.1,31.031982777819152,40.96437251624191,NaN,NaN,NaN,NaN,5.214190054787056,29.770835871059365,1005507709,-2.0390454280944805,-5.217675235038286,-3.178629806943805
2024-03-11T09:30:00-04:00,175.445,182.87,174.8,178.93,NaN,NaN,NaN,191.49817656446885,NaN,NaN,190.46140000000003,206.9535445591555,173.96925544084456,175.36689734651597,178.86666666666667,178.86666666666667,178.86666666666667,8025094,5691893.2,37.652673227751634,39.592363832873765,NaN,NaN,NaN,NaN,5.418176479445123,29.35685523358667,1013532803,-1.5640701304477473,-5.133717470003489,-3.569647339555742
2024-03-11T13:30:00-04:00,178.94,179.58,176.51,177.78,NaN,NaN,NaN,191.49817656446885,NaN,NaN,190.25960000000003,207.1165316116568,173.40266838834327,168.9907669775386,178.66422294690054,179.04269398319386,178.28575191060722,2296114,5663412.8,36.44572077644036,38.019095124174164,NaN,NaN,NaN,NaN,5.250449588056187,28.972444641647737,1011236689,-1.2252201949232253,-5.101172583209774,-3.8759523882865485
2024-03-12T09:30:00-04:00,177.77,179.08,172.41,178.12,NaN,NaN,NaN,191.49817656446885,NaN,NaN,190.19580000000005,207.21114088521458,173.18045911478552,168.9907669775386,176.53666666666666,176.53666666666666,176.53666666666666,8976552,5684366.166666667,37.08780930967307,36.26319326059442,NaN,NaN,NaN,NaN,5.351846046052175,29.1703362317761,1020213241,-0.8915732289844991,-4.990418924517172,-4.098845695532673
2024-03-12T13:30:00-04:00,178.11,179.42,177.35,177.51,NaN,NaN,NaN,191.49817656446885,NaN,NaN,190.12580000000005,207.31958589607459,172.93201410392552,168.9907669775386,176.83024593303193,177.43919278812433,176.22129907793953,2086419,5654594.733333333,36.37770681848272,34.68254123901578,NaN,NaN,NaN,NaN,5.117428471334162,29.269002914376372,1018126822,-0.6372724137550456,-4.89543621272648,-4.2581637989714345
2024-03-13T09:30:00-04:00,173.12,176.05,170.6,171.76,NaN,NaN,NaN,189.0438812443581,NaN,NaN,189.90640000000002,207.7401351152282,172.07266488477183,168.9907669775386,172.8033333333333,172.8033333333333,172.8033333333333,8053769,5640846.066666666,30.457843280525893,34.118341232534206,NaN,NaN,NaN,NaN,5.2454692948102934,30.164264331896813,1010073053,-0.7726054168311665,-5.223920570010392,-4.451315153179226
2024-03-13T13:30:00-04:00,171.76,172.03,169.15,169.49,NaN,NaN,NaN,185.9871139150691,NaN,NaN,189.59480000000008,208.27978915814595,170.9098108418542,168.9907669775386,171.95775083209296,173.1687805950601,170.7467210691258,3926463,5679929.233333333,28.486941861048038,33.33170338860105,NaN,NaN,NaN,NaN,5.076507202323844,31.14574536004412,1006146590,-0.9212125749989104,-5.602830871927864,-4.681618296928954
2024-03-14T09:30:00-04:00,167.64,171.17,161.88,162.09,NaN,NaN,NaN,182.48906328256595,NaN,NaN,189.05260000000007,209.2630316866326,168.84216831336755,168.9907669775386,165.04666666666665,165.04666666666665,165.04666666666665,10179214,5757637.133333334,23.213472650766434,32.62191370571772,NaN,NaN,NaN,NaN,5.377470973586426,32.711093078710725,995967376,-1.3956344692061684,-6.426161383436664,-5.030526914230496
2024-03-14T13:30:00-04:00,162.08,163.53,160.51,162.51,NaN,NaN,NaN,177.6702422242675,NaN,NaN,188.54960000000005,210.08225277108426,167.01694722891585,168.9907669775386,164.1756400339332,165.49296770645807,162.85831236140834,4450302,5805101.533333333,24.072587918356277,31.952585163009854,NaN,NaN,NaN,NaN,5.209080189758825,34.27212601828696,1000417678,-1.5471656839260133,-6.964484019138013,-5.417318335211999
2024-03-15T09:30:00-04:00,163.14,165.18,160.76,161.97,NaN,NaN,NaN,177.6702422242675,NaN,NaN,188.01080000000005,210.79240515503864,165.22919484496146,168.9907669775386,162.63666666666666,162.63666666666666,162.63666666666666,6723996,5806942.2,23.705354648414087,31.312606129275302,NaN,NaN,NaN,NaN,5.152717319061766,35.28087821110635,993693682,-1.5461104132179138,-7.3499563517343915,-5.803845938516478
2024-03-15T13:30:00-04:00,161.95,163.9,161.91,163.56,NaN,NaN,NaN,177.6702422242675,NaN,NaN,187.49160000000006,211.2732814746154,163.70991852538472,168.9907669775386,162.77916046232102,163.00061587262908,162.55770505201295,2783856,5809322.4,27.225700404238324,31.11271797860399,NaN,NaN,NaN,NaN,4.926808939128784,36.21757667586721,996477538,-1.3100166862599254,-7.441366796341384,-6.131350110081459
2024-03-18T09:30:00-04:00,170.05,174.72,165.9,172.83,NaN,NaN,NaN,177.6702422242675,NaN,NaN,187.08540000000005,211.1593076047089,163.01149239529119,167.62843269249976,171.15,171.15,171.15,9775828,5818726.233333333,43.57298523865897,31.778379543224645,NaN,NaN,NaN,NaN,5.372036872048156,34.61858271180723,1006253366,-0.4458763805328747,-6.688695585747553,-6.242819205214678
2024-03-18T13:30:00-04:00,172.83,174.4,172.03,173.88,NaN,NaN,NaN,177.6702422242675,NaN,NaN,186.69160000000008,210.97161889949882,162.41158110050134,167.62843269249976,171.6593405274273,172.61079427468647,170.70788678016814,2801526,5836986.3,45.07789013881001,32.57873180072141,NaN,NaN,NaN,NaN,5.157605666901859,33.13380260232296,1009054892,0.24304673661369414,-5.939010784447561,-6.182057521061255
2024-03-19T09:30:00-04:00,172.3,172.8,167.42,171.72,NaN,NaN,NaN,177.6702422242675,NaN,NaN,186.3502000000001,210.98011562795236,161.72028437204781,167.62843269249976,170.64666666666668,170.64666666666668,170.64666666666668,6360959,5777736.8,42.5630856766972,33.35512533769163,NaN,NaN,NaN,NaN,5.250633833551727,32.390330237218336,1002693933,0.5806239727559968,-5.456277555116259,-6.0369015278722555
2024-03-19T13:30:00-04:00,171.74,172.2,170.55,171.31,NaN,NaN,NaN,177.6702422242675,NaN,NaN,186.0172000000001,210.99876281420464,161.03563718579554,163.16174615399981,170.81643031636878,171.1183352942786,170.51452533845895,2011275,5741079.966666667,42.083171157829696,34.14449593626381,NaN,NaN,NaN,NaN,4.993445702583744,31.699963041049756,1000682658,0.7906456130459869,-5.048594511564772,-5.839240124610759
2024-03-20T09:30:00-04:00,173.02,174.32,170.82,172.95,NaN,NaN,NaN,177.6702422242675,NaN,NaN,185.7888000000001,211.03385674859982,160.54374325140037,163.37202127720207,172.69666666666663,172.69666666666663,172.69666666666663,6120240,5670398.333333333,44.7659351213655,34.65258607152194,NaN,NaN,NaN,NaN,4.886771009542048,30.60154092243882,1006802898,1.038732365132903,-4.540824668194631,-5.579557033327534
2024-03-20T13:30:00-04:00,172.94,176.25,172.49,175.73,NaN,NaN,NaN,177.6702422242675,NaN,NaN,185.6226000000001,211.02047575684335,160.22472424315683,165.61161702176167,173.60660420695137,174.65881497882648,172.55439343507626,4577055,5740675.2,49.07235996495223,35.554488870701356,NaN,NaN,NaN,NaN,4.80628736600333,29.17724979082464,1011379953,1.3680571299401105,-3.8694856209023953,-5.237542750842506
2024-03-21T09:30:00-04:00,176.39,178.17,172.83,173.36,160.6053165130901,160.6053165130901,160.6053165130901,NaN,NaN,NaN,185.3658000000001,210.99374071789677,159.73785928210341,166.98929361740934,174.78666666666666,174.7866685740153,174.78666475931803,6381057,5709504.133333334,45.794351904783866,36.17638477035213,NaN,NaN,NaN,NaN,4.844409697003091,27.463019429824666,1004998896,1.3992575113343593,-3.488470861674557,-4.887728373008916
2024-03-21T13:30:00-04:00,173.36,173.58,171.8,172.83,160.6053165130901,NaN,NaN,NaN,NaN,NaN,185.04800000000006,210.89483748546564,159.20116251453447,166.98929361740934,174.25500010891253,175.15346942656376,173.3565307912613,2234420,5699765.733333333,45.06930493787657,36.79721320745169,NaN,NaN,NaN,NaN,4.625523290074299,26.059729333956977,1002764476,1.3561990398010302,-3.1924795732576285,-4.548678613058659
2024-03-22T09:30:00-04:00,166.67,170.74,166.29,170.4,160.6053165130901,NaN,NaN,NaN,NaN,NaN,184.49380000000008,210.38484675829162,158.60275324170854,166.98929361740934,169.14333333333332,169.14333333333332,169.14333333333332,6552393,5677899.333333333,41.801464743642434,37.607471883388584,NaN,NaN,NaN,NaN,4.762271626497565,25.666502563347414,996212083,1.1445091409181742,-3.118042186910941,-4.262551327829115
2024-03-22T13:30:00-04:00,170.38,171.2,170.11,170.74,160.6053165130901,NaN,NaN,NaN,NaN,NaN,183.89880000000008,209.65910454478444,158.13849545521572,166.98929361740934,169.51237978001492,170.16975048827663,168.85500907175322,2065101,5645689.566666666,42.430435166456235,38.60343569091774,NaN,NaN,NaN,NaN,4.499966510319166,25.195700905043573,998277184,1.0123878255390881,-2.9970665459052555,-4.009454371444344
2024-03-25T09:30:00-04:00,168.79,175.22,168.74,172.28,160.6053165130901,NaN,NaN,NaN,NaN,NaN,183.3562000000001,208.92898956703846,157.78341043296172,166.98929361740934,172.08000000000004,172.08000000000004,172.08000000000004,6887135,5484880.4,45.313313196453734,40.1819957298954,NaN,NaN,NaN,NaN,4.641397473867796,23.877988412512583,1005164319,1.0113383344145817,-2.7452814534261165,-3.756619787840698
2024-03-25T13:30:00-04:00,172.29,173.71,171.89,172.65,160.6053165130901,NaN,NaN,NaN,NaN,NaN,182.81000000000006,208.10603036051467,157.51396963948545,166.98929361740934,172.23518328708474,172.5178331583981,171.95253341577137,2076017,5415473.2,46.012816356181226,41.74915490402576,NaN,NaN,NaN,NaN,4.439869082877241,22.654398240876667,1007240336,1.0155254282050974,-2.487213002584326,-3.5027384307894236
2024-03-26T09:30:00-04:00,178.6,184.25,177.67,179.3,166.00705718982599,NaN,NaN,NaN,NaN,NaN,182.58500000000006,207.8016542586455,157.36834574135463,170.80737770604216,180.40666666666667,180.4066685740153,180.40666475931803,11914925,5484764.3,56.72641847871318,44.10780232047569,NaN,NaN,NaN,NaN,4.951307005528866,22.379860829236517,1019155261,1.4212355584998613,-1.7261939826645971,-3.1474295411644584
2024-03-26T13:30:00-04:00,179.32,179.88,177.37,177.7,166.00705718982599,NaN,NaN,NaN,NaN,NaN,182.26360000000008,207.31089885955922,157.21630114044095,170.80737770604216,180.04053868563452,180.83499307820023,179.2460842930688,2530575,5448111.166666667,53.95222211106522,46.01683958524904,NaN,NaN,NaN,NaN,4.776927933705375,22.06310366320622,1016624686,1.5276095440274293,-1.2379176111301717,-2.765527155157601
2024-03-27T09:30:00-04:00,181.41,181.92,176.01,179.86,166.00705718982599,NaN,NaN,NaN,NaN,NaN,182.00420000000005,206.87643965468476,157.13196034531535,170.80737770604216,179.26333333333332,179.26333524068195,179.2633314259847,6959201,5393410.466666667,57.008894533755495,46.976547392041645,NaN,NaN,NaN,NaN,4.857861652726419,22.06583989390098,1023583887,1.6772618178236387,-0.6689498828780529,-2.3462117007016916
2024-03-27T13:30:00-04:00,179.88,180.79,179.14,179.87,166.00705718982599,NaN,NaN,NaN,NaN,NaN,181.70480000000006,206.31076488333844,157.0988351166617,170.80737770604216,179.41011578755382,179.6872423930322,179.13298918207545,1952321,5336552.833333333,57.02311802000676,47.829777954984266,NaN,NaN,NaN,NaN,4.628728677531675,22.06838067954611,1025536208,1.7051642686198114,-0.2147563649269273,-1.9199206335467387
2024-03-28T09:30:00-04:00,177.45,179.54,175.7,177.16,166.00705718982599,NaN,NaN,NaN,NaN,NaN,181.3026000000001,205.5322683625683,157.0729316374319,170.80737770604216,177.46666666666667,177.46666666666667,177.46666666666667,7250753,5316934.433333334,52.00198907279159,48.50398534041959,NaN,NaN,NaN,NaN,4.59596234342227,21.28467644596194,1018285455,1.4778231365967378,-0.07264171280081655,-1.5504648493975544
2024-03-28T13:30:00-04:00,177.15,177.4,175.3,175.78,166.00705718982599,NaN,NaN,NaN,NaN,NaN,180.8708000000001,204.70602698528512,157.03557301471506,170.80737770604216,177.11897345029436,177.696406185205,176.54154071538372,2628892,5299862.733333333,49.60655637929433,49.041369999095636,NaN,NaN,NaN,NaN,4.417679318892108,20.468388652893804,1015656563,1.1839271045728406,-0.0705559686815036,-1.2544830732543442
2024-04-01T09:30:00-04:00,176.2,176.75,170.21,171.88,166.00705718982599,NaN,NaN,NaN,NaN,NaN,180.4290000000001,204.09494456175494,156.76305543824523,170.80737770604216,172.9466666666667,172.9466666666667,172.9466666666667,6779842,5271421.033333333,43.50706024856342,48.95145036532405,NaN,NaN,NaN,NaN,4.569273653256957,19.3432203530453,1008876721,0.7002033440743012,-0.3792288931614678,-1.079432237235769
2024-04-01T13:30:00-04:00,171.89,175.41,171.75,175.23,166.00705718982599,NaN,NaN,NaN,NaN,NaN,180.09540000000007,203.57409407271356,156.61670592728657,170.80737770604216,173.26459455210818,173.7891291306652,172.74005997355115,2490741,5261734.5,49.2764443443996,48.96602782099887,NaN,NaN,NaN,NaN,4.504325535167174,18.29842121747169,1011367462,0.5839389974034173,-0.34950849048149735,-0.9334474878849146
2024-04-02T09:30:00-04:00,164.75,167.7,163.43,166.75,NaN,NaN,NaN,180.52553268868945,180.52553268868945,180.52553268868945,179.44580000000008,202.56545608394867,156.32614391605148,170.80737770604216,165.96,165.96,165.96,9959387,5326210.933333334,38.54536957716931,48.44824336902639,NaN,NaN,NaN,NaN,5.025445139798089,18.695850244743045,1001408075,-0.05220801643871853,-0.9987075084333128,-0.9464994919945943
2024-04-02T13:30:00-04:00,166.75,167.06,165.26,166.64,NaN,NaN,NaN,180.52553268868945,NaN,NaN,178.79100000000008,201.4654953637355,156.11650463626466,170.80737770604216,166.03693178943658,166.18450192182533,165.88936165704783,2706745,5339898.633333334,38.42846314932349,47.97389752698689,NaN,NaN,NaN,NaN,4.795056201241083,19.064891484352152,998701330,-0.44658669783020133,-1.5047328642823459,-1.0581461664521445
2024-04-03T09:30:00-04:00,164.02,168.81,163.28,167.73,NaN,NaN,NaN,180.52553268868945,NaN,NaN,178.17340000000007,200.33127123710358,156.01552876289657,169.91517738549356,166.60666666666668,166.60666666666668,166.60666666666668,6799865,5267342.4,40.35879114840031,47.87084941304102,NaN,NaN,NaN,NaN,4.84755218686672,19.693336758151013,1005501195,-0.5911566321134065,-1.7970919565939028,-1.2059353244804962
2024-04-03T13:30:00-04:00,167.75,168.55,167.13,168.41,NaN,NaN,NaN,180.52553268868945,NaN,NaN,177.5474000000001,198.9932308526398,156.10156914736038,169.91517738549356,166.94193606339525,167.54591829793276,166.33795382885774,2095269,5267637.4,41.58909435030568,47.81075364045885,NaN,NaN,NaN,NaN,4.6027270306619545,20.27689308382138,1007596464,-0.59639056508515,-1.9514235308369337,-1.3550329657517837
2024-04-04T09:30:00-04:00,170.07,177.18,168.01,175.92,NaN,NaN,NaN,180.52553268868945,NaN,NaN,177.00960000000006,197.20669640913923,156.8125035908609,169.91517738549356,173.70333333333335,173.70333333333335,173.70333333333335,9665443,5321359.866666666,53.09669688014525,48.366709617865375,NaN,NaN,NaN,NaN,4.9289608141861025,18.902007673834415,1017261907,-0.07678308179685467,-1.451011817997852,-1.3742287362009973
2024-04-04T13:30:00-04:00,175.93,176.31,170.75,171.04,NaN,NaN,NaN,180.52553268868945,NaN,NaN,176.3876000000001,195.3270587293307,157.4481412706695,168.75514190839485,173.37388493741113,173.84506463949907,172.9027052353232,4725235,5347985.6,46.66342255689257,48.41318148934476,NaN,NaN,NaN,NaN,4.974035041744238,17.6253283645608,1012536672,-0.04597970007513963,-1.4317033612949217,-1.385723661219782
2024-04-05T09:30:00-04:00,169,170.86,160.51,167.8,NaN,NaN,NaN,180.52553268868945,NaN,NaN,175.73140000000006,193.5061708891025,157.95662911089764,167.7221135267159,166.39000000000004,166.39000000000004,166.39000000000004,14021879,5476074.433333334,42.943200634321144,47.42866592903105,NaN,NaN,NaN,NaN,5.37088968161965,18.024014109109824,998514793,-0.21839825797807433,-1.658721483692375,-1.4403232257143006
2024-04-05T13:30:00-04:00,167.82,168.17,164,164.86,NaN,NaN,NaN,180.52553268868945,NaN,NaN,174.99260000000007,191.38919760316406,158.59600239683607,165.73769082137272,166.2524383310754,166.53387058060025,165.97100608155057,3350066,5439399.9,39.83941171174865,46.42060804336557,NaN,NaN,NaN,NaN,5.2851118472182455,18.394222300476777,995164727,-0.48951085190845545,-2.05221179059987,-1.5627009386914144
2024-04-08T09:30:00-04:00,169.34,174.5,167.78,173.81,NaN,NaN,NaN,180.52553268868945,NaN,NaN,174.38340000000008,188.48667996460642,160.28012003539374,164.77015265709818,172.02999999999997,172.02999999999997,172.02999999999997,9041066,5516635.566666666,51.363798075048244,46.01738686774363,NaN,NaN,NaN,NaN,5.596175286702655,17.51984538615094,1004205793,-0.0483630683920917,-1.623154774181529,-1.5747917057894374
2024-04-08T13:30:00-04:00,173.82,174.4,172.55,172.99,NaN,NaN,NaN,180.52553268868945,NaN,NaN,173.79000000000008,185.35218180103004,162.2278181989701,163.89349482267792,172.3340411843334,172.8797014676454,171.78838090102138,2806983,5517406.466666667,50.41098777523192,45.545091850259716,NaN,NaN,NaN,NaN,5.3285913376524645,16.707923965705525,1001398810,0.1927016788743916,-1.3339146071964478,-1.5266162860708394
2024-04-09T09:30:00-04:00,172.9,179.22,171.94,175.37,NaN,NaN,NaN,180.52553268868945,NaN,NaN,173.55040000000008,184.45655603042906,162.6442439695711,164.13720798679608,175.51,175.51,175.51,9258173,5500151.3,53.12870374062397,45.6255714693906,NaN,NaN,NaN,NaN,5.467977670677288,15.900895747318398,1010656983,0.4994985609905418,-0.9022430848326621,-1.401741645823204
2024-04-09T13:30:00-04:00,175.4,176.99,174.76,176.99,NaN,NaN,NaN,180.52553268868945,NaN,NaN,173.3276000000001,183.4610578974815,163.1941421025187,164.13720798679608,175.6690679020391,175.97218079142306,175.36595501265515,2549656,5491755.633333334,54.93897002655648,46.006458158480754,NaN,NaN,NaN,NaN,5.236693551343197,15.151512401673205,1013206639,0.7817723895089641,-0.42452615893699885,-1.206298548445963
2024-04-10T09:30:00-04:00,173.08,174.93,170.43,171.4,NaN,NaN,NaN,180.52553268868945,NaN,NaN,173.14260000000013,183.07023400614656,163.2149659938537,164.13720798679608,172.25333333333333,172.25333333333333,172.25333333333333,7366071,5525259.366666666,48.04367023623576,46.33050172902877,NaN,NaN,NaN,NaN,5.331215440532968,14.450223479024466,1005840568,0.571971209059136,-0.491334537122043,-1.063305746181179
2024-04-10T13:30:00-04:00,171.38,172.14,170.01,171.77,NaN,NaN,NaN,180.52553268868945,NaN,NaN,172.9612000000001,182.6481509258611,163.2742490741391,164.13720798679608,171.96799806908155,172.40239554888578,171.5336005892773,3178134,5564154.666666667,48.50436960621054,46.275353533443834,NaN,NaN,NaN,NaN,5.102557194780613,13.870256295703449,1009018702,0.443794708894251,-0.5085623600633653,-0.9523570689576163
2024-04-11T09:30:00-04:00,172.55,174.29,168.51,173.85,NaN,NaN,NaN,180.52553268868945,NaN,NaN,172.84060000000008,182.32808937074958,163.35311062925058,164.13720798679608,172.21666666666667,172.21666666666667,172.21666666666667,8112602,5630566.733333333,51.12790200023049,47.17410584937678,NaN,NaN,NaN,NaN,5.1509459665819985,12.914863483070976,1017131304,0.4816149081556025,-0.35033843376311324,-0.8319533419187157
2024-04-11T13:30:00-04:00,173.86,175.88,173.79,174.63,NaN,NaN,NaN,180.52553268868945,NaN,NaN,172.80300000000005,182.24682316650004,163.35917683350007,164.76300671311333,173.02552084078548,174.21225293735267,171.83878874421828,3768732,5603622.633333334,52.113156026957064,48.15158391206489,NaN,NaN,NaN,NaN,4.932306968968999,12.25766148369109,1020900036,0.5374353646273304,-0.16015913613455268,-0.6975945007618831
2024-04-12T09:30:00-04:00,172.45,173.8,170.37,170.6,NaN,NaN,NaN,180.52553268868945,NaN,NaN,172.63500000000008,181.92956464822726,163.3404353517729,164.76300671311333,171.59,171.59,171.59,5735974,5582119.866666666,46.85712412644859,48.61575055335406,NaN,NaN,NaN,NaN,4.88428504261407,11.771953261468372,1015164062,0.2934239461574656,-0.33081456806505116,-0.6242385142225167
2024-04-12T13:30:00-04:00,170.6,171.78,170.51,171.04,NaN,NaN,NaN,180.52553268868945,NaN,NaN,172.4844000000001,181.63228470412855,163.33651529587166,164.76300671311333,171.46951902517003,171.67764207199534,171.26139597834472,1922223,5571713.3,47.479952006782746,49.036526100245275,NaN,NaN,NaN,NaN,4.626121825284494,11.320938483690135,1017086285,0.15887138368693,-0.4256492846138542,-0.5845206683007842
2024-04-15T09:30:00-04:00,170.29,170.68,162.89,162.97,NaN,NaN,NaN,180.52553268868945,NaN,NaN,172.2218000000001,181.6877420577169,162.75585794228328,164.76300671311333,165.51333333333332,165.51333333333332,165.51333333333332,8108072,5623569.266666667,38.554944065624696,47.99782947063666,NaN,NaN,NaN,NaN,4.877827409192745,12.158261338647135,1008978213,-0.4434714398595011,-1.1388599681251605,-0.6953885282656594
2024-04-15T13:30:00-04:00,162.98,163.49,161.38,161.45,NaN,NaN,NaN,176.83147409715735,NaN,NaN,171.94400000000007,181.83339067890833,162.05460932109182,164.76300671311333,164.44465435872934,166.02533721414244,162.86397150331624,3706147,5678270.8,37.13888321343559,47.31750523181831,NaN,NaN,NaN,NaN,4.680125451393264,13.145646225380645,1005272066,-0.8884238711881328,-1.8059183672508254,-0.9174944960626926
2024-04-16T09:30:00-04:00,156.83,158.19,153.75,156.77,NaN,NaN,NaN,170.76208891092293,NaN,NaN,171.50080000000005,182.061577880445,160.94002211955512,164.76300671311333,156.23666666666668,156.23666666666668,156.23666666666668,8359394,5727346.1,33.106994433606374,46.61491907462439,NaN,NaN,NaN,NaN,4.895830776293745,14.971991020901921,996912672,-1.4110408320856735,-2.6812955361697846,-1.270254704084111
2024-04-16T13:30:00-04:00,156.81,157.83,155.5,157.02,NaN,NaN,NaN,170.76208891092293,NaN,NaN,171.08560000000008,182.2418396245361,159.92936037546406,164.76300671311333,156.38339578113826,156.62564045679167,156.14115110548485,3066895,5760375.366666666,33.52217341079307,46.16368776741327,NaN,NaN,NaN,NaN,4.7125571494156215,16.667882616743103,999979567,-1.637102840729573,-3.316633254996077,-1.6795304142665042
2024-04-17T09:30:00-04:00,157.66,157.71,153.78,157.17,NaN,NaN,NaN,170.06210993743187,NaN,NaN,170.66660000000007,182.2981231057702,159.03507689422995,164.76300671311333,156.21999999999997,156.2200026973983,156.21999730260166,6904571,5593363.566666666,33.787712932129395,44.908253114347644,NaN,NaN,NaN,NaN,4.656660210171649,18.43104006438518,1006884138,-1.6680898843380683,-3.7646427696890896,-2.0965528853510214
2024-04-17T13:30:00-04:00,157.17,158.32,155.3,155.49,NaN,NaN,NaN,170.06210993743187,NaN,NaN,170.2262000000001,182.44079316719376,158.01160683280642,164.76300671311333,156.26403045114063,156.33233774973664,156.19572315254462,2868856,5604639.6,32.23468764202323,43.60994596197559,NaN,NaN,NaN,NaN,4.539755909445102,19.904977780759094,1004015282,-1.6881677375828605,-4.206762557329597,-2.5185948197467365
2024-04-18T09:30:00-04:00,151.29,152.2,148.7,150.87,NaN,NaN,NaN,164.81414355869305,NaN,NaN,169.80840000000006,183.16066024911527,156.45613975088486,164.76300671311333,150.59,150.59,150.59,7803086,5632769.1,28.37248947707593,41.84164494315073,NaN,NaN,NaN,NaN,4.700487630199025,21.963735850392606,996212196,-1.884131663278437,-4.873759398844783,-2.9896277355663456
2024-04-18T13:30:00-04:00,150.87,151.4,149.42,149.89,NaN,NaN,NaN,164.39122794238884,NaN,NaN,169.41640000000004,183.88704270031377,154.9457572996863,162.7764053704907,150.4900639247231,150.64919760267236,150.33093024677385,3077420,5670272.4,27.616613924514027,39.890048078719126,NaN,NaN,NaN,NaN,4.506167085184811,23.875439772195147,993134776,-1.9434742054291165,-5.4189704923527415,-3.475496286923625
2024-04-19T09:30:00-04:00,148.97,150.94,147.82,148.94,NaN,NaN,NaN,163.1511721268257,NaN,NaN,169.15340000000006,184.59268009202847,153.71411990797165,162.32612429639255,149.23333333333332,149.23333333333332,149.23333333333332,6115986,5632446.833333333,26.86931951018788,38.377594455429985,NaN,NaN,NaN,NaN,4.407155150528753,25.806887484736524,987018790,-1.9077301762983359,-5.860159007296545,-3.952428830998209
2024-04-19T13:30:00-04:00,148.89,149.32,146.22,147.01,NaN,NaN,NaN,161.3379370301518,NaN,NaN,168.84340000000003,185.38675521471257,152.3000447852875,159.04189943711404,148.6473408630418,149.46132278263946,147.83335894344413,3169721,5650474.466666667,25.36750123515236,36.72496100035441,NaN,NaN,NaN,NaN,4.313786925490985,27.754428048159973,983849069,-1.8724546950679661,-6.292997199833167,-4.4205425047652005
2024-04-22T09:30:00-04:00,140.63,144.44,138.8,142.16,NaN,NaN,NaN,155.69075807423582,NaN,NaN,168.44720000000004,186.50919104861205,150.38520895138802,153.12451954969123,141.79999999999998,141.79999999999998,141.79999999999998,8249543,5699464.5,22.034516295050693,34.64686202141299,NaN,NaN,NaN,NaN,4.592087859384484,30.16606093063201,975599526,-2.021401964939259,-6.947294960939274,-4.925892996000015
2024-04-22T13:30:00-04:00,142.15,143.33,141.46,142.05,NaN,NaN,NaN,155.69075807423582,NaN,NaN,168.01700000000008,187.49338128606217,148.540618713938,148.2754992075535,141.89609687924735,142.08816950049268,141.70402425800202,2064988,5685272.733333333,21.96403022070014,32.493353035251786,NaN,NaN,NaN,NaN,4.397653012285592,32.4054343214989,973534538,-1.9709055137415596,-7.389524888176965,-5.418619374435405
2024-04-23T09:30:00-04:00,143.32,147.26,141.11,145.68,NaN,NaN,NaN,155.69075807423582,NaN,NaN,167.47400000000005,187.8752783913197,147.07272160868038,148.2754992075535,144.68333333333334,144.68333333333334,144.68333333333334,6025074,5554128.966666667,29.929866407877995,31.28426319821103,NaN,NaN,NaN,NaN,4.522820654265191,33.336493034502446,979559612,-1.5548785544408847,-7.3622175674865105,-5.807339013045626
2024-04-23T13:30:00-04:00,145.7,145.92,144.47,144.81,NaN,NaN,NaN,155.69075807423582,NaN,NaN,166.89260000000004,188.1686348975114,145.6165651024887,148.2754992075535,144.79570664996052,144.97020213915332,144.62121116076773,2498736,5547195.333333333,29.161542508288363,29.975805376890005,NaN,NaN,NaN,NaN,4.303333464674819,34.20104755372002,977060876,-1.2151885792568082,-7.326324737116636,-6.1111361578598276
2024-04-24T09:30:00-04:00,162.96,167.97,157.52,160.8,146.73052160441802,146.73052160441802,146.73052160441802,NaN,NaN,NaN,166.67420000000004,187.97171500621937,145.3766849937807,148.63966875354365,162.09666666666666,162.09666666666666,162.09666666666666,14031449,5788248.133333334,53.0281657889453,31.009606928555762,NaN,NaN,NaN,NaN,5.650238217198045,32.59605982159785,991092325,0.13758321591120293,-5.939157137970824,-6.076740353882027
2024-04-24T13:30:00-04:00,160.8,162.58,160.32,162.12,146.73052160441802,NaN,NaN,NaN,NaN,NaN,166.49040000000008,187.7833336485159,145.19746635148425,148.63966875354365,162.00465436305055,162.17925565510484,161.83005307099626,3896722,5848296.566666666,54.394171096212716,32.24212749161127,NaN,NaN,NaN,NaN,5.408078344541043,31.10571407034155,994989047,1.1179018281522728,-4.679363068691686,-5.797264896843958
2024-04-25T09:30:00-04:00,159.06,166.89,158.37,164.64,146.73052160441802,NaN,NaN,NaN,NaN,NaN,166.32420000000005,187.5424548160808,145.1059451839193,149.35458800226792,163.29999999999998,163.29999999999998,163.29999999999998,8225102,5800285.2,56.96709434731464,33.94642034259043,NaN,NaN,NaN,NaN,5.63035846278811,30.237690833788538,1003214149,1.8874173515851247,-3.4379932073625525,-5.325410558947677
2024-04-25T13:30:00-04:00,164.61,170.88,164.54,170.27,151.52719905883873,NaN,NaN,NaN,NaN,NaN,166.21500000000006,187.29424714025922,145.1357528597409,153.68167040181436,165.30068456699618,167.85558789869825,162.74578123529412,5043704,5810900.833333333,62.110157065592006,35.988419175076075,NaN,NaN,NaN,NaN,5.681047144017532,29.868277835097285,1008257853,2.678637436128403,-1.9771137637871732,-4.655751199915576
2024-04-26T09:30:00-04:00,168.85,172.12,167.27,170.91,153.586417283437,NaN,NaN,NaN,NaN,NaN,166.16600000000008,187.1899010652183,145.14209893478187,155.93633632145148,170.1,170.1,170.1,7639567,5598157.1,62.65653360155305,38.05047779432062,NaN,NaN,NaN,NaN,5.621686633730564,29.65702982473607,1015897420,3.1174291558278058,-0.758964755130819,-3.8763939109586247
2024-04-26T13:30:00-04:00,170.93,170.97,166.37,168.27,153.586417283437,NaN,NaN,NaN,NaN,NaN,166.07480000000007,187.02169905069746,145.12790094930267,155.93633632145148,169.55296528670206,170.29858625222786,168.80734432117626,4112087,5623557.8,58.884472977278335,39.954033889695985,NaN,NaN,NaN,NaN,5.548709017035523,29.289715600069794,1011785333,3.095896228140349,-0.006523625783188436,-3.1024198539235375
2024-04-29T09:30:00-04:00,188.41,198.87,184.54,195.65,172.25606409503246,NaN,NaN,NaN,NaN,NaN,166.57980000000006,189.07938417038196,144.08021582961817,171.37245524572896,193.01999999999998,193.01999999999998,193.01999999999998,17372947,5901287.166666667,75.41522788750521,43.31422949044093,NaN,NaN,NaN,NaN,7.3380869443901275,31.03325466591252,1029158280,4.695719615158977,2.7672296650251837,-1.928489950133793
2024-04-29T13:30:00-04:00,195.63,195.66,191.14,194.18,174.2187429998037,NaN,NaN,NaN,NaN,NaN,167.04860000000008,190.81642060181554,143.28077939818462,171.40196419658315,193.16760529369145,193.4371976994334,192.8980128879495,5207893,5981317.5,73.70192467528864,46.60603740121055,NaN,NaN,NaN,NaN,7.136795019790833,32.65225522705219,1023950387,5.3760702478245195,4.791597859646856,-0.5844723881776632
2024-04-30T09:30:00-04:00,187.06,190.95,183.02,184.38,174.2187429998037,NaN,NaN,NaN,NaN,NaN,167.2906000000001,191.50868891221742,143.07251108778277,171.40196419658315,186.11666666666667,186.11666666666667,186.11666666666667,8664256,5961520.266666667,63.366500012190386,49.2129788656393,NaN,NaN,NaN,NaN,7.424166804091487,32.88829500359158,1015286131,4.90059377565531,5.5412698313914746,0.6406760557361644
2024-04-30T13:30:00-04:00,184.4,185.91,182.85,183.33,174.2187429998037,NaN,NaN,NaN,NaN,NaN,167.50420000000008,192.09315006786753,142.91524993213264,171.40196419658315,185.60596091722735,186.50309652644168,184.70882530801302,2807738,5970123,62.35751159837241,51.85512246301216,NaN,NaN,NaN,NaN,7.112440603799238,33.08226534022927,1012478393,4.272827642528148,5.98171060889635,1.7088829663682015
2024-05-01T09:30:00-04:00,182.04,184.05,179.01,179.99,174.2187429998037,NaN,NaN,NaN,NaN,NaN,167.51800000000011,192.1341745200192,142.90182547998103,171.40196419658315,181.01666666666665,181.01666857401528,181.01666475931802,5162469,5896669.6,59.13205443517862,54.504946615878445,NaN,NaN,NaN,NaN,6.964409132099293,32.68706260589499,1007315924,3.4266367496424714,5.992178903421291,2.5655421537788192
2024-05-01T13:30:00-04:00,179.97,185.86,179.86,180,174.2187429998037,NaN,NaN,NaN,NaN,NaN,167.56400000000014,192.26456193692826,142.863438063072,171.40196419658315,181.37989951642854,181.81732280473696,180.9424762281201,3559786,5909391.333333333,59.13886920356499,57.16029225751164,NaN,NaN,NaN,NaN,6.895522765520773,32.47155249841177,1010875710,2.6938793492995634,5.932891340403273,3.23901199110371
2024-05-02T09:30:00-04:00,182.9,184.62,176.02,180.4,174.2187429998037,NaN,NaN,NaN,NaN,NaN,167.5748000000001,192.29732001394825,142.85227998605194,171.40196419658315,180.34666666666666,180.34666666666666,180.34666666666666,6105685,5842494.1,59.430286223167194,59.26746510146087,NaN,NaN,NaN,NaN,7.017271139412146,31.69089590788306,1016981395,2.089381211196757,5.850738505099656,3.761357293902899
2024-05-02T13:30:00-04:00,180.38,181.75,179.59,180,174.2187429998037,NaN,NaN,NaN,NaN,NaN,167.57740000000013,192.30511847461946,142.8496815253808,171.40196419658315,180.3738266208512,180.41830506852838,180.329348173174,2276634,5792757.5,58.97731127499369,61.39716287051125,NaN,NaN,NaN,NaN,6.670323200882707,30.966000502392117,1014704761,1.5411460316835743,5.687789833507367,4.146643801823792
2024-05-03T09:30:00-04:00,182.09,184.78,178.43,181.34,174.2187429998037,NaN,NaN,NaN,NaN,NaN,167.66100000000014,192.5455080321072,142.7764919678931,171.40196419658315,181.51666666666668,181.51666666666668,181.51666666666668,6355853,5813420.133333334,60.07515147537928,61.90051899097083,NaN,NaN,NaN,NaN,6.6474429722482276,30.596892369189266,1021060614,1.1644449301402293,5.6021999644990785,4.437755034358849
2024-05-03T13:30:00-04:00,181.36,182.02,180.62,181.2,174.2187429998037,NaN,NaN,NaN,NaN,NaN,167.76940000000013,192.84095054160028,142.6978494584,171.40196419658315,181.45861351493852,181.56044218224267,181.35678484763437,2065786,5818205.566666666,59.89480316801559,62.29342128181389,NaN,NaN,NaN,NaN,6.27262561708764,30.25414910264376,1018994828,0.8179012117240703,5.460131549013937,4.642230337289867
2024-05-06T09:30:00-04:00,183.93,187.55,182.2,184.54,174.2187429998037,NaN,NaN,NaN,NaN,NaN,168.02260000000012,193.5073932100705,142.53780678992976,173.31222575992274,184.76333333333332,184.76333333333332,184.76333333333332,6372200,5760343.166666667,62.766595669310234,62.707671376242146,NaN,NaN,NaN,NaN,6.278152358724239,30.48178326018639,1025367028,0.7286472589417201,5.553039410967017,4.824392152025297
2024-05-06T13:30:00-04:00,184.51,185.4,183.51,184.85,174.2187429998037,NaN,NaN,NaN,NaN,NaN,168.21500000000015,194.0572869730996,142.3727130269007,173.31222575992274,184.72180503753924,184.79671876285815,184.64689131222033,1958190,5702077.933333334,63.03119438692087,62.77345975633706,NaN,NaN,NaN,NaN,5.9647129045296525,30.69315783504741,1027325218,0.6103081305567688,5.587277315221257,4.976969184664489
2024-05-07T09:30:00-04:00,182.51,183.26,178.17,179.39,174.2187429998037,NaN,NaN,NaN,NaN,NaN,168.46780000000012,194.49445780771825,142.441142192282,173.31222575992274,180.2733333333333,180.2733333333333,180.2733333333333,5456787,5605324.366666666,55.544172210514674,62.265433942691466,NaN,NaN,NaN,NaN,6.015804839920392,29.903696466341135,1021868431,0.11032357432354267,5.114873652568917,5.004550078245375
2024-05-07T13:30:00-04:00,179.41,179.58,177.4,177.73,174.2187429998037,NaN,NaN,NaN,NaN,NaN,168.68960000000013,194.83890085795903,142.54029914204122,173.31222575992274,179.6976759024395,180.6147586812398,178.7805931236392,2150048,5574762.8,53.46484874806368,61.87831792631899,NaN,NaN,NaN,NaN,5.741818779926079,29.035553008023346,1019718383,-0.36040325299624243,4.554046012000072,4.914449264996314
2024-05-08T09:30:00-04:00,171.68,176.05,170.15,174.47,NaN,NaN,NaN,190.5854603617935,190.5854603617935,190.5854603617935,168.82440000000017,195.02196909638744,142.6268309036129,173.31222575992274,173.5566666666667,173.55666857401533,173.55666475931807,5847273,5539519.533333333,49.54242080179153,60.030260277339444,NaN,NaN,NaN,NaN,5.873117438502787,27.067649192462866,1013871110,-0.8894024547148147,3.8026961966027955,4.69209865131761
2024-05-08T13:30:00-04:00,174.46,175.08,174.05,174.77,NaN,NaN,NaN,190.5854603617935,NaN,NaN,168.95160000000016,195.20159393828496,142.70160606171535,173.31222575992274,173.78246865384003,174.22079152051455,173.3441457871655,1551746,5495615.866666666,49.90663358813718,58.3305966282572,NaN,NaN,NaN,NaN,5.52718047860973,25.240309935156706,1015422856,-1.1979766282063924,3.1946278660596192,4.392604494266012
2024-05-09T09:30:00-04:00,175.03,175.6,172.01,173.15,NaN,NaN,NaN,190.36061574287385,NaN,NaN,168.89620000000016,195.098782739875,142.69361726012534,173.31222575992274,173.58666666666667,173.58666666666667,173.58666666666667,4069182,5371152.4,47.896117593523975,57.22556931263817,NaN,NaN,NaN,NaN,5.388810444423321,23.644028677520676,1011353674,-1.472016179747131,2.5525842695820984,4.024600449329229
2024-05-09T13:30:00-04:00,173.15,173.15,171.37,171.97,NaN,NaN,NaN,188.30581502728865,NaN,NaN,168.91480000000013,195.1247627592263,142.70483724077397,173.31222575992274,173.12798098508898,173.79316521943585,172.46279675074211,1934878,5333067.666666667,46.428917025649206,56.087812557443655,NaN,NaN,NaN,NaN,5.131038269821654,22.261394904895916,1009418796,-1.678609698463562,1.9263383262497769,3.6049480247133388
2024-05-10T09:30:00-04:00,173.05,173.09,167.75,168.62,NaN,NaN,NaN,186.46464161695738,NaN,NaN,168.93120000000016,195.13937815568264,142.72302184431769,173.31222575992274,169.82000000000002,169.82000000000002,169.82000000000002,6302841,5339296.166666667,42.452935280896284,54.89644690356635,NaN,NaN,NaN,NaN,5.145964107691536,21.527546397513703,1003115955,-1.9667578162554955,1.1465007543939691,3.1132585706494647
2024-05-10T13:30:00-04:00,168.61,169.31,167.78,168.47,NaN,NaN,NaN,184.06897608891384,NaN,NaN,169.00340000000017,195.18619575904725,142.8206042409531,173.31222575992274,169.51768618003155,170.06688042636335,168.96849193369974,1909855,5297300.633333334,42.27835105403965,53.69212417860025,NaN,NaN,NaN,NaN,4.88768095714214,20.846115640658788,1001206100,-2.0822184131820003,0.5104855541719644,2.5927039673539647
2024-05-13T09:30:00-04:00,170,175.4,169,171.59,NaN,NaN,NaN,184.06897608891384,NaN,NaN,168.9590000000002,195.11655867813255,142.80144132186786,173.0647806079382,171.99666666666667,171.9966685740153,171.99666475931804,5547447,5207230.766666667,47.14706653004211,52.81475134337704,NaN,NaN,NaN,NaN,5.033560888774845,19.58612692482132,1006753547,-1.8699596246259222,0.2552544365715619,2.125214061197484
2024-05-13T13:30:00-04:00,171.59,172.4,170.92,171.89,NaN,NaN,NaN,184.06897608891384,NaN,NaN,168.93700000000018,195.08280815350642,142.79119184649394,170.05182448635054,171.9400988221316,172.0473728569214,171.8328247873418,1542564,5189816.633333334,47.604701631410634,52.0024220831211,NaN,NaN,NaN,NaN,4.779735111005215,18.41613740297224,1008296111,-1.6391234263933725,0.07630977820576845,1.715433204599141
2024-05-14T09:30:00-04:00,174.58,179.49,174.09,176.25,NaN,NaN,NaN,184.06897608891384,NaN,NaN,168.9546000000002,195.1188841170926,142.7903158829078,168.3245301353062,176.61,176.61,176.61,7035917,5223511.4,53.85784039738848,51.55832843469319,NaN,NaN,NaN,NaN,4.981182603076273,18.40015420695888,1015332028,-1.1459084736808938,0.2830476124980237,1.4289560861789175
2024-05-14T13:30:00-04:00,176.24,178,175.92,177.62,NaN,NaN,NaN,184.06897608891384,NaN,NaN,168.9672000000002,195.14755233987424,142.78684766012614,168.3245301353062,176.7431101572324,176.98426254819677,176.50195776626802,2143680,5211676.2,55.6489747903211,51.25505497914359,NaN,NaN,NaN,NaN,4.773955274285112,18.385312667803618,1017475708,-0.7022978012116736,0.5510838346643254,1.253381635875999
2024-05-15T09:30:00-04:00,179.92,180,173.12,175.29,NaN,NaN,NaN,184.06897608891384,NaN,NaN,169.0450000000002,195.2768771726304,142.81312282736997,168.58209928659593,176.13666666666663,176.13666997029136,176.1366633630419,6996766,4977186.766666667,51.955129316226596,50.48280738249475,NaN,NaN,NaN,NaN,4.924387040407603,17.812507828197056,1010478942,-0.5475576124631765,0.5689346202970285,1.116492232760205
2024-05-15T13:30:00-04:00,175.31,175.6,173.76,174.08,NaN,NaN,NaN,184.06897608891384,NaN,NaN,169.09120000000019,195.3502344498798,142.83216555012058,168.58209928659593,175.8014435472918,176.46700979343663,175.13587730114696,1774936,4906460.566666666,50.09546688788447,49.55882684684929,NaN,NaN,NaN,NaN,4.704073680378488,17.280617619990963,1008704006,-0.5092638049157102,0.47991247661556713,0.9891762815312773
2024-05-16T09:30:00-04:00,174.05,175.78,171.44,174.27,NaN,NaN,NaN,184.06897608891384,NaN,NaN,169.09960000000012,195.36498618334122,142.83421381665903,168.58209928659593,173.83,173.83,173.83,4649675,4787279.666666667,50.395713288564544,49.19107978099571,NaN,NaN,NaN,NaN,4.67806841749431,16.315108046006067,1013353681,-0.45545831326332287,0.41985338995212373,0.8753117032154466
2024-05-16T13:30:00-04:00,174.28,175.22,173.97,174.82,NaN,NaN,NaN,184.06897608891384,NaN,NaN,169.10340000000014,195.37204034852283,142.83475965147744,168.58209928659593,174.01619534758524,174.36510132992078,173.6672893652497,1324169,4663295.166666667,51.30894455787252,49.03708662455348,NaN,NaN,NaN,NaN,4.433206387673288,15.418563441591521,1014677850,-0.37073853070695706,0.4118885398317502,0.7826270705387073
2024-05-17T09:30:00-04:00,173.69,179.63,172.75,177.22,NaN,NaN,NaN,184.06897608891384,NaN,NaN,169.23580000000013,195.5998379577946,142.87176204220566,169.1533878677897,176.53333333333333,176.53333333333333,176.53333333333333,7345745,4653501.1,55.186053393227546,49.44020323822748,NaN,NaN,NaN,NaN,4.607977359982338,15.387009407049042,1022023595,-0.15217575434888764,0.5924073776025978,0.7445831319514854
2024-05-17T13:30:00-04:00,177.23,177.69,176,177.57,NaN,NaN,NaN,184.06897608891384,NaN,NaN,169.36640000000014,195.82940383856712,142.90339616143316,169.1533878677897,176.67317485806194,176.91363966833538,176.4327100477885,2484306,4599241.733333333,55.73955145030626,49.85684022838241,NaN,NaN,NaN,NaN,4.399550405697886,15.357709232116742,1024507901,0.008340424159792859,0.7550086621512264,0.7466682379914336
2024-05-20T09:30:00-04:00,177.65,177.78,173.6,174.25,NaN,NaN,NaN,184.06897608891384,NaN,NaN,169.59200000000013,196.02534712063598,143.15865287936427,169.1533878677897,175.21,175.21000190734864,175.20999809265138,5676643,4209364.933333334,49.494773860846486,49.97102996176259,NaN,NaN,NaN,NaN,4.383868233862323,14.767902132863844,1018831258,-0.11017023935644743,0.6089554387958742,0.7191256781523216
2024-05-20T13:30:00-04:00,174.25,175.02,173.52,174.96,NaN,NaN,NaN,184.06897608891384,NaN,NaN,169.86220000000012,196.2332384444766,143.49116155552363,169.1533878677897,175.0643959703772,175.35106359600377,174.77772834475064,1464472,4084584.2333333334,50.765146422328606,50.28076063295397,NaN,NaN,NaN,NaN,4.1778776457293,14.201457874439535,1020295730,-0.1399207115487554,0.5442247887163774,0.6841455002651328
2024-05-21T09:30:00-04:00,175.51,182.2,174.71,181.64,NaN,NaN,NaN,184.06897608891384,NaN,NaN,170.35960000000014,196.66220274877347,144.05699725122682,171.79353967064665,179.51666666666665,179.51666857401528,179.51666475931802,7473230,4044883.3666666667,60.76458895556763,51.588735895430496,NaN,NaN,NaN,NaN,4.414457813891491,14.950856177205221,1027768960,0.26883191411887897,1.0201853929137314,0.7513534787948525
2024-05-21T13:30:00-04:00,181.64,186.87,181.58,186.68,170.04042064418837,170.04042064418837,170.04042064418837,NaN,NaN,NaN,170.95280000000014,197.36287778556877,144.5427222144315,175.89983173651734,181.89142050089015,184.62729642716644,179.15554457461386,5630575,4138977.933333333,66.32217210101794,53.30615168450036,NaN,NaN,NaN,NaN,4.47699654147067,16.283381743096108,1033399535,0.8257286072668777,1.7835142378784496,0.957785630611572
2024-05-22T09:30:00-04:00,182.86,183.8,179.55,179.68,170.04042064418837,NaN,NaN,NaN,NaN,NaN,171.40300000000013,197.62469643634446,145.1813035636558,175.89983173651734,181.01,181.01,181.01,6694490,4190045.3,54.72734386296673,53.84760006542354,NaN,NaN,NaN,NaN,4.666496788508479,17.019724068306022,1026705045,0.6760390121127295,1.802834395752484,1.1267953836397544
2024-05-22T13:30:00-04:00,179.68,180.21,178.12,180.18,170.04042064418837,NaN,NaN,NaN,NaN,NaN,171.8968000000001,197.82953959765624,145.96406040234396,175.89983173651734,180.57199132326878,181.25615612216762,179.88782652436993,2743857,4162847.6666666665,55.328097862997694,54.39927122482261,NaN,NaN,NaN,NaN,4.4824613036150165,17.357145053702546,1029448902,0.5684134452055258,1.8373121901466618,1.268898744941136
2024-05-23T09:30:00-04:00,181.79,181.86,175.16,177.02,170.04042064418837,NaN,NaN,NaN,NaN,NaN,172.4198000000001,197.6812832470274,147.15831675297278,175.89983173651734,178.01333333333332,178.01333333333332,178.01333333333332,5563002,4144758.2333333334,50.745033066442005,54.17692784404072,NaN,NaN,NaN,NaN,4.640856924785374,16.986422004968524,1023885900,0.2579265275554268,1.5913069043854193,1.3333803768299926
2024-05-23T13:30:00-04:00,177,177.1,173.27,173.78,170.04042064418837,NaN,NaN,NaN,NaN,NaN,172.8976000000001,197.32647686652513,148.46872313347507,175.89983173651734,176.9434171408996,178.48693143914647,175.39990284265275,2672929,4157968.066666667,46.492607033350424,53.52290157568567,NaN,NaN,NaN,NaN,4.58293857301499,16.23104929703709,1021212971,-0.16912699721921132,1.1219716303059784,1.2910986275251897
2024-05-24T09:30:00-04:00,174.8,179.51,173.74,179.05,170.04042064418837,NaN,NaN,NaN,NaN,NaN,173.4998000000001,197.00363542828345,149.99596457171677,175.89983173651734,177.4333333333333,177.4333333333333,177.4333333333333,6491308,4162483.2333333334,53.34155377360667,53.62193189406996,NaN,NaN,NaN,NaN,4.667728674942489,15.96968439846953,1027704279,-0.10338156790202424,1.1618716676476595,1.2652532355496837
2024-05-24T13:30:00-04:00,179.06,180.08,178.85,179.34,170.04042064418837,NaN,NaN,NaN,NaN,NaN,174.1464000000001,196.44774050140947,151.84505949859076,175.89983173651734,177.91969305966404,178.77485975218147,177.0645263671466,2099645,4163611.8666666667,53.69281518583963,53.8788853439239,NaN,NaN,NaN,NaN,4.422176626732313,15.829968378381269,1029803924,-0.049782123613082874,1.2030255810333301,1.252807704646413
2024-05-28T09:30:00-04:00,176.42,178.25,173.16,176.05,170.04042064418837,NaN,NaN,NaN,NaN,NaN,174.8242000000001,195.17000176448806,154.47839823551215,175.89983173651734,175.82000000000002,175.82000000000002,175.82000000000002,5314735,4128363.033333333,49.17024680168721,53.79135202343266,NaN,NaN,NaN,NaN,4.5477354391085765,14.924596222191264,1024489189,-0.2349590918091493,0.9591088398849763,1.1940679316941256
2024-05-28T13:30:00-04:00,176.05,176.88,174.81,176.78,170.04042064418837,NaN,NaN,NaN,NaN,NaN,175.51880000000008,193.58523103216186,157.4523689678383,175.89983173651734,175.89949634906446,176.04247921979706,175.75651347833187,1642888,4117852.966666667,50.17311611025238,53.710221420031225,NaN,NaN,NaN,NaN,4.370754336315106,14.083893505729113,1026132077,-0.3030066789751378,0.8153095829752033,1.118316261950341
2024-05-29T09:30:00-04:00,174.17,178.14,173.94,176.83,170.04042064418837,NaN,NaN,NaN,NaN,NaN,176.14180000000007,192.07141503112544,160.2121849688747,175.89983173651734,176.3033333333333,176.3033333333333,176.3033333333333,4462865,4084722.2333333334,50.24552473806236,53.35732651609084,NaN,NaN,NaN,NaN,4.358557598006883,13.126897799475184,1030594942,-0.3367780702048211,0.6973436741943146,1.0341217443991357
2024-05-29T13:30:00-04:00,176.81,178.01,176.02,176.25,170.04042064418837,NaN,NaN,NaN,NaN,NaN,176.7706000000001,189.9477574537099,163.59344254629028,171.45886538921388,176.42757090262057,176.6307953672409,176.22434643800025,1667891,4068650.3333333335,49.3496377451685,52.90090410858101,NaN,NaN,NaN,NaN,4.189374912434962,12.23825892938225,1028927051,-0.3867329965889714,0.5507054986629214,0.9374384952518928
2024-05-30T09:30:00-04:00,178.61,182.67,175.39,178.39,170.04042064418837,NaN,NaN,NaN,NaN,NaN,177.12240000000008,189.489591150777,164.75520884922318,171.7075892515185,178.81666666666663,178.81666666666663,178.81666666666663,7303154,4117179.7,52.700689376787615,53.129898074005375,NaN,NaN,NaN,NaN,4.4101338472610365,12.389980215900497,1036230205,-0.2697472411818209,0.6002544437746167,0.8700016849564376
2024-05-30T13:30:00-04:00,178.38,180.29,177.53,178.74,170.04042064418837,NaN,NaN,NaN,NaN,NaN,177.45480000000006,189.06122183620212,165.848378163798,171.7075892515185,178.8252507119785,178.84077689924754,178.80972452470945,2232363,4139866.933333333,53.2455190564704,53.30706754787264,NaN,NaN,NaN,NaN,4.2922671438852475,12.530864267667438,1038462568,-0.16787769692123433,0.6601545638048947,0.828032260726129
2024-05-31T09:30:00-04:00,178.52,180.32,173.82,175.955,170.04042064418837,NaN,NaN,NaN,NaN,NaN,177.68110000000007,188.70591769281765,166.6562823071825,171.7075892515185,176.69833333333335,176.69833333333335,176.69833333333335,6038796,4205520.733333333,48.46198385851633,52.4283100409404,NaN,NaN,NaN,NaN,4.449962347893444,11.740192940534126,1032423772,-0.28050861963817797,0.4773964861784066,0.7579051058165845
2024-05-31T13:30:00-04:00,175.95,178.27,175.385,178.06,170.04042064418837,NaN,NaN,NaN,NaN,NaN,177.8369000000001,188.6566524722071,167.0171475277931,171.7075892515185,176.8325619283758,177.06594171672498,176.59918214002664,1997625,4207612.3,51.97398045361069,51.40343920898274,NaN,NaN,NaN,NaN,4.338179323043914,11.005998136767479,1034421397,-0.20897226845582506,0.49668977024680316,0.7056620387026282
2024-06-03T09:30:00-04:00,178.13,182.63,174.49,175.8,170.04042064418837,NaN,NaN,NaN,NaN,NaN,177.93470000000008,188.58937717201508,167.28002282798508,171.7075892515185,177.64000000000001,177.64000000000001,177.64000000000001,6705323,4221028.366666666,48.17806310625663,50.935633440646306,NaN,NaN,NaN,NaN,4.609737942826491,11.262206112001575,1027716074,-0.30384130413715504,0.3258604085311845,0.6297017126683395
2024-06-03T13:30:00-04:00,175.79,176.83,175.57,176.37,170.04042064418837,NaN,NaN,NaN,NaN,NaN,178.09670000000008,188.39915205957604,167.79424794042413,171.7075892515185,177.37989700842354,177.9204111822605,176.8393828345866,1552731,4209124.233333333,49.18607262033791,50.496917351884896,NaN,NaN,NaN,NaN,4.370470946910314,11.500113517576093,1029268805,-0.3167403164856213,0.23377631706131297,0.5505166335469343
2024-06-04T09:30:00-04:00,174.8,177.08,174,175.65,170.04042064418837,NaN,NaN,NaN,NaN,NaN,177.69670000000008,186.71501239422676,168.6783876057734,171.7075892515185,175.57666666666668,175.57666666666668,175.57666666666668,5013173,4191315.1,47.91814827362215,50.29499700954062,NaN,NaN,NaN,NaN,4.278294450702435,11.289511015285514,1024255632,-0.3591887897638914,0.10153064634206999,0.4607194361059614
2024-06-04T13:30:00-04:00,175.71,177.75,174.71,174.73,170.04042064418837,NaN,NaN,NaN,NaN,NaN,177.30770000000007,185.03381447235085,169.58158552764928,171.7075892515185,175.61891199967013,175.687417105825,175.55040689351526,1906445,4203444.466666667,46.27660367419978,50.279568198172726,NaN,NaN,NaN,NaN,4.189844847080832,11.24846929794929,1022349187,-0.42987794242799293,-0.0766279919290298,0.35324995049896313
2024-06-05T09:30:00-04:00,175.37,176.15,172.13,175.54,170.04042064418837,NaN,NaN,NaN,NaN,NaN,177.13090000000008,184.60193732823322,169.65986267176694,171.7075892515185,174.60666666666665,174.6066685740153,174.60666475931802,5597402,4155493.966666667,47.966716761682854,49.895651268749596,NaN,NaN,NaN,NaN,4.177713072289345,10.503883333135988,1027946589,-0.40317782643662675,-0.15072233254682033,0.2524554938898064
2024-06-05T13:30:00-04:00,175.55,175.61,174.51,174.97,170.04042064418837,NaN,NaN,NaN,NaN,NaN,176.96370000000007,184.24407274044967,169.68332725955048,171.7075892515185,174.6916007202986,174.86113426440266,174.52206717619453,1404879,4130867.2666666666,46.84976544249424,49.40686200136778,NaN,NaN,NaN,NaN,3.957876424268679,9.812482080095066,1026541710,-0.40398512004321224,-0.2525259061642089,0.15145921387900335
2024-06-06T09:30:00-04:00,174.57,178.24,172.74,178.01,170.04042064418837,NaN,NaN,NaN,NaN,NaN,176.92410000000007,184.15959962061225,169.68860037938788,170.1400714012148,176.33,176.33,176.33,6007095,4097878.2333333334,53.11976415663876,49.68897038386432,NaN,NaN,NaN,NaN,4.068028108249488,9.847169663178017,1032548805,-0.19068867522573424,-0.08690163015316443,0.10378704507256979
2024-06-06T13:30:00-04:00,178.02,179.72,177.64,177.99,170.04042064418837,NaN,NaN,NaN,NaN,NaN,176.88390000000007,184.072779548296,169.69502045170412,171.18490997448703,176.9996746601142,177.98519286342014,176.01415645680828,2773722,4131171.1,53.075403632656304,49.89627663546461,NaN,NaN,NaN,NaN,3.926026100517382,10.230005475274154,1029775083,-0.0492249403546037,0.04225586962931516,0.09148080998391886
2024-06-07T09:30:00-04:00,176.19,179.34,175.92,177.5,170.04042064418837,NaN,NaN,NaN,NaN,NaN,176.82590000000008,183.94684535577352,169.70495464422663,171.18490997448703,177.58666666666667,177.58666666666667,177.58666666666667,4591680,4129237.933333333,51.93115789595327,50.01667900388538,NaN,NaN,NaN,NaN,3.889881379051856,10.05802062705932,1025183403,0.009917572415271511,0.10387777550300825,0.09396020308773674
2024-06-07T13:30:00-04:00,177.51,177.76,175.57,177.37,170.04042064418837,NaN,NaN,NaN,NaN,NaN,176.77330000000006,183.8383185024467,169.70828149755343,171.18490997448703,177.38144700699092,177.69577548315934,177.0671185308225,1957231,4150340,51.61323701696674,50.17836466615669,NaN,NaN,NaN,NaN,3.768461280548152,9.791636663570111,1023226172,0.03731414457210688,0.14060288380287034,0.10328873923076345
2024-06-10T09:30:00-04:00,176.04,178.56,174.36,174.86,170.04042064418837,NaN,NaN,NaN,NaN,NaN,176.64370000000005,183.60586771127691,169.6815322887232,171.18490997448703,175.92666666666665,175.92666666666665,175.92666666666665,4110324,4042492.6333333333,45.78509391954423,49.684393562067875,NaN,NaN,NaN,NaN,3.799285474794712,9.171800107730684,1019115848,-0.10859428377879159,-0.03245411549272603,0.07614016828606555
2024-06-10T13:30:00-04:00,174.85,175.01,173.17,173.78,170.04042064418837,NaN,NaN,NaN,NaN,NaN,176.49530000000007,183.37853772943387,169.61206227056627,171.18490997448703,175.28990531260425,176.20086744401218,174.37894318119632,2008301,4026625.8,43.508538030134915,48.988894917329624,NaN,NaN,NaN,NaN,3.6593365123093755,8.793735352474629,1017107547,-0.26397140045738104,-0.2538240822856608,0.01014731817172028
2024-06-11T09:30:00-04:00,173.93,174.74,167.41,168.69,NaN,NaN,NaN,183.43441125789252,183.43441125789252,183.43441125789252,176.17830000000006,183.0100967212089,169.34650327879123,171.18490997448703,170.28,170.28,170.28,6229392,4045050.7666666666,34.741039100641444,48.00882743462427,NaN,NaN,NaN,NaN,3.9215267614301355,9.848124085951213,1010878155,-0.6724453700272437,-0.8304093943623343,-0.15796402433509066
2024-06-11T13:30:00-04:00,168.68,170.73,168.67,170.6,NaN,NaN,NaN,181.7785289279883,NaN,NaN,175.89330000000007,182.43715745871,169.34944254129013,171.18490997448703,170.21798615820262,170.33425377674408,170.10171853966116,1772170,4055307.3666666667,39.65511608165189,47.128908550912925,NaN,NaN,NaN,NaN,3.788560564185126,10.827199338465183,1012650325,-0.7698863774887708,-1.1203219961960542,-0.3504356187072834
2024-06-12T09:30:00-04:00,171.19,180.26,169.81,178.96,NaN,NaN,NaN,181.7785289279883,NaN,NaN,175.88470000000004,182.41126062868952,169.35813937131056,171.18490997448703,176.34333333333333,176.34333333333333,176.34333333333333,8060820,4074893.7,55.46317774387413,47.64927388217132,NaN,NaN,NaN,NaN,4.26437766674333,10.860231854434328,1020711145,-0.25389127297559944,-0.6677997099267827,-0.4139084369511833
2024-06-12T13:30:00-04:00,178.96,180.55,176.95,177.2,NaN,NaN,NaN,181.7785289279883,NaN,NaN,175.87410000000003,182.39035158814187,169.35784841185819,171.18490997448703,176.8911436213505,177.74861976253024,176.03366748017075,3289997,3996874.433333333,52.353773218701036,47.875538210625834,NaN,NaN,NaN,NaN,4.216922119118808,10.94893030141041,1017421148,-0.025711701995867475,-0.44604806444601763,-0.42033636245015016
2024-06-13T09:30:00-04:00,188.27,191.08,181.94,183.73,172.34508955652706,172.34508955652706,172.34508955652706,NaN,NaN,NaN,176.05930000000004,182.92252315242288,169.1960768475772,174.81339907090018,185.58333333333334,185.58333333333334,185.58333333333334,10923505,4137841.6,61.07350252450285,48.81520637140302,NaN,NaN,NaN,NaN,4.907141967753181,12.686722606970866,1028344653,0.5392161535372051,0.25368382947135615,-0.2855323240658489
2024-06-13T13:30:00-04:00,183.75,184.88,181.23,182.5,172.34508955652706,NaN,NaN,NaN,NaN,NaN,176.21390000000008,183.29866203975033,169.12913796024984,174.81339907090018,185.0590329725481,186.1303456147216,183.9877203303746,2616314,4133590.1666666665,58.887385648338935,49.715976512412965,NaN,NaN,NaN,NaN,4.817346112913668,14.118861530289594,1025728339,0.7891428043326593,0.7008961813499752,-0.08824662298268404
2024-06-14T09:30:00-04:00,185.8,186.01,176.92,179.15,172.34508955652706,NaN,NaN,NaN,NaN,NaN,176.33390000000003,183.41026270692493,169.25753729307513,174.81339907090018,180.6933333333333,180.6933333333333,180.6933333333333,7321496,4192206.6333333333,53.29226906070138,50.09637310520001,NaN,NaN,NaN,NaN,5.122535676276978,14.411660220613681,1018406843,0.6914391711953983,0.7760523410115638,0.08461316981616554
2024-06-14T13:30:00-04:00,179.16,179.42,177.55,177.93,172.34508955652706,NaN,NaN,NaN,NaN,NaN,176.45310000000006,183.43152299949722,169.4746770005029,174.81339907090018,180.12265096079307,181.14253074518504,179.1027711764011,2292402,4179522.4,51.377741668703734,50.419799978500684,NaN,NaN,NaN,NaN,4.890211699400049,14.683544718771763,1016114441,0.5153250909002396,0.728769533441465,0.21344444254122544
2024-06-17T09:30:00-04:00,177.94,187.28,177.01,187.1,172.34508955652706,NaN,NaN,NaN,NaN,NaN,176.82270000000005,184.05539609757804,169.59000390242207,174.81339907090018,183.79666666666665,183.79666666666665,183.79666666666665,8426794,4244038.6,62.3316315492022,51.07779050654093,NaN,NaN,NaN,NaN,5.274482292300045,16.033499883420834,1024541235,0.9611880494369007,1.4149295043373513,0.4537414549004506
2024-06-17T13:30:00-04:00,187.14,188.8,186.26,187.53,172.89792106283522,NaN,NaN,NaN,NaN,NaN,177.2039,184.64170432385654,169.76609567614346,174.81339907090018,184.9060015195711,186.61213544406206,183.19986759508015,3562554,4292802.233333333,62.7553534431243,51.76921549300293,NaN,NaN,NaN,NaN,5.079162128564329,17.465662120183055,1028103789,1.213564169416226,1.970696666670733,0.757132497254507
2024-06-18T09:30:00-04:00,186.56,187.18,182.36,184.67,172.89792106283522,NaN,NaN,NaN,NaN,NaN,177.46550000000002,185.01436329191202,169.91663670808802,174.81339907090018,184.73666666666668,184.73666666666668,184.73666666666668,6406941,4329209.1,58.07602789206978,52.20813477843983,NaN,NaN,NaN,NaN,5.08565054795259,17.879503897294104,1021696848,1.1187104420287108,2.1555205497903955,1.0368101077616847
2024-06-18T13:30:00-04:00,184.67,185.34,183.84,184.94,172.89792106283522,NaN,NaN,NaN,NaN,NaN,177.72650000000002,185.3877929065507,170.06520709344935,174.81339907090018,184.7304557001443,184.74261106463175,184.71830033565683,1672758,4330204.766666667,58.3914538544894,52.69229312397715,NaN,NaN,NaN,NaN,4.829532651670262,18.26378554746865,1023369606,1.0083916827596995,2.297299711211309,1.2889080284516097
2024-06-20T09:30:00-04:00,184.73,185.21,180.08,180.19,172.89792106283522,NaN,NaN,NaN,NaN,NaN,177.80530000000002,185.48525271078879,170.12534728921125,174.81339907090018,181.82666666666668,181.82666666666668,181.82666666666668,4702577,4338195.166666667,51.10651649129674,53.072394736245194,NaN,NaN,NaN,NaN,4.850994605122386,17.78134231799953,1018667029,0.5714998317824826,2.003282818179713,1.4317829863972302
2024-06-20T13:30:00-04:00,180.19,181.96,179.66,181.54,172.89792106283522,NaN,NaN,NaN,NaN,NaN,177.88370000000006,185.63419541899685,170.13320458100327,174.81339907090018,181.6112118689786,181.95790713434818,181.264516603609,1816153,4343137.233333333,52.904879209898844,53.74356196337119,NaN,NaN,NaN,NaN,4.668780704756502,17.243058606645757,1020483182,0.34080607202105884,1.8577905764235538,1.516984504402495
2024-06-21T09:30:00-04:00,182.3,183.95,180.69,181.46,172.89792106283522,NaN,NaN,NaN,NaN,NaN,178.00710000000007,185.7849069119697,170.22929308803043,174.41880020755258,182.0333333333333,182.03333603073162,182.033330635935,3826727,4227256.333333333,52.78098679517225,55.032129655837686,NaN,NaN,NaN,NaN,4.568153511559609,17.093814651880653,1016656455,0.15941060396751738,1.7162477593618917,1.5568371553943743
2024-06-21T13:30:00-04:00,181.45,183.62,181.04,182.99,172.89792106283522,NaN,NaN,NaN,NaN,NaN,178.18530000000007,186.00321747461447,170.36738252538566,174.41880020755258,182.1968699545584,182.43718161570385,181.95655829341294,1772180,4211916.9,54.953661049160864,56.12488286780261,NaN,NaN,NaN,NaN,4.426142546448209,16.95523097959877,1018428635,0.12080651000159315,1.7078452928963657,1.5870387828947725
2024-06-24T09:30:00-04:00,184.93,188.39,182.6,183.5,172.89792106283522,NaN,NaN,NaN,NaN,NaN,178.3699000000001,186.24497726691393,170.49482273308624,177.84101756928692,184.83,184.83,184.83,5411669,4191012.6666666665,55.685618493485656,56.14077149277487,NaN,NaN,NaN,NaN,4.523560935987622,17.626289958245454,1023840304,0.10835561381414349,1.7224833001624518,1.6141276863483083
2024-06-24T13:30:00-04:00,183.49,184.38,182.55,182.8,172.89792106283522,NaN,NaN,NaN,NaN,NaN,178.52950000000007,186.4337313351696,170.62526866483054,177.84101756928692,184.49809628975717,185.14343378341115,183.8527587961032,1431468,4172140.7666666666,54.37952493293177,56.28546804379135,NaN,NaN,NaN,NaN,4.3311637262742195,18.23599212066101,1022408836,0.035483394293523984,1.6584819292152133,1.6229985349216893
2024-06-25T09:30:00-04:00,184.19,187.98,182.01,185.46,172.89792106283522,NaN,NaN,NaN,NaN,NaN,178.69430000000008,186.82286691181554,170.56573308818463,177.84101756928692,185.15,185.15,185.15,4908750,4112255,58.37487696133268,56.09270907499348,NaN,NaN,NaN,NaN,4.448223460111775,19.347524458859635,1027317586,0.14290681862035148,1.8016320581971286,1.658725239576777
2024-06-25T13:30:00-04:00,185.45,187.74,184.69,187.43,172.9272963327696,NaN,NaN,NaN,NaN,NaN,178.89150000000006,187.37217927703148,170.41082072296865,177.84101756928692,185.53951320566895,186.188253427135,184.8907729842029,1769594,4119483.7666666666,61.09255048175414,56.250220848808844,NaN,NaN,NaN,NaN,4.348350355818078,20.379661630044072,1029087180,0.31334484461078027,2.0504062953402524,1.7370614507294722
2024-06-26T09:30:00-04:00,186.54,195.5,186.36,194.91,176.99991922673462,NaN,NaN,NaN,NaN,NaN,179.30470000000005,188.79379319376255,169.81560680623755,183.01025679637993,192.25666666666666,192.25666666666666,192.25666666666666,7163271,4191153.7,69.29093675447763,57.39298282693572,NaN,NaN,NaN,NaN,4.690611044688215,22.30940520015792,1036250451,0.865265710521679,2.818643588881571,1.9533778783598919
2024-06-26T13:30:00-04:00,194.94,197.76,194.27,196.35,182.2421956255194,NaN,NaN,NaN,NaN,NaN,179.73250000000004,190.2702466756381,169.19475332436198,186.02320543710394,193.4834801843432,195.28422916914516,191.68273119954122,3324774,4238431.333333333,70.57633572607595,58.76431097389088,NaN,NaN,NaN,NaN,4.60485311292477,24.328729047848682,1039575225,1.2399292211087038,3.5032894047457717,2.263360183637068
2024-06-27T09:30:00-04:00,195.2,198.72,194.12,196.71,182.64595946072308,NaN,NaN,NaN,NaN,NaN,180.03390000000007,191.585890874299,168.48190912570115,187.03056434968317,196.5166666666667,196.5166666666667,196.5166666666667,5716864,4242413.4,70.90422409729771,59.37663901304056,NaN,NaN,NaN,NaN,4.604506462001573,26.298919400787767,1045292089,1.4121016486674143,4.028487244471336,2.6163855958039215
2024-06-27T13:30:00-04:00,196.74,197.99,195.15,197.43,183.03477948523565,NaN,NaN,NaN,NaN,NaN,180.24890000000002,192.65615131364478,167.84164868635526,187.21845147974653,196.59792598257388,196.74292629629906,196.4529256688487,1795421,4255431.466666667,71.58620648170645,60.007414230082134,NaN,NaN,NaN,NaN,4.478470286144318,28.12838187137406,1047087510,1.4680869188123191,4.451494244319321,2.9834073255070015
2024-06-28T09:30:00-04:00,199.59,203.2,195.38,196.84,185.30365314499767,NaN,NaN,NaN,NaN,NaN,180.59210000000007,193.8383831148924,167.34581688510775,190.6727611837972,198.47333333333333,198.47333333333333,198.47333333333333,8177277,4327770.866666666,70.13548115431205,60.86880374881372,NaN,NaN,NaN,NaN,4.717150979991152,30.325187008887966,1038910233,1.3613662825847208,4.685115178737902,3.3237488961531816
2024-06-28T13:30:00-04:00,196.85,198.08,195.27,198,185.30365314499767,NaN,NaN,NaN,NaN,NaN,180.94850000000002,195.06179674455856,166.83520325544148,190.6727611837972,198.20704603061853,198.74589125864242,197.66820080259464,1997016,4301880.666666667,71.36420897012715,61.79542911421642,NaN,NaN,NaN,NaN,4.580925909991785,32.327787454006746,1040907249,1.2668372910253956,4.907295509934926,3.6404582189095303
2024-07-01T09:30:00-04:00,201.085,211.54,200.9,209.79,191.26411371269415,NaN,NaN,NaN,NaN,NaN,181.60390000000004,197.81435555066014,165.39344444933994,195.62856715763021,207.41,207.41,207.41,9494601,4465311.366666666,80.2558102988459,63.87752152904136,NaN,NaN,NaN,NaN,5.2208597735638005,35.08601734189208,1050401850,1.8603995400327102,5.965957643950418,4.105558103917708
2024-07-01T13:30:00-04:00,209.77,213.23,208.97,209.87,196.24301763484442,NaN,NaN,NaN,NaN,NaN,182.32570000000004,200.20629305615813,164.44510694384195,198.37085372610417,208.39989764127986,209.90554266026373,206.894252622296,4104045,4536871.833333333,80.30050815426566,65.8343521679247,NaN,NaN,NaN,NaN,5.152226932594957,37.72870000022602,1054505895,2.10258346399989,6.73378743391757,4.63120396991768
2024-07-02T09:30:00-04:00,218.81,231.14,218.07,227.36,207.52288046962423,NaN,NaN,NaN,NaN,NaN,183.29190000000003,205.14070032312858,161.44309967687147,208.61768298088333,225.5233333333333,225.5233333333333,225.5233333333333,15391423,4912908.466666667,87.14975980151844,68.28926452552085,NaN,NaN,NaN,NaN,6.303496437409601,40.79954375468329,1069897318,3.218107893719081,8.65383883706653,5.435730943347449
2024-07-02T13:30:00-04:00,227.36,231.31,225.87,231.24,211.54252226645949,NaN,NaN,NaN,NaN,NaN,184.3299,209.9371747858877,158.72262521411233,210.57214638470668,226.4914804952964,228.19056035290814,224.79240063768466,4997283,5012541.2,88.13529395983964,70.65938116199791,NaN,NaN,NaN,NaN,6.241818120451772,43.65538297012625,1074894601,3.9466544756993596,10.36904903797165,6.42239456227229
2024-07-03T09:30:00-04:00,234.56,248.34,234.23,246.53,222.68058943616586,NaN,NaN,NaN,NaN,NaN,185.73950000000002,216.59089039006105,154.888109609939,223.19971710776537,243.03333333333333,243.03333333333333,243.03333333333333,16142127,5342965.7,91.04873024165603,73.18531771543864,NaN,NaN,NaN,NaN,7.017402540419503,46.6556298457208,1091036728,5.113623544313382,12.814423992664018,7.700800448350636
2024-07-05T09:30:00-04:00,249.77,252.35,242.46,246.66,228.29760809815835,NaN,NaN,NaN,NaN,NaN,187.13710000000003,222.27223797269,152.00196202731007,227.29277368621229,247.15666666666667,247.15666936406498,247.15666396926835,9689883,5606889.466666667,91.06881091982373,75.80598100021665,NaN,NaN,NaN,NaN,7.222588073246681,49.50351189680548,1100726611,5.515082121079761,14.594653099700338,9.079570978620577
2024-07-05T13:30:00-04:00,246.63,251.84,246.4,251.44,230.13930773006024,NaN,NaN,NaN,NaN,NaN,188.62930000000003,227.97216985007523,149.28643014992483,229.07421894896984,247.992200093458,249.25254146416242,246.73185872275357,4258629,5480149.766666667,91.79744905048886,78.19330757801353,NaN,NaN,NaN,NaN,7.095260353729061,52.147973801384104,1104985240,5.699870578997551,16.204409202367515,10.504538623369964
2024-07-08T09:30:00-04:00,247.74,259.43,244.58,251.93,231.86206646960295,NaN,NaN,NaN,NaN,NaN,190.14290000000005,233.11959126817365,147.16620873182646,233.7923751591759,251.98000000000002,251.98000000000002,251.98000000000002,10843386,5731929.4,91.87066580189902,80.39174438659529,NaN,NaN,NaN,NaN,7.6491703284626995,54.71632084170243,1115828626,5.452398551913737,17.320036813262135,11.867638261348398
2024-07-08T13:30:00-04:00,251.93,254.33,249.86,252.91,232.25810890280283,NaN,NaN,NaN,NaN,NaN,191.63330000000002,237.9176070428841,145.34899295711594,233.7923751591759,252.07582719026678,252.24277128217935,251.9088830983542,3572731,5486903.6,92.02400773090737,82.015535170626,NaN,NaN,NaN,NaN,7.422086733572507,57.10121452199801,1119401357,4.965810455759986,18.07490133104838,13.109090875288395
2024-07-09T09:30:00-04:00,251,264.98,250.3,260.52,236.70296758903902,NaN,NaN,NaN,NaN,NaN,193.26890000000003,243.24757094231245,143.2902290576876,239.44392010187258,258.59999999999997,258.59999999999997,258.59999999999997,10251001,5741393.166666667,93.11073831660917,83.62513535566409,NaN,NaN,NaN,NaN,7.940509109745899,59.45182999763408,1129652358,4.766649816612603,19.067403146054147,14.300753329441545
2024-07-09T13:30:00-04:00,260.43,265.62,260.2,262.33,242.18555997135542,NaN,NaN,NaN,NaN,NaN,194.99640000000002,248.32091290129128,141.67188709870877,242.48113608149805,259.913369206944,261.8321616817855,257.99457673210253,4802683,5657432.733333333,93.3430603432927,85.22790937323516,NaN,NaN,NaN,NaN,7.7604727447640505,61.6418642822224,1134455041,4.377076859654441,19.772099404009595,15.395022544355154
2024-07-10T09:30:00-04:00,262.8,265.72,257.86,265.2,242.18555997135542,NaN,NaN,NaN,NaN,NaN,196.7392,253.33151903217956,140.14688096782047,243.27890886519845,262.9266666666667,262.9266666666667,262.9266666666667,9710063,5904688.1,93.70552465179956,86.80786067109896,NaN,NaN,NaN,NaN,7.767581834423763,63.14827713665153,1144165104,3.946249689026608,20.327834655638412,16.381584966611804
2024-07-10T13:30:00-04:00,265.23,267.59,263.18,263.18,244.87731807307387,NaN,NaN,NaN,NaN,NaN,198.48680000000002,257.7198020768828,139.25379792311725,247.43212709215874,263.43100717564164,264.2150910113818,262.6469233399015,4017397,5757708.2,89.99148773721103,88.22614685559174,NaN,NaN,NaN,NaN,7.52775456053635,64.58696817763474,1140147707,3.191087171336079,20.370443930781903,17.179356759445824
2024-07-11T09:30:00-04:00,263.24,271,241.32,248.09,NaN,NaN,NaN,279.782787293884,279.782787293884,279.782787293884,199.9212,260.4028045607257,139.43959543927426,247.43212709215874,253.46999999999997,253.47000467203088,253.46999532796906,18405020,6252457.066666666,68.23416498042069,88.00257228489842,NaN,NaN,NaN,NaN,9.110057806212325,62.1356274481213,1121742687,1.4308544092998332,18.967924771070614,17.53707036177078
2024-07-11T13:30:00-04:00,248.095,248.095,239.65,240.89,NaN,NaN,NaN,267.57311514416205,NaN,NaN,201.226,262.36815069818846,140.0838493018115,247.43212709215874,250.7158319008732,255.3618827541972,246.0697810475492,6467691,6254482.066666666,60.694048266391405,86.60530356829453,NaN,NaN,NaN,NaN,9.062553677197158,59.64307979634324,1115274996,-0.36680243952284286,17.078567312367227,17.44536975189007
2024-07-12T09:30:00-04:00,235.75,251.84,233.08,249.65,NaN,NaN,NaN,267.57311514416205,NaN,NaN,202.72439999999997,264.85981214605437,140.58898785394558,247.43212709215874,244.85666666666665,244.85667048136392,244.8566628519694,13004245,6632198.3,65.66529981941977,85.55993154437697,NaN,NaN,NaN,NaN,9.755228414540218,56.513707247116926,1128279241,-1.0743139069297278,16.10247736822791,17.176791275157637
2024-07-12T13:30:00-04:00,249.65,251.02,247.7,248.33,NaN,NaN,NaN,267.57311514416205,NaN,NaN,204.18019999999996,267.105571352421,141.2548286475789,247.43212709215874,245.78674143401392,247.5199673163857,244.05351555164214,3744644,6600267.2,64.34468963564322,83.93099796110016,NaN,NaN,NaN,NaN,9.29556924207306,53.60786130854965,1124534597,-1.7022879212388808,15.048931373609037,16.751219294847917
2024-07-15T09:30:00-04:00,255.97,265.6,252.88,260.5,NaN,NaN,NaN,267.57311514416205,NaN,NaN,205.89079999999998,270.1822650435033,141.59933495649668,247.43212709215874,259.66,259.66,259.66,10524839,6890556.733333333,70.27937818593742,82.65557540582144,NaN,NaN,NaN,NaN,9.865171439067842,52.036771241949275,1135059436,-1.3827098219247134,15.022832017442028,16.40554183936674
2024-07-15T13:30:00-04:00,260.48,261.09,251.75,252.7,NaN,NaN,NaN,267.57311514416205,NaN,NaN,207.38459999999998,272.48120282503265,142.2879971749673,247.43212709215874,258.4780823741408,260.4524333281398,256.5037314201418,3771735,6888723.666666667,63.037347666879384,80.65476236476596,NaN,NaN,NaN,NaN,9.827659193420136,50.43305440667578,1131287701,-1.7572644980313896,14.208961216827504,15.966225714858894
2024-07-16T09:30:00-04:00,255.23,258.61,245.85,254.5,NaN,NaN,NaN,267.57311514416205,NaN,NaN,208.91479999999999,274.76817594869385,143.0614240513061,247.43212709215874,252.98666666666665,252.98666936406497,252.98666396926833,9659848,7151645.933333334,63.96029362068874,78.71843970054204,NaN,NaN,NaN,NaN,10.037112108175842,48.205914205931826,1140947549,-1.9305986412428862,13.552977413305285,15.483576054548172
2024-07-16T13:30:00-04:00,254.49,257.48,254.26,256.56,NaN,NaN,NaN,267.57311514416205,NaN,NaN,210.49599999999998,277.0491395502875,143.94286044971244,247.43212709215874,253.86061534728526,255.25958184532408,252.46164884924644,3769880,7096919.633333334,65.0362881754583,76.80692820946841,NaN,NaN,NaN,NaN,9.550175529020427,46.13785544809816,1144717429,-1.9477323731010578,13.04891058817185,14.996642961272908
2024-07-17T09:30:00-04:00,252.75,258.46,246.56,249.9,NaN,NaN,NaN,267.57311514416205,NaN,NaN,211.9466,278.70984505115086,145.18335494884911,247.43212709215874,251.64,251.64,251.64,8453868,7330999.633333334,58.91240018519216,74.45276637970365,NaN,NaN,NaN,NaN,9.718020134090395,43.30027111416794,1136263561,-2.4181152871176064,11.9739988523759,14.392114139493506
2024-07-17T13:30:00-04:00,249.89,250.8,246.18,248.43,NaN,NaN,NaN,267.57311514416205,NaN,NaN,213.418,280.0897378204588,146.74626217954116,240.033701673727,250.87968081493415,252.2332415093612,249.5261201205071,2667423,7256288.733333333,57.62268802547773,71.99552925788723,NaN,NaN,NaN,NaN,9.353875838798226,40.622119621124845,1133596138,-2.8112027089040943,10.878110753363387,13.689313462267481
2024-07-18T09:30:00-04:00,251.14,257.13,247.2,255.98,NaN,NaN,NaN,267.57311514416205,NaN,NaN,215.062,281.7968327637074,148.3271672362926,234.7880842055586,253.43666666666664,253.43666666666664,253.43666666666664,7680016,7453302.8,62.19982762298691,69.78760706548563,NaN,NaN,NaN,NaN,9.395027564598353,38.75846554544985,1141276154,-2.5531938941703434,10.497821094554553,13.051014988724896
2024-07-18T13:30:00-04:00,255.99,256.43,247.44,249.15,NaN,NaN,NaN,267.57311514416205,NaN,NaN,216.6712,282.732611990965,150.60978800903501,234.7880842055586,252.68656618831793,253.80910502273068,251.56402735390517,3429243,7328835.2,56.27797431867301,67.14010092086993,NaN,NaN,NaN,NaN,9.3660970242699,37.02792961803736,1137846911,-2.8124945809787576,9.535396762501449,12.347891343480207
2024-07-19T09:30:00-04:00,247.95,249.01,236.83,239.28,NaN,NaN,NaN,267.57311514416205,NaN,NaN,218.0448,283.0651909234633,153.0244090765367,234.7880842055586,241.70666666666668,241.70666666666668,241.70666666666668,7024335,7452153.9,49.01552295896671,63.94795794281044,NaN,NaN,NaN,NaN,9.577090093964907,34.59341369045111,1130822576,-3.5700373248732884,7.885344687388596,11.455382012261884
2024-07-19T13:30:00-04:00,239.25,241.2,238.39,239.29,NaN,NaN,NaN,265.28099894754814,NaN,NaN,219.2514,283.561015580876,154.94178441912396,234.7880842055586,241.1863620809394,242.0872042848777,240.2855198770011,2343274,7339700.9,49.02270072228627,61.02161601317296,NaN,NaN,NaN,NaN,9.093726515824557,32.33279175769244,1133165850,-3.9615015394555293,6.503505087942472,10.465006627398001
2024-07-22T09:30:00-04:00,244.21,251.57,243.75,250.89,NaN,NaN,NaN,265.28099894754814,NaN,NaN,220.7252,284.48767150040544,156.96272849959456,233.46400754598193,248.73666666666668,248.73666666666668,248.73666666666668,5536821,7464414.233333333,56.64719495283719,60.193975296916996,NaN,NaN,NaN,NaN,9.321317478979946,30.897238656997512,1138702671,-3.354317836007615,6.272109332388482,9.626427168396097
2024-07-22T13:30:00-04:00,250.96,253.22,250.64,251.72,NaN,NaN,NaN,265.28099894754814,NaN,NaN,222.085,285.5327672735614,158.63723272643864,233.46400754598193,249.74321628925867,251.20289017241163,248.2835424061057,2632808,7279598.6,57.14114110569841,59.94019621401035,NaN,NaN,NaN,NaN,8.839794801909951,29.71871734657937,1141335479,-2.8327016080810985,6.085550158294723,8.918251766375821
2024-07-23T09:30:00-04:00,253.41,255.75,245.63,247.57,NaN,NaN,NaN,265.28099894754814,NaN,NaN,223.38640000000004,286.1991824901905,160.5736175098096,234.8090844741339,249.65,249.65,249.65,5832900,7407461.4,53.83815131792829,59.09539989247524,NaN,NaN,NaN,NaN,8.931238030344955,28.01500263431656,1135502579,-2.703417066542263,5.538980433197992,8.242397499740255
2024-07-23T13:30:00-04:00,247.42,249.45,246.32,246.38,NaN,NaN,NaN,265.28099894754814,NaN,NaN,224.73100000000002,286.5691886215951,162.89281137840493,234.8090844741339,249.1100225058005,250.07561729275753,248.14442771884345,1824089,7151777.666666667,52.893985738295136,58.27749247123608,NaN,NaN,NaN,NaN,8.516863885320316,26.432981830072517,1133678490,-2.6317538153634974,4.952705230535884,7.584459045899381
2024-07-24T09:30:00-04:00,225.21,225.98,214.71,220.79,NaN,NaN,NaN,248.2215613120379,NaN,NaN,225.58820000000003,285.97891315227184,165.19748684772821,234.8090844741339,220.49333333333334,220.49333333333334,220.49333333333334,13574533,7467460.6,37.61668686798405,55.94444309138227,NaN,NaN,NaN,NaN,10.17065932208315,26.795528975586226,1120103957,-4.151115876573921,2.3955642001819797,6.546680076755901
2024-07-24T13:30:00-04:00,220.77,221.6,215.5,215.5,NaN,NaN,NaN,245.99126307058162,NaN,NaN,226.1562,285.61527969553526,166.69712030446476,234.8090844741339,219.79691303552113,221.05246185986772,218.54136421117454,4176385,7093626,35.34406663983275,53.96635158945037,NaN,NaN,NaN,NaN,9.879897941934354,27.13217989642038,1115927572,-5.28309450216636,-0.05718805095204971,5.2259064512143105
2024-07-25T09:30:00-04:00,216.82,225.99,216.17,223.8,NaN,NaN,NaN,245.99126307058162,NaN,NaN,226.88160000000005,285.31414919785675,168.44905080214338,234.8090844741339,221.98666666666668,221.98666666666668,221.98666666666668,8898001,7223649.933333334,41.33297284429461,52.3501143911365,NaN,NaN,NaN,NaN,9.923476660367616,26.93937582296963,1124825573,-5.23360521280558,-1.3161000647926642,3.9175051480129155
2024-07-25T13:30:00-04:00,223.83,225.81,220.17,220.24,NaN,NaN,NaN,245.99126307058162,NaN,NaN,227.59300000000002,284.8059511561852,170.38004884381488,234.8090844741339,222.00805042056695,222.04541342011274,221.97068742102115,2914586,6782731.9,39.637083892962664,50.53588551381539,NaN,NaN,NaN,NaN,9.617514041769931,26.76034346905108,1121910987,-5.1911380814626975,-2.5714174538154566,2.619720627647241
2024-07-26T09:30:00-04:00,221.18,222.25,215.34,221.9,NaN,NaN,NaN,245.64155966347263,NaN,NaN,228.33220000000006,284.2623945342578,172.40200546574232,234.8090844741339,219.83,219.83,219.83,6168020,6665336.466666667,40.85567119699132,49.24611915751533,NaN,NaN,NaN,NaN,9.424120181643506,26.940864398524557,1128079007,-4.810338641047088,-3.3932026736616194,1.4171359673854687
2024-07-26T13:30:00-04:00,221.85,222.18,218.92,219.92,NaN,NaN,NaN,245.64155966347263,NaN,NaN,229.1268000000001,283.40302498884637,174.8505750111538,234.8090844741339,219.97093771583795,220.19900523945415,219.74287019222174,2355447,6601897.066666666,39.82299969337234,47.97471284807922,NaN,NaN,NaN,NaN,8.983825882954685,27.108490975892785,1125723560,-4.4587737613004546,-4.156331234240099,0.302442527060355
2024-07-29T09:30:00-04:00,224.89,234.27,224.76,231.18,NaN,NaN,NaN,245.64155966347263,NaN,NaN,230.11960000000008,282.6661789501076,177.5730210498925,234.8090844741339,230.07000000000002,230.07000000000002,230.07000000000002,8154741,6512275.566666666,47.88962565636072,46.95255556474878,NaN,NaN,NaN,NaN,9.367124034172209,25.8125653587912,1133878301,-3.288853833478246,-3.808624764787453,-0.5197709313092067
2024-07-29T13:30:00-04:00,231.15,232.94,229.22,232.13,NaN,NaN,NaN,245.64155966347263,NaN,NaN,231.13300000000007,281.80782455815597,180.45817544184413,234.8090844741339,230.37622388446292,230.94428322595672,229.8081645429691,2369741,6472175.9,48.51666951202865,46.39817664998848,NaN,NaN,NaN,NaN,8.963758031731336,24.609205857196873,1136248042,-2.3177981023184913,-3.417018559207321,-1.0992204568888295
2024-07-30T09:30:00-04:00,232.25,232.78,220,223.225,NaN,NaN,NaN,245.64155966347263,NaN,NaN,231.93770000000006,280.7734524446986,183.1019475553015,231.1322675793071,225.335,225.335,225.335,6384888,6343305.466666667,43.26167727604763,45.98718767263711,NaN,NaN,NaN,NaN,9.236346743750527,24.285454427878086,1129863154,-2.145931289213502,-3.781634568405707,-1.6357032791922048
2024-07-30T13:30:00-04:00,223.24,224.25,220.45,222.59,NaN,NaN,NaN,245.64155966347263,NaN,NaN,232.71950000000007,279.6426219016796,185.7963780983205,212.4605014734783,224.53713207664202,225.833748093141,223.24051606014305,2417645,6263804.2,42.90480605550409,45.55019519643839,NaN,NaN,NaN,NaN,8.848036262054062,23.9848281006535,1127445509,-1.951327058164948,-4.07486210189839,-2.1235350437334417
2024-07-31T09:30:00-04:00,227.96,234.68,226.79,231.01,NaN,NaN,NaN,245.64155966347263,NaN,NaN,233.6837000000001,278.3931835045073,188.9742164954929,212.5398967544209,230.8266666666667,230.8266666666667,230.8266666666667,5505542,6123653.5,48.92164175320198,44.99836996789302,NaN,NaN,NaN,NaN,9.079605100478773,22.521817163978184,1132951051,-1.170356514458796,-3.5864806868069365,-2.4161241723481406
2024-07-31T13:30:00-04:00,231.03,233.45,229.23,232.04,NaN,NaN,NaN,245.64155966347263,NaN,NaN,234.6153000000001,277.15516978870284,192.07543021129737,213.62791740353669,231.05512363143046,231.39920009910418,230.71104716375675,2427163,6070645.7,49.621044884170495,44.461220237783884,NaN,NaN,NaN,NaN,8.732490450444574,21.163307008493966,1135378214,-0.5317477485530562,-3.080808858039461,-2.549061109486405
2024-08-01T09:30:00-04:00,227.6,231.87,219.53,219.81,NaN,NaN,NaN,245.64155966347263,NaN,NaN,235.26290000000012,275.8508603867918,194.67493961320847,213.62791740353669,223.7366666666667,223.7366666666667,223.7366666666667,6082119,5659882.333333333,42.22739547152273,43.6318805344692,NaN,NaN,NaN,NaN,9.002312561127104,20.795014686373484,1129296095,-0.8608557752681785,-3.6251308285716277,-2.7642750533034492
2024-08-01T13:30:00-04:00,219.8,220.58,214.34,216.76,NaN,NaN,NaN,243.4745704356681,NaN,NaN,235.69990000000013,274.99034049078307,196.40945950921719,213.62791740353669,221.2762342794899,224.4327651772714,218.1197033817084,3695368,5567471.566666666,40.602577844615226,42.75392282777778,NaN,NaN,NaN,NaN,8.805004521046596,20.869871937590855,1125600727,-1.1914493349314972,-4.253586721967821,-3.0621373870363238
2024-08-02T09:30:00-04:00,214.78,216.13,207.21,207.5,NaN,NaN,NaN,237.80436268859228,NaN,NaN,235.9229000000001,274.43634409890956,197.40945590109064,213.62791740353669,210.28,210.28,210.28,6948502,5365613.466666667,36.06529692257128,42.6431092602483,NaN,NaN,NaN,NaN,8.858218483828981,21.45975071831086,1118652225,-1.8992358754576166,-5.4361822313583446,-3.536946355900728
2024-08-02T13:30:00-04:00,207.49,208.91,205.78,207.61,NaN,NaN,NaN,232.71825529365626,NaN,NaN,236.1409000000001,273.87964378884135,198.40215621115888,213.62791740353669,209.45939767167982,210.7488134748179,208.16998186854175,2814302,5334602.066666666,36.15656621434658,42.70114494414214,NaN,NaN,NaN,NaN,8.449060020698338,22.107401242521142,1121466527,-2.2040360762224136,-6.291991451178745,-4.087955374956332
2024-08-05T09:30:00-04:00,185.1,203.85,182,199.89,NaN,NaN,NaN,220.6371982348537,NaN,NaN,236.19010000000014,273.73275065175517,198.64744934824512,213.62791740353669,195.24666666666667,195.24666666666667,195.24666666666667,7686319,5239984.733333333,32.63540189973817,42.079889876673825,NaN,NaN,NaN,NaN,9.674841447791314,24.004652561951442,1113780208,-2.7349429798289675,-7.506634099742541,-4.771691119913574
2024-08-05T13:30:00-04:00,199.95,201.71,196,198.8,NaN,NaN,NaN,220.6371982348537,NaN,NaN,236.22930000000014,273.6112690230432,198.8473309769571,213.62791740353669,196.1778671773464,197.75135865881396,194.60437569587884,2692006,5203993.766666667,32.1591923209414,41.545754764386594,NaN,NaN,NaN,NaN,9.391638487234792,25.766385929993863,1111088202,-2.9503935678086544,-8.459683079674392,-5.509289511865737
2024-08-06T09:30:00-04:00,200.75,202.1,192.65,201.54,NaN,NaN,NaN,220.6371982348537,NaN,NaN,236.30010000000013,273.40456078249565,199.1956392175046,213.62791740353669,198.7633333333333,198.76333714803056,198.76332951863603,6084989,5084831.8,34.73719660630148,41.10872086505161,NaN,NaN,NaN,NaN,9.395807166718019,27.552311709672722,1117173191,-2.7056817765547585,-8.891391732559185,-6.185709956004427
2024-08-06T13:30:00-04:00,201.59,202.9,199.49,200.39,NaN,NaN,NaN,220.6371982348537,NaN,NaN,236.1121000000001,273.84192407008834,198.38227592991188,213.62791740353669,199.37884936788748,200.3549161514478,198.40278258432716,2419800,5039829.133333334,34.15062207122543,40.70355103489826,NaN,NaN,NaN,NaN,8.968249511952445,29.09852228330066,1114753391,-2.4274612334673433,-9.220036497838606,-6.792575264371263
2024-08-07T09:30:00-04:00,200.84,203.49,195.22,195.86,NaN,NaN,NaN,220.6371982348537,NaN,NaN,235.83190000000013,274.5327045854313,197.13109541456896,213.62791740353669,198.19000000000003,198.19000000000003,198.19000000000003,4035170,4892539.2,31.867831865423156,39.55913719268843,NaN,NaN,NaN,NaN,8.918374546812986,30.73922935350056,1110718221,-2.352993863037093,-9.733817593167629,-7.380823730130536
2024-08-07T13:30:00-04:00,195.88,196.87,191.48,191.72,NaN,NaN,NaN,220.13846186013365,NaN,NaN,235.11910000000012,275.68567331793986,194.55252668206037,209.7573339228294,196.44220467649927,198.76446411593943,194.1199452370591,2285712,4879815.5,29.900691134104918,38.22942445140817,NaN,NaN,NaN,NaN,8.666347793469203,32.435910327628285,1108432509,-2.3798868986184125,-10.355682353403552,-7.975795454785139
2024-08-08T09:30:00-04:00,195.79,199.95,192.05,199.94,NaN,NaN,NaN,220.13846186013365,NaN,NaN,234.4931000000001,276.22894909355244,192.75725090644778,199.76986713826352,197.31333333333336,197.31333333333336,197.31333333333336,4353203,4768921.733333333,38.074235933485085,37.85889292693941,NaN,NaN,NaN,NaN,8.635180093935688,33.53763924239612,1112785712,-1.6746903272167089,-10.069158363806025,-8.394468036589316
2024-08-08T13:30:00-04:00,199.95,200.7,197.65,199.11,NaN,NaN,NaN,220.13846186013365,NaN,NaN,233.5447000000001,276.28635876097775,190.80304123902243,194.7068937106108,197.91455252637058,198.77755820255413,197.05154685018704,2112746,4725038.5,37.597533873444384,37.47980205679229,NaN,NaN,NaN,NaN,8.236238658654566,34.44309283777666,1110672966,-1.1213346421846726,-9.796136339320157,-8.674801697135484
2024-08-09T09:30:00-04:00,197.01,200.22,195.11,200.22,NaN,NaN,NaN,220.13846186013365,NaN,NaN,232.61590000000012,276.18745814014216,189.0443418598581,190.20651496848865,198.51666666666668,198.51666666666668,198.51666666666668,4330771,4635253.033333333,38.70284794463941,36.74988821332354,NaN,NaN,NaN,NaN,8.012935897322096,35.43377919012475,1115003737,-0.5657956861901265,-9.382046304873143,-8.816250618683016
2024-08-09T13:30:00-04:00,200.22,200.89,199.17,199.96,NaN,NaN,NaN,220.13846186013365,NaN,NaN,231.5863000000001,275.7587490971443,187.4138509028559,186.80051242287084,198.95661177222712,199.63629295584497,198.27693058860928,1814478,4617626.5,38.53069050693157,35.95772004352076,NaN,NaN,NaN,NaN,7.563440476084804,36.2375647896842,1113189259,-0.12415120492379295,-8.971439624837757,-8.847288419913964
2024-08-12T09:30:00-04:00,199.01,199.21,194.67,197.41,NaN,NaN,NaN,220.13846186013365,NaN,NaN,230.49590000000012,275.29301641121344,185.6987835887868,186.80051242287084,197.09666666666666,197.09666666666666,197.09666666666666,4941763,4597791.233333333,36.80166328903499,35.57016774477164,NaN,NaN,NaN,NaN,7.4010518706501776,37.263713597913814,1108247496,0.07709520816143645,-8.750919409712168,-8.828014617873604
2024-08-12T13:30:00-04:00,197.43,198.83,197.01,197.45,NaN,NaN,NaN,220.13846186013365,NaN,NaN,229.38670000000013,274.65292924918566,184.12047075081463,186.80051242287084,197.2510750590247,197.53231690622513,196.9698332118243,1489580,4559683.633333334,36.849534684450816,35.30209323333132,NaN,NaN,NaN,NaN,7.00240530846088,38.21656606269846,1109737076,0.2822271335909807,-8.475230700884879,-8.75745783447586
2024-08-13T09:30:00-04:00,198.42,208.47,197.08,207.505,NaN,NaN,NaN,220.13846186013365,NaN,NaN,228.32640000000015,273.1069390784855,183.54586092151484,193.14038236050985,204.3516666666667,204.3516666666667,204.3516666666667,5043171,4533359.333333333,47.59550724337662,36.12567968481742,NaN,NaN,NaN,NaN,7.315804929285102,37.44088067846557,1114780247,1.117531718795421,-7.360543185981584,-8.478074904777005
2024-08-13T13:30:00-04:00,207.55,208.41,205.78,207.93,NaN,NaN,NaN,220.13846186013365,NaN,NaN,227.23840000000015,271.299076002074,183.1777239979263,194.83130588840788,205.11689167611985,206.43092576566553,203.80285758657416,1710286,4529565.9,47.9982968710247,36.97151758886586,NaN,NaN,NaN,NaN,6.9811045771933085,36.72060139310645,1116490533,1.6869170886370988,-6.369428543980632,-8.056345632617731
2024-08-14T09:30:00-04:00,207.55,208.4,198.76,200.71,NaN,NaN,NaN,220.13846186013365,NaN,NaN,225.9486000000001,269.2579831422229,182.63921685777734,194.83130588840788,202.62333333333333,202.62333333333333,202.62333333333333,5611133,4264119.233333333,42.08093548337771,37.646198559125814,NaN,NaN,NaN,NaN,7.171025678822359,36.650186029673456,1110879400,1.5680504588895676,-6.096282559005772,-7.6643330178953395
2024-08-14T13:30:00-04:00,200.71,201.66,199.7,201.33,NaN,NaN,NaN,220.13846186013365,NaN,NaN,224.71160000000012,267.2224675253733,182.20073247462693,194.83130588840788,202.20596535819092,202.94519424272906,201.4667364736528,1788673,4184528.8333333335,42.733824884261196,38.4015294565058,NaN,NaN,NaN,NaN,6.798809558906477,36.5848003350571,1112668073,1.5207885747563594,-5.76334729944989,-7.28413587420625
2024-08-15T09:30:00-04:00,205.02,215.79,204.84,213.92,NaN,NaN,NaN,220.13846186013365,NaN,NaN,224.0282000000001,266.1102441404625,181.94615585953773,197.73890861486484,211.51666666666665,211.51666666666665,211.51666666666665,7901462,4151310.8666666667,54.05883937182429,39.78164679690029,NaN,NaN,NaN,NaN,7.346037447556013,34.46754745990955,1120569535,2.2813159551342377,-4.432490930288452,-6.71380688542269
2024-08-15T13:30:00-04:00,213.94,215.88,213.51,214.11,NaN,NaN,NaN,220.13846186013365,NaN,NaN,223.49260000000012,265.3838282102092,181.60137178979107,200.25412689189187,212.2619764277075,213.5534952289118,210.97045762650322,2631356,4141869.8666666667,54.20602367590783,41.21417548294903,NaN,NaN,NaN,NaN,6.990606201302012,32.4904287340517,1123200891,2.711743283174182,-3.324127781454962,-6.035871064629144
2024-08-16T09:30:00-04:00,211.15,219.8,210.8,217.63,NaN,NaN,NaN,220.13846186013365,NaN,NaN,222.85220000000012,264.0983803400002,181.60601966000004,202.7993015135135,216.07666666666668,216.076669364065,216.07666396926837,6271964,4145334.6666666665,56.957291527743685,43.006279744543356,NaN,NaN,NaN,NaN,7.13413432978044,30.171486007138498,1129472855,3.1190387907673163,-2.1370725761699987,-5.256111366937315
2024-08-16T13:30:00-04:00,217.62,218.06,215.57,216.12,NaN,NaN,NaN,220.13846186013365,NaN,NaN,222.20800000000014,262.84399089476926,181.57200910523105,203.2144412108108,216.21188300290086,216.43599492309403,215.9877710827077,2283137,4142924.3333333335,55.41912571131546,44.82902507148697,NaN,NaN,NaN,NaN,6.802410449081838,28.01818204643339,1127189718,3.1623728485866165,-1.3031453062040441,-4.465518154790661
2024-08-19T09:30:00-04:00,217.07,222.38,214.1,220.82,196.32538176850116,196.32538176850116,196.32538176850116,NaN,NaN,NaN,221.4144000000001,260.5502722217848,182.2785277782154,206.36355296864863,219.1,219.1,219.1,5365775,4049958.8,59.119734125654176,46.33227494235619,NaN,NaN,NaN,NaN,6.907952559861706,26.557090538553947,1132555493,3.364411282779158,-0.260004051316713,-3.624415334095871
2024-08-19T13:30:00-04:00,220.85,222.98,220.4,222.85,200.41968259720565,NaN,NaN,NaN,NaN,NaN,220.81740000000013,258.9232083887453,182.71159161125496,208.8768423749189,219.78876785837406,221.04408899751425,218.53344671923386,1615357,4024812.6666666665,60.63947079621497,47.978127579696945,NaN,NaN,NaN,NaN,6.598813091300154,25.2739913873431,1134170850,3.4772700206376266,0.7221721917011621,-2.7550978289364645
2024-08-20T09:30:00-04:00,224.9,228.21,219.56,221.04,202.4019697518781,NaN,NaN,NaN,NaN,NaN,220.14820000000014,257.0196507314235,183.27674926857676,212.60247389993515,222.93666666666664,222.93666666666664,222.93666666666664,5191023,3985017.1666666665,58.54947758250623,49.39574398240172,NaN,NaN,NaN,NaN,6.745326441921572,24.701235497336786,1128979827,3.2753311801867264,1.3390661462969433,-1.9362650338897829
2024-08-20T13:30:00-04:00,221.04,222.47,220.58,221.08,202.4019697518781,NaN,NaN,NaN,NaN,NaN,219.43860000000012,254.8150565235097,184.06214347649055,212.60247389993515,222.66297652644798,223.25631481604844,222.0696382368475,1104502,3941245.7333333334,58.58345023760687,50.82808396316424,NaN,NaN,NaN,NaN,6.398517410355744,24.169390742330926,1130084329,2.9972668197702435,1.8103184908230219,-1.1869483289472218
2024-08-21T09:30:00-04:00,222.6,224.66,218.86,221.94,202.4019697518781,NaN,NaN,NaN,NaN,NaN,218.87940000000015,253.17971583761,184.5790841623903,212.60247389993515,221.82000000000002,221.82000000000002,221.82000000000002,4360147,3903065.9,59.35476608098121,52.43901987687468,NaN,NaN,NaN,NaN,6.355766166758904,23.935557474945263,1134444476,2.7315641584518158,2.2275068691175477,-0.5040572893342679
2024-08-21T13:30:00-04:00,221.93,223.99,221.55,223.27,202.76281619760925,NaN,NaN,NaN,NaN,NaN,218.3762000000001,251.6505441443984,185.1018558556018,212.60247389993515,222.11195368460545,222.6026450273495,221.6212623418614,1543520,3873611.1333333333,60.57752296704732,54.133876182774436,NaN,NaN,NaN,NaN,6.076068583418982,23.71842658380143,1135987996,2.5113066579398478,2.6350760330905416,0.12376937515069408
2024-08-22T09:30:00-04:00,223.905,224.8,215.52,215.67,202.76281619760925,NaN,NaN,NaN,NaN,NaN,217.5700000000001,249.06673576737535,186.07326423262487,212.60247389993515,218.66333333333336,218.66333333333336,218.66333333333336,5022275,3838283,51.11465908240812,54.38524417127668,NaN,NaN,NaN,NaN,6.304920827460483,22.453068974634157,1130965721,1.7554640521871248,2.3180994403846,0.5626353881974753
2024-08-22T13:30:00-04:00,215.65,215.8,210.32,210.75,202.76281619760925,NaN,NaN,NaN,NaN,NaN,216.8020000000001,247.028186461409,186.5758135385912,212.60247389993515,216.52406317273412,219.53368191993633,213.5144444255319,2537516,3799687.933333333,46.094719891962086,54.24927438705793,NaN,NaN,NaN,NaN,6.2459979112133075,21.19773434915547,1128428205,0.8705798782040027,1.6508602359524787,0.7802803577484759
2024-08-23T09:30:00-04:00,214.43,221.48,214.23,218.79,202.76281619760925,NaN,NaN,NaN,NaN,NaN,216.39220000000012,245.93616616298874,186.8482338370115,212.60247389993515,218.16666666666666,218.16666666666666,218.16666666666666,6149166,3773043.4,54.03843133324552,55.103381233477066,NaN,NaN,NaN,NaN,6.5662837746980705,20.14231025460333,1134577371,0.7762947352409509,1.7506487767996646,0.9743540415587136
2024-08-23T13:30:00-04:00,218.81,220.88,218.67,220.25,202.76281619760925,NaN,NaN,NaN,NaN,NaN,216.0114000000001,244.8473458343201,187.1754541656801,212.60247389993515,218.63455696692853,219.41409841165364,217.85501552220342,2215266,3753075.533333333,55.32587921551637,56.002813685709576,NaN,NaN,NaN,NaN,6.255120647933923,19.16227359537634,1136792637,0.7607947708155949,1.9253475050782072,1.1645527342626123
2024-08-26T09:30:00-04:00,218.71,219.14,211.5,212.76,202.76281619760925,NaN,NaN,NaN,NaN,NaN,215.24880000000013,242.317415151865,188.18018484813527,212.60247389993515,214.46666666666667,214.46666666666667,214.46666666666667,4566636,3649086.1,47.91130140054707,55.563703830618344,NaN,NaN,NaN,NaN,6.433326315938643,18.370533896825503,1132226001,0.22258626737906417,1.4427855684864426,1.2201993011073784
2024-08-26T13:30:00-04:00,212.79,213.44,211.01,213.2,202.76281619760925,NaN,NaN,NaN,NaN,NaN,214.4784000000001,239.46359148935613,189.49320851064408,212.60247389993515,213.983568594848,214.8157670231082,213.1513701665878,1538910,3610649.566666667,48.349217138924416,55.1453605065481,NaN,NaN,NaN,NaN,6.14737443622874,17.700532251805924,1133764911,-0.1094652877188027,1.083367691458875,1.1928329791776777
2024-08-27T09:30:00-04:00,213.2,215.66,206.95,210.14,202.76281619760925,NaN,NaN,NaN,NaN,NaN,213.7298000000001,236.87973744786024,190.57986255213996,211.8541466367668,210.91666666666666,210.91666666666666,210.91666666666666,4645225,3562657.433333333,45.48523116779896,54.32592762369491,NaN,NaN,NaN,NaN,6.33041911935526,17.607402006504103,1129119686,-0.5180073001429584,0.5453238539989798,1.0633311541419381
2024-08-27T13:30:00-04:00,210.16,210.54,209.07,209.16,202.76281619760925,NaN,NaN,NaN,NaN,NaN,212.98540000000008,234.20074537451296,191.7700546254872,211.8541466367668,210.65483016248513,211.18285611572043,210.12680420924983,1142238,3520072.033333333,44.574567704948656,53.551316337525854,NaN,NaN,NaN,NaN,5.983246325115599,17.520923921580984,1127977448,-0.8191542178179845,0.03938838186945759,0.8585425996874421
2024-08-28T09:30:00-04:00,209.73,211.83,204.2,206.01,202.76281619760925,NaN,NaN,NaN,NaN,NaN,212.68980000000008,233.87377780965238,191.50582219034777,211.8541466367668,207.3466666666667,207.3466666666667,207.3466666666667,3667740,3507824.3666666667,41.68559976677072,52.30602102617704,NaN,NaN,NaN,NaN,6.100871587607344,18.04791764701033,1124309708,-1.1738186639708397,-0.6087307302761076,0.5650879336947321
2024-08-28T13:30:00-04:00,206,206.21,202.59,205.52,NaN,NaN,NaN,223.519911858665,223.519911858665,223.519911858665,212.49020000000007,233.75242612615784,191.2279738738423,210.45131730941344,206.47260168951308,207.6913186201072,205.25388475891896,1886602,3494520.7,41.23786383180614,50.92019195729069,NaN,NaN,NaN,NaN,5.9236664742068195,18.724707191491003,1122423106,-1.3710044079149766,-1.1486675761989886,0.22233683171598795
2024-08-29T09:30:00-04:00,209.84,214.88,209.08,211.69,NaN,NaN,NaN,223.519911858665,NaN,NaN,212.24800000000008,233.2638491619974,191.23215083800275,206.38287446241966,211.88333333333335,211.88333333333335,211.88333333333335,4474878,3498576.533333333,48.70846214467598,50.21726228315996,NaN,NaN,NaN,NaN,6.169118868906331,17.81838396361305,1126897984,-1.0309983122556183,-1.066411058603535,-0.035412746347916635
2024-08-29T13:30:00-04:00,211.7,212.68,205.97,206.29,NaN,NaN,NaN,223.519911858665,NaN,NaN,211.96900000000005,232.92334580224087,191.01465419775923,206.38287446241966,210.7958024674092,212.43889765850932,209.1527072763091,1960374,3493497.466666667,43.49645553592011,49.13961980446805,NaN,NaN,NaN,NaN,6.207753235413023,17.38696037717947,1124937610,-1.1081349767032742,-1.4205814672270094,-0.3124464905237352
2024-08-30T09:30:00-04:00,208.66,210.84,207.03,210.46,NaN,NaN,NaN,223.519911858665,NaN,NaN,211.74020000000007,232.50477068758894,190.9756293124112,206.38287446241966,209.44333333333336,209.44333333333336,209.44333333333336,4429205,3496778.6,48.11367414204224,48.336684665972406,NaN,NaN,NaN,NaN,6.089342290026379,16.986352761205428,1129366815,-0.829424303875548,-1.3492268703681702,-0.5198025664926222
2024-08-30T13:30:00-04:00,210.5,214.57,210.5,214.25,NaN,NaN,NaN,223.519911858665,NaN,NaN,211.6268000000001,232.2730382781914,190.98056172180878,203.16729956993572,210.72696377996272,212.4747220811308,208.97920547879463,2389148,3515934.2666666666,51.956307611323275,47.72088356913497,NaN,NaN,NaN,NaN,5.947960697881636,15.988842425534116,1131755963,-0.3646461744562144,-0.9756102845628902,-0.6109641101066758
2024-09-03T09:30:00-04:00,215.37,219.9,212.56,215.06,NaN,NaN,NaN,223.519911858665,NaN,NaN,211.3044000000001,231.20937743178322,191.39942256821698,205.1392132222817,215.84,215.84,215.84,5756728,3543099.7666666666,52.7615054184887,47.83851545028359,NaN,NaN,NaN,NaN,6.0473920766043765,15.422707823941305,1137512691,0.003045458690767333,-0.6071572867432167,-0.610202745433984
2024-09-03T13:30:00-04:00,215.07,215.1,209.64,210.65,NaN,NaN,NaN,223.519911858665,NaN,NaN,210.8748000000001,229.8697391112429,191.87986088875732,205.1392132222817,214.7425795007924,216.54060762433366,212.94455137725114,2144514,3564930.9,48.04072289699752,47.97751566492898,NaN,NaN,NaN,NaN,6.005435499704064,14.43629104674525,1135368177,-0.04252499248354691,-0.6633589860384177,-0.6208339935548708
2024-09-04T09:30:00-04:00,210.6,222.22,210.58,220.93,NaN,NaN,NaN,223.519911858665,NaN,NaN,210.8289000000001,229.715023296215,191.94277670378517,205.1392132222817,217.91,217.91,217.91,6763157,3622263.7666666666,57.570879786644944,48.22983341160036,NaN,NaN,NaN,NaN,6.407904392582345,14.472572090308875,1142131334,0.5928471709999963,0.12022497019512457,-0.4726222008048717
2024-09-04T13:30:00-04:00,220.95,221.58,217.55,219.56,NaN,NaN,NaN,223.519911858665,NaN,NaN,210.7683000000001,229.52206374064315,192.01453625935704,205.60427716980826,218.28405580970568,218.97580807023735,217.592303549174,1977521,3631171.6,56.09426389125342,48.28471803129587,NaN,NaN,NaN,NaN,6.238054078826464,14.506261630760811,1140153813,0.8768867124887556,0.6234861898060728,-0.25340052268268276
2024-09-05T09:30:00-04:00,223.4,235,222.25,227.47,208.03703083232168,208.03703083232168,208.03703083232168,NaN,NaN,NaN,210.69750000000008,229.16967456067033,192.22532543932982,214.4994217358466,228.24,228.24,228.24,9116939,3748031.8,62.133241297821634,49.300570881101194,NaN,NaN,NaN,NaN,6.895335930338859,15.925844475128184,1149270752,1.516057268871419,1.6416710634065907,0.12561379453517196
2024-09-05T13:30:00-04:00,227.48,231.25,227.31,230.11,209.09057488539796,NaN,NaN,NaN,NaN,NaN,210.6589000000001,228.9597934525024,192.3580065474978,214.4994217358466,228.5554760873122,229.11748292591074,227.99346924871367,2872756,3784167.9,63.917081417081974,50.412561186683874,NaN,NaN,NaN,NaN,6.684240506743225,17.244028544897887,1152143508,2.0045361991119854,2.631284043425154,0.6267478443131684
2024-09-06T09:30:00-04:00,232.67,233.6,214.31,215.84,209.09057488539796,NaN,NaN,NaN,NaN,NaN,210.5795000000001,228.75491132959112,192.4040886704091,214.4994217358466,221.25,221.25,221.25,9831662,3848507.9,50.16164696116957,50.74659088621034,NaN,NaN,NaN,NaN,7.584651899118708,16.50724677777008,1142311846,1.289232226141806,2.238288126990426,0.9490559008486199
2024-09-06T13:30:00-04:00,215.88,216.18,210.54,210.62,209.09057488539796,NaN,NaN,NaN,NaN,NaN,210.45670000000013,228.54618596394587,192.36721403605438,214.4994217358466,219.044169886026,222.859005567717,215.229334204335,3287149,3870367.6666666665,46.24134893617612,50.86564668844088,NaN,NaN,NaN,NaN,7.445748192038802,15.365036205268412,1139024697,0.4315293033578542,1.4884675300459378,1.0569382266880836
2024-09-09T09:30:00-04:00,216.04,219.87,213.66,217.73,209.09057488539796,NaN,NaN,NaN,NaN,NaN,210.66130000000013,228.84356507451207,192.47903492548818,214.4994217358466,217.08666666666664,217.0866704813639,217.08666285196938,5216490,3835185.2,51.77033303179191,51.58598477879953,NaN,NaN,NaN,NaN,7.574623321178888,14.726908797791062,1144241187,0.31542393435598126,1.45121814463306,1.1357942102770788
2024-09-09T13:30:00-04:00,217.71,217.79,215.37,216.48,209.09057488539796,NaN,NaN,NaN,NaN,NaN,210.83870000000013,229.07143504551067,192.6059649544896,214.4994217358466,216.9529628993927,217.18603657219495,216.71988922659045,1716640,3816301.966666667,50.78148965226165,52.267672337403496,NaN,NaN,NaN,NaN,7.206435941094681,14.134361919419232,1142524547,0.1359893957649585,1.3057809549832768,1.1697915592183183
2024-09-10T09:30:00-04:00,220.03,226.4,218.64,221.02,209.09057488539796,NaN,NaN,NaN,NaN,NaN,211.26130000000012,229.43878748424277,193.08381251575747,214.4994217358466,222.01999999999998,222.01999999999998,222.01999999999998,6521577,3854828.7,54.202972486258865,52.66013736180228,NaN,NaN,NaN,NaN,7.400261945302205,14.510446913385804,1149046124,0.2954619417433091,1.5391189863974546,1.2436570446541455
2024-09-10T13:30:00-04:00,221,226.4,220.98,226.13,209.09057488539796,NaN,NaN,NaN,NaN,NaN,211.80790000000013,230.09695422267134,193.51884577732892,214.4994217358466,222.6407930642116,223.71608469018454,221.56550143823867,2173671,3873439.1666666665,57.76205767900547,53.679108943451226,NaN,NaN,NaN,NaN,7.258814663494905,14.859668693497621,1151219795,0.6946977190774166,2.1120291935009163,1.4173314744234997
2024-09-11T09:30:00-04:00,224.5,224.55,216.82,223.09,209.09057488539796,NaN,NaN,NaN,NaN,NaN,212.23890000000011,230.55542098952816,193.92237901047207,214.4994217358466,221.48666666666668,221.48666666666668,221.48666666666668,6065984,3902604.533333333,55.022510032844416,54.17259722136566,NaN,NaN,NaN,NaN,7.4053279018166975,14.569330405347753,1145153811,0.7015865289472847,2.2943146356076056,1.592728106660321
2024-09-11T13:30:00-04:00,223.13,228.42,222.86,228.07,209.09057488539796,NaN,NaN,NaN,NaN,NaN,212.7925000000001,231.3151140973637,194.2698859026365,214.4994217358466,223.14583768437606,225.48724118482133,220.8044341839308,3046008,3967321.4,58.495266098577005,54.639665684740926,NaN,NaN,NaN,NaN,7.2735187659726455,14.728789906724707,1148199819,0.9724173440396808,2.808249786709922,1.8358324426702413
2024-09-12T09:30:00-04:00,224.69,231.45,223.83,230.16,209.09057488539796,NaN,NaN,NaN,NaN,NaN,213.47850000000008,231.9825127810132,194.97448721898695,212.87953738867728,228.48,228.48,228.48,6818757,4049275.066666667,59.89479362706334,55.1491862710677,NaN,NaN,NaN,NaN,7.298267425546027,15.196141831671033,1155018576,1.2078351114854033,3.3456263320269954,2.137791220541592
2024-09-12T13:30:00-04:00,230.2,230.78,227.35,229.76,209.09057488539796,NaN,NaN,NaN,NaN,NaN,214.2393000000001,232.22305978598078,196.25554021401942,214.09184327903947,228.6900482460125,229.04700641618027,228.33309007584475,2361069,4076526.7,59.48140037356374,55.96637751939385,NaN,NaN,NaN,NaN,7.021962609435597,15.630111476264052,1152657507,1.2470567949070372,3.6966122141753885,2.4495554192683513
2024-09-13T09:30:00-04:00,227.99,232.67,226.32,229.18,209.09057488539796,NaN,NaN,NaN,NaN,NaN,214.8241000000001,232.8115404727264,196.8366595272738,216.14447462323156,229.39000000000001,229.39000000000001,229.39000000000001,5776974,4101683.3333333335,58.847161991536574,56.05754053402897,NaN,NaN,NaN,NaN,6.973965280190198,16.24347099038597,1146880533,1.146921034180001,3.8832067119933527,2.7362856778133517
2024-09-13T13:30:00-04:00,229.19,230.39,228.48,230.26,209.1768431122776,NaN,NaN,NaN,NaN,NaN,215.4471000000001,233.37200514228255,197.52219485771764,216.21457969858525,229.47786989686048,229.6206888319225,229.33505096179846,2186800,4089992.8,59.708677896563316,56.315712962979674,NaN,NaN,NaN,NaN,6.612253474462326,16.813019110642035,1149067333,1.0680112662088996,4.071299760574476,3.0032884943655764
2024-09-16T09:30:00-04:00,229.28,229.96,223.54,226.7,209.1768431122776,NaN,NaN,NaN,NaN,NaN,215.97670000000008,233.6334656845718,198.31993431542836,216.21457969858525,226.73333333333335,226.73333333333335,226.73333333333335,4327146,4029258.8,55.578389361587824,55.847509253248695,NaN,NaN,NaN,NaN,6.619949654857875,16.43813081979449,1144740187,0.7079939458844939,3.888280926721194,3.1802869808367
2024-09-16T13:30:00-04:00,226.7,228.45,226.34,226.77,209.1768431122776,NaN,NaN,NaN,NaN,NaN,216.51290000000012,233.8163153958051,199.20948460419513,216.21457969858525,226.84323799189545,227.03751720136202,226.64895878242888,1384781,4001575.966666667,55.64336256480544,55.25652933522894,NaN,NaN,NaN,NaN,6.297810393796596,16.090020264007485,1146124968,0.42070101877819566,3.7061632543094447,3.285462235531249
2024-09-17T09:30:00-04:00,229.5,234.58,228.4,229.61,211.69605457013552,NaN,NaN,NaN,NaN,NaN,217.1569000000001,233.9580398291846,200.35576017081559,220.42278480567566,230.86333333333334,230.86333333333334,230.86333333333334,5489265,4032330.2666666666,58.3077668200869,55.83839503943732,NaN,NaN,NaN,NaN,6.40582393709684,16.57436382020729,1151614233,0.369866768457376,3.747795696102969,3.377928927645593
2024-09-17T13:30:00-04:00,229.58,230.04,226.56,227.88,211.69605457013552,NaN,NaN,NaN,NaN,NaN,217.7655000000001,233.85669513895186,201.6743048610483,220.42278480567566,230.2368156533651,231.3775004147564,229.09613089197381,1655959,4036231.9,56.09724168976076,56.542387378979086,NaN,NaN,NaN,NaN,6.196836513018494,16.67579985061205,1149958274,0.17741532635291568,3.5996980855867378,3.422282759233822
2024-09-18T09:30:00-04:00,230.09,231.71,226.88,230.16,211.69605457013552,NaN,NaN,NaN,NaN,NaN,218.21860000000007,234.4041807483033,202.03301925169683,220.42278480567566,229.58333333333334,229.58333333333334,229.58333333333334,4161663,4020113.1666666665,58.3389185790797,57.01157206092821,NaN,NaN,NaN,NaN,6.099205333517174,16.98872501418537,1154119937,0.16179406111808792,3.624525335631432,3.4627312745133443
2024-09-18T13:30:00-04:00,230.16,235.67,226.95,227.18,211.84422345736522,NaN,NaN,NaN,NaN,NaN,218.6036000000001,234.70751990043908,202.49968009956115,221.01590582050594,229.76826102349494,229.94297919929363,229.59354284769626,4662240,4137446.566666667,54.42723615034329,57.27198252507691,NaN,NaN,NaN,NaN,6.286404952551662,17.770201535664086,1149457697,-0.07822425556189438,3.3649509550609764,3.443175210622871
2024-09-19T09:30:00-04:00,234.02,243.97,232.13,243.29,217.17948602748498,NaN,NaN,NaN,NaN,NaN,219.4552000000001,236.17567666305536,202.73472333694485,223.85172465640474,239.79666666666665,239.79666666666665,239.79666666666665,7952415,4280269.066666666,67.22241004191542,58.20194235048093,NaN,NaN,NaN,NaN,7.036661741655114,19.341315446701124,1157410112,0.7721493511581778,4.408361899570593,3.6362125484124155
2024-09-19T13:30:00-04:00,243.29,244.24,241.75,243.94,222.73360029896295,NaN,NaN,NaN,NaN,NaN,220.3074000000001,237.5801520957094,203.03464790429078,226.9003797251238,240.74496217463397,242.30458195123933,239.1853423980286,2940011,4315382.7,67.61746199027206,58.90589980128568,NaN,NaN,NaN,NaN,6.711900188679749,20.824819417688673,1160350123,1.273000534241317,5.227463216214062,3.954462681972745
2024-09-20T09:30:00-04:00,241.5,243.99,235.92,238.19,222.73360029896295,NaN,NaN,NaN,NaN,NaN,220.79280000000008,238.67364429326074,202.91195570673943,226.9003797251238,239.36666666666665,239.36666666666665,239.36666666666665,6411485,4379936.266666667,60.65327221380974,59.30809709992606,NaN,NaN,NaN,NaN,6.808907318059768,21.027372206417972,1153938638,1.1171879127767719,5.35094757294371,4.233759660166938
2024-09-20T13:30:00-04:00,238.19,240.64,237.46,238.28,222.73360029896295,NaN,NaN,NaN,NaN,NaN,221.27620000000007,239.70664433104778,202.84575566895236,226.9003797251238,239.2243838344016,239.47203497238505,238.97673269641817,2116328,4385134.733333333,60.721463107461254,59.467111171989224,NaN,NaN,NaN,NaN,6.54969965248407,21.215456938809467,1156054966,0.928107954857035,5.393894603738232,4.465786648881197
2024-09-23T09:30:00-04:00,242.6,250,241.92,247.7,225.3230397603959,NaN,NaN,NaN,NaN,NaN,221.87760000000006,241.7025424957511,202.05265750424903,231.40771441926339,246.53999999999996,246.53999999999996,246.53999999999996,7140917,4475525.133333334,67.1405237039539,59.98466332033855,NaN,NaN,NaN,NaN,6.919006820163779,22.36829885220563,1163195883,1.3213920164293267,6.117526669417856,4.796134652988529
2024-09-23T13:30:00-04:00,247.63,250.01,247.45,249.99,228.68199249855974,NaN,NaN,NaN,NaN,NaN,222.55500000000006,243.80977424015228,201.30022575984785,233.8561715354107,247.15400880075026,248.2610572019278,246.04696039957273,2196696,4469110.066666666,68.48871509200235,60.62804294308417,NaN,NaN,NaN,NaN,6.607649190152081,23.439718291469948,1165392579,1.6010423000590537,6.797437528062346,5.196395228003293
2024-09-24T09:30:00-04:00,254.15,257.19,249.27,252.44,233.01326556680704,NaN,NaN,NaN,NaN,NaN,223.18740000000005,246.02101445237787,200.35378554762224,240.30693722832856,252.9666666666667,252.9666666666667,252.9666666666667,7287842,4520147.2,69.91108552630347,61.41832319556751,NaN,NaN,NaN,NaN,6.701388533712645,25.05021573115242,1172680421,1.8013711301099002,7.448109140640668,5.646738010530767
2024-09-24T13:30:00-04:00,252.43,254.54,251.72,254.31,233.44766258649761,NaN,NaN,NaN,NaN,NaN,223.81660000000002,248.25571966008366,199.3774803399164,240.30693722832856,253.07180658910133,253.28969070242837,252.85392247577428,1697005,4505230.233333333,70.9875297166361,62.22395546842986,NaN,NaN,NaN,NaN,6.424146495590313,26.545677639428998,1174377426,1.9003613072707717,8.022189644619232,6.12182833734846
2024-09-25T09:30:00-04:00,252.61,256.91,252.28,256.14,235.17595065074775,NaN,NaN,NaN,NaN,NaN,224.51860000000005,250.5621552135262,198.4750447864739,242.6618398261303,255.11000000000004,255.11000000000004,255.11000000000004,5559930,4465122.666666667,72.04165124466778,63.399902745792716,NaN,NaN,NaN,NaN,6.295993174476721,28.127387662666663,1179937356,1.9237611370203247,8.526529758623866,6.602768621603541
2024-09-25T13:30:00-04:00,256.1,257.05,255.04,256.94,237.23454380298648,NaN,NaN,NaN,NaN,NaN,225.2358,252.79219892003454,197.6794010799655,244.64647186090423,255.37638084992585,255.88390190797284,254.86885979187886,1531677,4450261.2,72.5118431787423,64.60479421821678,NaN,NaN,NaN,NaN,5.989850804871243,29.60774883612411,1181469033,1.828438909198658,8.888317258101864,7.059878348903206
2024-09-26T09:30:00-04:00,260.6,261.75,251.54,253.25,237.2972918119416,NaN,NaN,NaN,NaN,NaN,225.86200000000005,254.49242549456744,197.23157450543266,246.72217748872336,255.51333333333332,255.51333333333332,255.51333333333332,6148068,4351298.833333333,66.92135842631856,65.22005076151903,NaN,NaN,NaN,NaN,6.291290033094726,31.358381215181602,1175320965,1.3729922517442148,8.776118663583475,7.40312641183926
2024-09-26T13:30:00-04:00,253.25,254.75,252.58,254.12,237.2972918119416,NaN,NaN,NaN,NaN,NaN,226.479,256.1694394713196,196.78856052868042,246.72217748872336,255.18101374938558,255.85436303088576,254.5076644678854,1497510,4305457.3,67.55646450202613,66.03856667668086,NaN,NaN,NaN,NaN,5.996912173587959,32.98396842430642,1176818475,1.0035810648782384,8.657602742937058,7.65402167805882
2024-09-27T09:30:00-04:00,257.375,259.86,254.13,258.81,238.30101382038484,NaN,NaN,NaN,NaN,NaN,227.3418,258.2096024329573,196.47399756704272,246.72217748872336,257.59999999999997,257.59999999999997,257.59999999999997,5802340,4171146.566666667,70.8101039371106,66.92936563082591,NaN,NaN,NaN,NaN,5.978561304045963,34.869913149101365,1182620815,0.9489565005646723,8.84021730376466,7.891260803199988
2024-09-27T13:30:00-04:00,258.76,260.69,258.16,260.65,241.2357404649128,NaN,NaN,NaN,NaN,NaN,228.33980000000003,260.207794600226,196.47180539977404,248.74035487422637,258.3134629432739,259.3547943995755,257.27213148697234,2723755,4152366.7666666666,71.9966402964531,68.18432306983377,NaN,NaN,NaN,NaN,5.7322354966141065,36.678287624596095,1185344570,0.9104543970615016,9.029328799526866,8.118874402465364
2024-09-30T09:30:00-04:00,259.04,264.86,256.83,258.45,242.38752498923495,NaN,NaN,NaN,NaN,NaN,229.13300000000004,261.9702722984112,196.29572770158887,251.2852838993811,260.0466666666667,260.0466666666667,260.0466666666667,6305759,4188675.7333333334,68.41572555771289,68.26955989239072,NaN,NaN,NaN,NaN,5.8963615325702445,38.631374539273175,1179038811,0.6241774119773957,8.899096167437108,8.274918755459712
2024-09-30T13:30:00-04:00,258.48,261.87,255.8,261.66,242.38752498923495,NaN,NaN,NaN,NaN,NaN,229.96120000000002,263.9298713640678,195.99252863593222,251.2852838993811,259.9698833107477,260.09168570127343,259.848080920222,2505878,4214983.666666667,70.70521722340598,68.49011383761457,NaN,NaN,NaN,NaN,5.9087642802437985,40.1523102235018,1181544689,0.5414379785974663,8.951716228706545,8.410278250109078
2024-10-01T09:30:00-04:00,262.72,263.98,248.54,253.08,242.38752498923495,NaN,NaN,NaN,NaN,NaN,230.76760000000004,264.9780855411312,196.5571144588689,251.2852838993811,255.20000000000002,255.20000000000002,255.20000000000002,6971766,4229989.966666667,58.49894305611378,68.33623318349343,NaN,NaN,NaN,NaN,6.589566831654958,39.74391703175688,1174572923,-0.16303502581885532,8.206484467835509,8.369519493654364
2024-10-01T13:30:00-04:00,253.09,259.15,253.03,258.02,242.38752498923495,NaN,NaN,NaN,NaN,NaN,231.66400000000004,266.33198246220786,196.9960175377922,251.2852838993811,255.63583463513217,256.32744720348774,254.9442220667766,2768602,4249821,62.51177424816348,68.46411255068645,NaN,NaN,NaN,NaN,6.556026343679602,39.36469478227945,1177341525,-0.35708254398470984,7.923166313673477,8.280248857658187
2024-10-02T09:30:00-04:00,247.56,251.15,241.49,248.58,NaN,NaN,NaN,267.33253759804916,267.33253759804916,267.33253759804916,232.43280000000001,266.8614838644752,198.00411613552487,251.2852838993811,247.07333333333335,247.07333333333335,247.07333333333335,8527240,4331862.866666666,52.13722226072201,67.39244816188418,NaN,NaN,NaN,NaN,7.268453033416772,36.831858583191405,1168814285,-1.1379171067530196,6.857852474216912,7.995769580969932
2024-10-02T13:30:00-04:00,248.56,250.05,247.34,248.99,NaN,NaN,NaN,267.33253759804916,NaN,NaN,233.22940000000003,267.3086810745761,199.15011892542395,251.2852838993811,247.41360553574887,248.09879384302113,246.72841722847662,2103011,4300429.633333334,52.505897319736434,66.25081832100804,NaN,NaN,NaN,NaN,6.942849245315574,34.479939255466796,1170917296,-1.6144082512085198,5.977759266959282,7.592167518167802
2024-10-03T09:30:00-04:00,244.48,249.79,238.92,240.22,NaN,NaN,NaN,265.3357419023547,NaN,NaN,233.9136,267.14254371116886,200.68465628883115,251.2852838993811,242.97666666666666,242.97666666666666,242.97666666666666,6624472,4293953.466666667,44.59334910390965,64.44240857655134,NaN,NaN,NaN,NaN,7.223360013507318,32.93450775327992,1164292824,-2.457330974901131,4.5205037995413875,6.977834774442519
2024-10-03T13:30:00-04:00,240.18,241.12,237.83,240.66,NaN,NaN,NaN,259.9507081795204,NaN,NaN,234.61640000000003,266.8860820585509,202.34671794144913,251.2852838993811,242.13084422173412,243.51369373893797,240.74799470453027,2478334,4297862.3,45.04084197567796,62.58907373791147,NaN,NaN,NaN,NaN,6.942405726828224,31.636289642414795,1166771158,-2.8923770733410423,3.362363432766216,6.254740506107258
2024-10-04T09:30:00-04:00,246.66,250.95,244.58,248.71,NaN,NaN,NaN,259.9507081795204,NaN,NaN,235.3568,267.1841528751617,203.52944712483827,251.2852838993811,248.08,248.08,248.08,8304208,4382103.433333334,52.585855585142035,61.19937404794535,NaN,NaN,NaN,NaN,7.181519603483351,29.764240969715594,1175075366,-2.556723435525809,3.0588362116999974,5.6155596472258065
2024-10-04T13:30:00-04:00,248.7,250.27,248.03,250.03,NaN,NaN,NaN,259.9507081795204,NaN,NaN,236.23160000000004,267.20825581950373,205.25494418049635,251.2852838993811,248.3544954070265,248.90119551656258,247.8077952974904,2093486,4378992.966666667,53.70810061704169,59.85624957925245,NaN,NaN,NaN,NaN,6.828553917520255,28.025910059352054,1177168852,-2.1792712399078464,2.891470597340998,5.070741837248844
2024-10-07T09:30:00-04:00,248.98,249.8,242.5,243.95,NaN,NaN,NaN,259.9507081795204,NaN,NaN,236.9014,267.05750293390156,206.74529706609846,247.97522711950486,245.41666666666666,245.41666936406497,245.41666396926834,5250933,4409785.866666666,48.06493886220433,58.50936246753,NaN,NaN,NaN,NaN,6.878657209125952,26.411667999303916,1171917919,-2.2626908981099394,2.2423782146114206,4.50506911272136
2024-10-07T13:30:00-04:00,243.97,244.35,240.7,240.85,NaN,NaN,NaN,259.9507081795204,NaN,NaN,237.4334,266.9030265629554,207.96377343704458,245.1441816956039,244.36223720571672,245.95156415514396,242.7729102562895,2311240,4440667.833333333,45.443171592846724,56.92984154544576,NaN,NaN,NaN,NaN,6.648038837045527,25.1480262958716,1169606679,-2.4352693409587927,1.460982436522869,3.8962517774816616
2024-10-08T09:30:00-04:00,243.65,246.21,240.56,244.3,NaN,NaN,NaN,259.9507081795204,NaN,NaN,238.0182,266.8421036051685,209.1942963948315,241.0213453564831,243.68999999999997,243.68999999999997,243.68999999999997,4632861,4412121.033333333,48.79093439285011,55.357043720855735,NaN,NaN,NaN,NaN,6.576750348685132,23.68486423871489,1174239540,-2.2311277661469795,1.1073420697979373,3.3384698359449168
2024-10-08T13:30:00-04:00,244.28,245.49,244.09,244.52,NaN,NaN,NaN,259.9507081795204,NaN,NaN,238.69559999999998,266.4884468955605,210.90275310443948,233.1828787571299,243.9322027896869,244.3634366313988,243.500968947975,1461443,4405637.166666667,49.00582350714645,53.71484252161954,NaN,NaN,NaN,NaN,6.206982466636194,22.326213757069375,1175700983,-2.00261268386582,0.8352039811126417,2.8378166649784617
2024-10-09T09:30:00-04:00,243.87,247.43,239.52,244.31,NaN,NaN,NaN,259.9507081795204,NaN,NaN,239.1632,266.5281435416931,211.79825645830687,233.1828787571299,243.75333333333333,243.75333333333333,243.75333333333333,5626731,4454472.766666667,48.795335589893945,52.31338609534676,NaN,NaN,NaN,NaN,6.328626576162179,21.71909931823082,1170074252,-1.7936771335608341,0.5957202480274191,2.389397381588253
2024-10-09T13:30:00-04:00,244.3,244.55,241,241.01,NaN,NaN,NaN,259.9507081795204,NaN,NaN,239.59220000000002,266.38089143202,212.80350856798006,233.1828787571299,243.30963203672482,244.0155082232862,242.60375585016345,2223210,4373171.766666667,45.48887036248626,50.512218462423924,NaN,NaN,NaN,NaN,6.1301532492934525,21.155350196452158,1167851042,-1.8010748295621624,0.13805384463555015,1.9391286741977125
2024-10-10T09:30:00-04:00,241.92,242.78,232.36,241.8,NaN,NaN,NaN,257.07161092894154,NaN,NaN,239.8788,266.4483231842808,213.30927681571924,233.1828787571299,238.98000000000002,238.98000000000002,238.98000000000002,8412784,4388517.4,46.424808655049546,49.64978029091934,NaN,NaN,NaN,NaN,6.43657087434392,21.70322823089343,1176263826,-1.6785589549575388,-0.15907001949921096,1.5194889354583279
2024-10-10T13:30:00-04:00,241.81,242.42,238.26,238.75,NaN,NaN,NaN,257.07161092894154,NaN,NaN,240.0516,266.4767339024046,213.62646609759543,233.1828787571299,239.14649460143698,239.47886497750486,238.8141242253691,2111035,4360884.866666666,43.33150045181702,48.279760734037446,NaN,NaN,NaN,NaN,6.2739586690336395,22.211972120017464,1174152791,-1.7222723093998193,-0.6333514512914462,1.0889208581083731
2024-10-11T09:30:00-04:00,220.13,223.33,214.4,220.01,NaN,NaN,NaN,240.49597194145295,NaN,NaN,240.135,266.2787757793335,213.99122422066648,233.1828787571299,219.24666666666667,219.24666666666667,219.24666666666667,15434518,4661652.633333334,30.07279134330696,46.703729954222084,NaN,NaN,NaN,NaN,7.565104478388379,24.50405229475212,1158718273,-2.8652571362667283,-2.4926505622250374,0.37260657404169095
2024-10-11T13:30:00-04:00,220,220.35,217.25,217.76,NaN,NaN,NaN,239.87047321684145,NaN,NaN,240.27779999999998,265.84684137115977,214.7087586288402,233.03134811113634,219.06924262016855,219.39981351717321,218.7386717231639,4446198,4739314.966666667,28.92828598090307,45.01961485859113,NaN,NaN,NaN,NaN,7.246168444217781,26.63241245700573,1154272075,-3.578443095356028,-4.100447295153344,-0.5220041997973162
2024-10-14T09:30:00-04:00,220.13,221.91,213.75,219.28,NaN,NaN,NaN,239.055451706985,NaN,NaN,240.30879999999996,265.7719572716373,214.84564272836266,233.03134811113634,218.3133333333333,218.3133333333333,218.3133333333333,10525906,4852147.933333334,30.84309469345824,44.03745382927317,NaN,NaN,NaN,NaN,7.311442126773653,28.796104621017378,1164797981,-3.736104475999178,-5.192134794796289,-1.4560303187971106
2024-10-14T13:30:00-04:00,219.28,220,218.37,219.15,NaN,NaN,NaN,239.055451706985,NaN,NaN,240.36219999999997,265.63573597421885,215.08866402578113,233.03134811113634,218.4587162361334,218.78104077439795,218.13639169786885,2141408,4850305,30.76674722578791,43.01787563285246,NaN,NaN,NaN,NaN,6.905624832004107,30.805247344742476,1162656573,-3.63409275053752,-5.99864625696901,-2.3645535064314904
2024-10-15T09:30:00-04:00,220.04,224.26,217.13,219.83,NaN,NaN,NaN,239.055451706985,NaN,NaN,240.33839999999998,265.6868792001436,214.98992079985635,233.03134811113634,220.40666666666667,220.40666666666667,220.40666666666667,6728063,4831645.7,31.718858496501966,41.527375840806734,NaN,NaN,NaN,NaN,6.921651629718099,31.830778451784315,1169384636,-3.314695435916338,-6.507922801326913,-3.193227365410575
2024-10-15T13:30:00-04:00,219.8,220.58,218.76,219.61,NaN,NaN,NaN,239.055451706985,NaN,NaN,240.20799999999997,265.91209337051384,214.50390662948612,233.03134811113634,220.26140360187895,220.5594209856596,219.9633862180983,1598517,4828362.766666667,31.56760235464489,39.94591167920697,NaN,NaN,NaN,NaN,6.557247941881093,32.783057336894586,1167786119,-2.9256694165236383,-6.850314136065123,-3.9246447195414844
2024-10-16T09:30:00-04:00,221.41,222.81,218.97,221.03,NaN,NaN,NaN,239.055451706985,NaN,NaN,240.16679999999997,265.98685435780675,214.34674564219316,231.25607848890905,220.93666666666664,220.93666666666664,220.93666666666664,5316796,4820258.3,33.76316282296598,38.924356247832804,NaN,NaN,NaN,NaN,6.363158803175302,33.21604612836228,1173102915,-2.4020656996206,-6.927226844067235,-4.525161144446635
2024-10-16T13:30:00-04:00,221.01,222.21,220.58,221.34,NaN,NaN,NaN,239.055451706985,NaN,NaN,240.0322,266.1712895908802,213.8931104091198,227.6638902329018,221.04095746546386,221.22807074868575,220.85384418224197,1651706,4824259.266666667,34.259044080218985,38.12548999693082,NaN,NaN,NaN,NaN,6.025076031519923,33.618107149010854,1174754621,-1.8869222743958005,-6.8838139874413855,-4.996891713045585
2024-10-17T09:30:00-04:00,221.48,221.63,217.91,221.07,NaN,NaN,NaN,238.22171610315468,NaN,NaN,239.85039999999998,266.38505988777854,213.31574011222142,227.6638902329018,220.2033333333333,220.2033333333333,220.2033333333333,4979094,4785293.466666667,34.020152350573454,37.0704341367682,NaN,NaN,NaN,NaN,5.860427743554213,34.24039613077408,1169775527,-1.436799833141981,-6.792891504473062,-5.356091671331081
2024-10-17T13:30:00-04:00,221.07,222.08,219.66,220.89,NaN,NaN,NaN,238.22171610315468,NaN,NaN,239.673,266.59096314731204,212.755036852688,211.78858651595317,220.3867429027502,220.68650398527433,220.08698182022607,1863991,4797509.5,33.85068472043564,35.98792422343171,NaN,NaN,NaN,NaN,5.614682904728914,34.714151144061205,1167911536,-1.0420090999399507,-6.658603046256019,-5.616593946316068
2024-10-18T09:30:00-04:00,220.71,222.28,219.24,220.945,NaN,NaN,NaN,238.22171610315468,NaN,NaN,239.5083,266.7795124856979,212.23708751430206,212.52686921276253,220.82166666666663,220.82166666666663,220.82166666666663,4780776,4763457.366666666,33.958937590897335,34.92818150921767,NaN,NaN,NaN,NaN,5.430776982962563,35.19708463683525,1172692312,-0.6852226914739763,-6.473122310658539,-5.787899619184563
2024-10-18T13:30:00-04:00,220.93,222.18,220.45,220.72,NaN,NaN,NaN,238.22171610315468,NaN,NaN,239.3175,266.9756081240221,211.65939187597792,213.51249537021002,220.89191699375252,221.01757023899916,220.76626374850588,1494334,4722476.666666667,33.715855610883054,34.08725188410316,NaN,NaN,NaN,NaN,5.166435769893809,35.64552288012543,1171197978,-0.38726717532859567,-6.271983588345307,-5.8847164130167116
2024-10-21T09:30:00-04:00,218.95,220.48,215.72,218.21,NaN,NaN,NaN,234.9904807537806,NaN,NaN,239.14770000000001,267.2147917061251,211.08060829387495,213.51249537021002,218.13666666666666,218.13666666666666,218.13666666666666,4386572,4658503.766666667,31.04604282074466,32.988768610224234,NaN,NaN,NaN,NaN,5.15454750061568,36.55277217055943,1166811406,-0.286745744845172,-6.243148594073176,-5.956402849228004
2024-10-21T13:30:00-04:00,218.21,218.96,216.93,218.9,NaN,NaN,NaN,234.34454981042694,NaN,NaN,238.99030000000002,267.41921995204984,210.56138004795017,213.51249537021002,218.16459121712097,218.21710149423623,218.1120809400057,1240535,4616325.666666667,32.625480013713386,32.2240528646454,NaN,NaN,NaN,NaN,4.9313655362859885,37.395217940248145,1168051941,-0.11037159803881469,-6.094367346776522,-5.983995748737708
2024-10-22T09:30:00-04:00,217.16,217.84,215.26,216.7,NaN,NaN,NaN,232.70047936449845,NaN,NaN,238.7321,267.72599964044224,209.73820035955777,213.51249537021002,216.6,216.6,216.6,3905516,4514117.333333333,30.24657224917425,32.23646578649307,NaN,NaN,NaN,NaN,4.83912514083699,38.346738895333296,1164146425,-0.0798817516078465,-6.083847938247516,-6.003966186639669
2024-10-22T13:30:00-04:00,216.68,218.23,216.4,217.96,NaN,NaN,NaN,232.70047936449845,NaN,NaN,238.53369999999998,267.95453838438505,209.11286161561492,213.51249537021002,216.86754842955165,217.28854472090254,216.44655213820076,1577345,4474408.766666667,33.248592839773366,32.545059133555235,NaN,NaN,NaN,NaN,4.624187630777205,39.10750921197814,1165723770,0.07856349694386289,-5.90576181545984,-5.984325312403703
2024-10-23T09:30:00-04:00,217.01,218.72,212.9,213.38,NaN,NaN,NaN,231.5574615697186,NaN,NaN,238.19809999999998,268.3666664816893,208.02953351831067,213.51249537021002,215,215,215,3969321,4322478.133333334,28.454762176588005,32.37446395377879,NaN,NaN,NaN,NaN,4.709602800007404,40.17564034057687,1161754449,-0.06397146790712505,-6.064289647287609,-6.000318179380484
2024-10-23T13:30:00-04:00,213.37,214.74,212.11,213.57,NaN,NaN,NaN,228.81530422564052,NaN,NaN,237.92589999999996,268.7261859525712,207.12561404742868,213.51249537021002,214.46176655586441,215.19115521609052,213.7323778956383,2161422,4324425.166666667,28.91266619167544,32.24202959419933,NaN,NaN,NaN,NaN,4.561059742864018,41.24480216460646,1163915871,-0.08312702085218149,-6.104226955445711,-6.021099934593529
2024-10-24T09:30:00-04:00,244.68,257.99,242.65,256.91,229.57198233007043,229.57198233007043,229.57198233007043,NaN,NaN,NaN,238.19829999999993,269.42153824397815,206.9750617560217,228.84598533306269,252.51666666666665,252.51666666666665,252.51666666666665,21119881,4807605.466666667,72.36344694054529,35.145214483059554,NaN,NaN,NaN,NaN,7.408126904088017,40.803680707137005,1185035752,2.7299750740950177,-2.6086310919747575,-5.338606166069775
2024-10-24T13:30:00-04:00,256.87,262.1,256.41,260.54,238.67416495143087,NaN,NaN,NaN,NaN,NaN,238.53029999999995,270.33823086071715,206.7223691392828,235.93978826645017,254.45610899830274,257.64011593176195,251.27210206484352,7836050,4986196,73.80750492103458,38.16235038065882,NaN,NaN,NaN,NaN,7.285403553796016,40.65455969038918,1192871802,4.630392336933933,0.449384255097641,-4.181008081836292
2024-10-25T09:30:00-04:00,256,269.44,255.31,267.18,240.80283927182037,NaN,NaN,NaN,NaN,NaN,239.11009999999996,271.9133765735407,206.30682342645923,241.4468306131601,263.9766666666667,263.9766666666667,263.9766666666667,16726798,5266949,76.25192225911397,41.19726176895511,NaN,NaN,NaN,NaN,7.774303299953443,40.94284710826553,1209598600,6.040670982765433,3.3698306466204997,-2.6708403361449333
2024-10-25T13:30:00-04:00,267.17,269.49,264.56,269.19,245.76111930491942,NaN,NaN,NaN,NaN,NaN,239.7283,273.5935502491877,205.86304975081234,244.63046449052808,264.8622072605888,266.4604268623989,263.26398765877866,5135194,5368339.266666667,76.9530930158273,44.246836692927126,NaN,NaN,NaN,NaN,7.571138778528197,41.213366020958986,1214733794,6.760567407482551,5.779868923208255,-0.9806984842742954
2024-10-28T09:30:00-04:00,269.99,273.53,266.01,269.24,248.44720479105945,NaN,NaN,NaN,NaN,NaN,240.1591,274.9542751649579,205.3639248350421,249.88237159242246,269.5933333333333,269.5933333333333,269.5933333333333,9723814,5517435.3,76.971307766839,47.314776365517524,NaN,NaN,NaN,NaN,7.567486008633324,41.6956966779268,1224457608,6.86951614904884,7.606196702036755,0.7366805529879148
2024-10-28T13:30:00-04:00,269.25,269.75,262.25,262.64,248.44720479105945,NaN,NaN,NaN,NaN,NaN,240.41209999999998,275.6704000208477,205.15379997915227,249.88237159242246,268.32120872396615,270.41349128225534,266.22892616567697,3594639,5560215.266666667,69.19708462549809,49.83951921587913,NaN,NaN,NaN,NaN,7.5626655794452295,41.557754985685534,1220862969,6.149778964526097,8.423904258645535,2.2741252941194388
2024-10-29T09:30:00-04:00,264.51,264.99,255.51,258.62,248.44720479105945,NaN,NaN,NaN,NaN,NaN,240.5357,276.0044918040647,205.0669081959353,249.88237159242246,259.70666666666665,259.70666666666665,259.70666666666665,8486177,5688659.133333334,64.89753339580133,52.04941891622941,NaN,NaN,NaN,NaN,7.699618038056286,40.46470897250415,1212376792,5.099000290784037,8.647875657599485,3.548875366815448
2024-10-29T13:30:00-04:00,258.62,259.84,257.7,259.41,248.44720479105945,NaN,NaN,NaN,NaN,NaN,240.63769999999997,276.29319333328783,204.9822066667121,249.88237159242246,259.56221873853684,259.851387888699,259.2730495883747,2117536,5710528.9,65.35313474265271,54.30922456849868,NaN,NaN,NaN,NaN,7.302502463909407,39.44973767455001,1214494328,4.191156089224253,8.787820478345765,4.5966643891215115
2024-10-30T09:30:00-04:00,258.03,263.35,255.85,262.38,248.44720479105945,NaN,NaN,NaN,NaN,NaN,240.7625,276.6769039209911,204.8480960790089,249.88237159242246,260.5266666666667,260.5266666666667,260.5266666666667,4683680,5679093.866666666,67.08288411710996,56.8832846610962,NaN,NaN,NaN,NaN,7.316609430773023,38.79781275224224,1219178008,3.5500611535260553,9.03424083102908,5.484179677503025
2024-10-30T13:30:00-04:00,262.37,262.84,257.4,257.65,248.44720479105945,NaN,NaN,NaN,NaN,NaN,240.77669999999998,276.7172299688265,204.83617003117348,249.88237159242246,260.21542620264654,260.750173941568,259.6806784637251,1586651,5657875.233333333,61.79185846307576,58.96659740747923,NaN,NaN,NaN,NaN,7.182565900003522,38.1924538958136,1217591357,2.6102794268978613,8.747028961125352,6.136749534227491
2024-10-31T09:30:00-04:00,258.02,259.74,250.68,252.6,248.44720479105945,NaN,NaN,NaN,NaN,NaN,240.7637,276.68663967982104,204.84076032017893,249.88237159242246,254.34,254.34,254.34,6519364,5594761.233333333,56.65409215378611,60.85284882923721,NaN,NaN,NaN,NaN,7.316668335717557,36.614643146380594,1211071993,1.506180510024194,8.019475171757733,6.513294661733539
2024-10-31T13:30:00-04:00,252.59,252.81,249.28,249.69,248.44720479105945,NaN,NaN,NaN,NaN,NaN,240.67510000000001,276.48751742692133,204.86268257307867,249.88237159242246,253.3680062162541,255.01025004532303,251.72576238718514,2283794,5600519.866666666,53.87430791855714,62.32611419200748,NaN,NaN,NaN,NaN,7.046192026023446,34.95136890161806,1208788199,0.49010636183561473,7.125927614028058,6.635821252192443
2024-11-01T09:30:00-04:00,252,254,246.63,248.54,NaN,NaN,NaN,271.04366259529354,271.04366259529354,271.04366259529354,240.46970000000002,275.98024842775675,204.9591515722433,249.88237159242246,249.72333333333333,249.72333333333333,249.72333333333333,5322030,5263436.933333334,52.77232325175325,64.06308284023358,NaN,NaN,NaN,NaN,7.069321167021771,33.03091609610948,1203466169,-0.30632924405122175,6.252909697128416,6.559238941179638
2024-11-01T13:30:00-04:00,248.54,249.54,246.81,248.85,NaN,NaN,NaN,268.3337233864166,NaN,NaN,240.23370000000003,275.3594036832001,205.10799631679993,249.88237159242246,249.37504465550265,249.95779418478676,248.79229512621853,1901044,5178598.466666667,53.05110718383977,65.78725719681674,NaN,NaN,NaN,NaN,6.7593696550916444,31.24763849099437,1205367213,-0.8294772207359484,5.522392415259702,6.351869635995651
2024-11-04T09:30:00-05:00,244.55,248.9,238.88,244.72,NaN,NaN,NaN,264.4987814143067,NaN,NaN,239.9591,274.72369265919923,205.1945073408008,247.08189727393798,244.16666666666666,244.16666666666666,244.16666666666666,5921411,5025115.3,48.90889757128853,64.11193224186982,NaN,NaN,NaN,NaN,6.992271822585098,29.511123193133333,1199445802,-1.43536940547751,4.557657879148763,5.993027284626273
2024-11-04T13:30:00-05:00,244.72,245.29,241.9,242.91,NaN,NaN,NaN,263.72929135002005,NaN,NaN,239.5841,273.8045135387061,205.36368646129392,244.72346512340496,244.0085323814955,244.32712455968147,243.68994020330956,1458838,5002362.966666667,47.17060732042938,62.20929669896946,NaN,NaN,NaN,NaN,6.734966692400447,27.89864470226237,1197986964,-1.9100337100164158,3.605485147105753,5.515518857122169
2024-11-05T09:30:00-05:00,247.34,254.93,246.25,254.15,NaN,NaN,NaN,263.72929135002005,NaN,NaN,239.6055,273.860966147756,205.350033852244,244.72346512340496,251.77666666666667,251.776669364065,251.77666396926836,5533874,4962556.666666667,57.31605833208492,60.85673498989596,NaN,NaN,NaN,NaN,7.112469071514702,26.66066085390295,1203520838,-1.440390368355584,3.715030896677689,5.155421265033273
2024-11-05T13:30:00-05:00,254.19,255.26,250.83,251.46,NaN,NaN,NaN,263.72929135002005,NaN,NaN,239.4743,273.49610089354564,205.45249910645438,244.72346512340496,251.98925643023233,252.32410268968314,251.65441017078152,2230607,4983626.333333333,54.61295843789825,59.26101109147245,NaN,NaN,NaN,NaN,6.920864137835079,25.549419827969043,1201290231,-1.2891898843242107,3.5439339096280094,4.83312379395222
2024-11-06T09:30:00-05:00,284.73,289.59,275.62,289.23,257.82373852436746,257.82373852436746,257.82373852436746,NaN,NaN,NaN,240.2873,276.9786659167932,203.59593408320677,257.01166479683064,284.81333333333333,284.81333333333333,284.81333333333333,15747863,5331328.566666666,73.50627475851238,59.01350873373484,NaN,NaN,NaN,NaN,9.150088127989715,27.069535656340353,1217038094,1.2394916091738581,6.3824883054195425,5.142996696245684
2024-11-06T13:30:00-05:00,289.22,289.43,284.77,289,262.809704955078,NaN,NaN,NaN,NaN,NaN,241.0875,280.1703640838925,202.00463591610756,261.03733183746454,285.4226546769771,286.6092236061143,284.2360857478399,4152680,5414694.366666666,73.3061585265906,59.3070140123843,NaN,NaN,NaN,NaN,8.829367547419023,28.48107178268514,1212885414,2.69787820043537,8.515344446789896,5.817466246354527
2024-11-07T09:30:00-05:00,288.83,299.75,285.53,296.84,267.5147183662108,NaN,NaN,NaN,NaN,NaN,242.21989999999997,284.3025334960164,200.13726650398354,269.9258654699716,294.03999999999996,294.03999999999996,294.03999999999996,12115549,5652576.2,75.73150433583521,60.08086907952958,NaN,NaN,NaN,NaN,9.214412722603381,30.258524340324172,1225000963,3.9178331839145253,10.714757726247683,6.796924542333158
2024-11-07T13:30:00-05:00,296.82,299.65,295.47,296.8,273.00677662229214,NaN,NaN,NaN,NaN,NaN,243.34269999999998,288.10908967841885,198.5763103215811,273.70069237597727,294.8826920518867,296.3119100695014,293.453474034272,4211957,5730841.733333333,75.69371658574747,60.81948206832207,NaN,NaN,NaN,NaN,8.854811813845993,31.909016000988995,1220789006,4.412579073504094,12.312648384213276,7.900069310709181
2024-11-08T09:30:00-05:00,299.17,321.82,297.66,321.09,282.8910140485516,NaN,NaN,NaN,NaN,NaN,244.7903,294.5589069891451,195.02169301085488,288.55055390078184,313.5233333333333,313.5233333333333,313.5233333333333,20216344,6245360.666666667,81.67371525845542,61.861684292703885,NaN,NaN,NaN,NaN,10.009468112856991,34.222473650990054,1241005350,5.969469156019651,15.361905755733744,9.392436599714094
2024-11-08T13:30:00-05:00,321.07,328.71,316.7,321.32,295.4386952281629,NaN,NaN,NaN,NaN,NaN,246.2161,300.392938788914,192.039261211086,296.08944312062545,316.4436740266999,320.5591303903177,312.3282176630821,10179669,6534871.833333333,81.71957734055464,63.28509278395238,NaN,NaN,NaN,NaN,10.15236324765292,36.55620788373804,1251185019,6.561417271585363,17.594208189195797,11.032790917610434
2024-11-11T09:30:00-05:00,346.48,358.63,336,340.62,316.20034544506456,NaN,NaN,NaN,NaN,NaN,248.14950000000002,308.42167109910633,187.8773289008937,313.8785544965004,345.0833333333333,345.0833371480306,345.08332951863605,20223607,7062773,85.09118238942453,65.31631351506941,NaN,NaN,NaN,NaN,12.09219444424914,39.323519558015796,1271408626,7.7195756097362,20.682260429780683,12.962684820044483
2024-11-11T13:30:00-05:00,340.65,350.76,340.47,350.63,316.20034544506456,NaN,NaN,NaN,NaN,NaN,250.34510000000003,317.04869500026905,183.64150499973104,313.8785544965004,345.5739594644647,346.4906376568442,344.65728127208513,5793302,7214531.9,86.48361000743552,67.64554937856072,NaN,NaN,NaN,NaN,11.963466269659914,41.89316611270228,1277201928,8.5614504010464,23.664497821352484,15.103047420306083
2024-11-12T09:30:00-05:00,342.61,345.83,323.32,325.08,316.20034544506456,NaN,NaN,NaN,NaN,NaN,251.9607,321.8379487726869,182.0834512273131,313.8785544965004,331.41,331.4100038146973,331.40999618530276,11734442,7475496.1,68.8165645875658,68.79156661683304,NaN,NaN,NaN,NaN,13.059647250398493,42.471346116187796,1265467486,6.872082922311403,23.693151073195338,16.821068150883935
2024-11-12T13:30:00-05:00,325.08,334.15,325.03,328.32,316.20034544506456,NaN,NaN,NaN,NaN,NaN,253.6367,326.6683663266007,180.6050336733993,313.8785544965004,330.76170487089297,331.77859006526376,329.7448196765222,4769404,7581898.066666666,69.66290086275214,69.97812330818392,NaN,NaN,NaN,NaN,12.778243875370029,43.00822754799579,1270236890,5.5063889360577,23.70405432095606,18.19766538489836
2024-11-13T09:30:00-05:00,335.92,344.59,322.5,330.3,316.20034544506456,NaN,NaN,NaN,NaN,NaN,255.35649999999998,331.415788564908,179.29721143509198,313.8785544965004,332.4633333333333,332.4633333333333,332.4633333333333,11334136,7827391.9,70.19526540184789,71.49857815322389,NaN,NaN,NaN,NaN,13.443369312843597,43.83722615154255,1281571026,4.322198729131877,23.600413796313205,19.27821506718133
2024-11-13T13:30:00-05:00,330.3,332.25,324.2,330.21,316.20034544506456,NaN,NaN,NaN,NaN,NaN,257.1405,335.90637271782106,178.3746272821789,313.8785544965004,331.6611722839354,333.1530168929756,330.1693276748952,3276909,7864574.8,70.13501887860673,73.13889326452227,NaN,NaN,NaN,NaN,13.058128647640483,44.60701056912169,1278294117,3.171895052907729,23.24308388331599,20.07118883040826
2024-11-14T09:30:00-05:00,327.67,329.99,314.27,314.52,NaN,NaN,NaN,356.91815955957935,356.91815955957935,356.91815955957935,258.5949,338.8455552867949,178.34424471320511,313.8785544965004,319.5933333333333,319.5933333333333,319.5933333333333,9572546,7479663.633333334,60.40213434025688,73.35932726510599,NaN,NaN,NaN,NaN,13.263976601380449,44.29918293693188,1268721571,1.1003466711409828,21.44662216933449,20.346275498193506
2024-11-14T13:30:00-05:00,314.56,316.27,310.37,311.19,NaN,NaN,NaN,347.33142503414393,NaN,NaN,260.0437,341.4167025698939,178.67069743010606,313.8785544965004,317.4095226607678,320.64699834558706,314.1720469759485,4355564,7363647.433333334,58.54516944516951,73.64019947991108,NaN,NaN,NaN,NaN,12.737978272710416,43.63565485213666,1264366007,-0.653747643194901,19.52909094419988,20.18283858739478
2024-11-15T09:30:00-05:00,310.84,324.65,309.22,319.89,NaN,NaN,NaN,347.33142503414393,NaN,NaN,262.0413,344.2843211217949,179.79827887820505,313.8785544965004,317.92,317.92,317.92,10744755,7164246,61.84549606774741,72.807286716285,NaN,NaN,NaN,NaN,12.930265538945383,43.391897464575976,1275110762,-1.3476988568666073,18.49821501631152,19.845913873178127
2024-11-15T13:30:00-05:00,319.85,322.08,316.48,320.75,NaN,NaN,NaN,347.33142503414393,NaN,NaN,264.10110000000003,346.96130548586575,181.24089451413434,313.8785544965004,318.3252503030095,319.09042038377163,317.5600802222474,3013889,7093535.833333333,62.16614240639573,72.01157127912823,NaN,NaN,NaN,NaN,12.406675143306424,43.165551318983916,1278124651,-1.8380536501304547,17.548346810515056,19.38640046064551
2024-11-18T09:30:00-05:00,340.7,348.55,335.01,338.85,305.7618841809535,305.7618841809535,305.7618841809535,NaN,NaN,NaN,266.4925,350.9271838745783,182.05781612542174,309.81384359720033,340.80333333333334,340.80333333333334,340.80333333333334,10315536,7113259.9,68.21961329494782,71.47500763335054,NaN,NaN,NaN,NaN,13.506198347355966,43.92512144430257,1288440187,-1.070687122579777,18.048041557420788,19.118728680000565
2024-11-18T13:30:00-05:00,338.93,339.5,330.01,338.88,305.7618841809535,NaN,NaN,NaN,NaN,NaN,268.88710000000003,354.5969035953873,183.1772964046128,309.74026528048364,339.46581644018215,341.57809266293816,337.35354021742614,4136080,7131307.933333334,68.22868703554198,70.94179123690729,NaN,NaN,NaN,NaN,13.21932703683054,44.145297810171726,1292576267,-0.7059767312959551,18.236257765880623,18.942234497176578
2024-11-19T09:30:00-05:00,335.84,347.37,332.77,346.2,305.7618841809535,NaN,NaN,NaN,NaN,NaN,271.41450000000003,358.6284568245811,184.20054317541891,311.4357697795095,342.1133333333333,342.11333714803055,342.113329518636,7532219,7099509.333333333,70.44595708728222,70.13980851039491,NaN,NaN,NaN,NaN,13.31794653419979,44.61335834642516,1300108486,-0.14592229383920952,18.759831629877567,18.905753923716777
2024-11-19T13:30:00-05:00,346.22,346.37,341.02,345.98,308.55949656271696,NaN,NaN,NaN,NaN,NaN,273.94190000000003,362.32078813262996,185.5630118673701,314.9476158236076,342.7568803178211,343.8027734189944,341.7109872166479,2851733,7123982.566666666,70.28719167225036,69.32320953408747,NaN,NaN,NaN,NaN,12.748807496042662,45.04798598723191,1297256753,0.026358429497609137,18.938701960588787,18.912343531091178
2024-11-20T09:30:00-05:00,345,346.59,334.3,341.01,308.55949656271696,NaN,NaN,NaN,NaN,NaN,276.3415,365.3565123125307,187.3264876874693,315.30709265888606,340.6333333333333,340.6333333333333,340.6333333333333,6062940,7169957.9,66.63366787674019,68.00481564032431,NaN,NaN,NaN,NaN,12.716035532039612,44.75709249374359,1291193813,-0.3566351182748555,18.46654963324761,18.823184751522465
2024-11-20T13:30:00-05:00,340.92,342.7,337.42,341.93,308.55949656271696,NaN,NaN,NaN,NaN,NaN,278.7533,368.2102181586305,189.29638184136957,315.30709265888606,340.64490997535086,340.6660005765005,340.6238193742012,1826714,7177960,66.9758704337487,66.61140567077526,NaN,NaN,NaN,NaN,12.184890136893923,44.486977106933004,1293020527,-0.6908877836269127,17.959575021988826,18.65046280561574
2024-11-21T09:30:00-05:00,343.95,347.96,335.28,343.41,308.55949656271696,NaN,NaN,NaN,NaN,NaN,281.2001,370.90429692500425,191.49590307499577,319.4869393016871,342.2166666666667,342.2166666666667,342.2166666666667,5737213,7151888.3,67.55239262894786,66.52110767373111,NaN,NaN,NaN,NaN,12.220255127115786,44.469420321387865,1298757740,-0.9397559663525001,17.475767847675115,18.415523814027615
2024-11-21T13:30:00-05:00,343.42,343.79,338.1,339.56,308.55949656271696,NaN,NaN,NaN,NaN,NaN,283.5735,373.0486161888035,194.09838381119653,319.4869393016871,341.85957144333986,342.5606050054749,341.15853788120484,1488646,7125383.366666666,64.4026706109415,66.14537694145892,NaN,NaN,NaN,NaN,11.753808332321801,44.453117591953095,1297269094,-1.4600669823742507,16.5904400860598,18.05050706843405
2024-11-22T09:30:00-05:00,341.01,356.63,337.7,351.43,312.4061097583779,NaN,NaN,NaN,NaN,NaN,286.18320000000006,375.81092075111525,196.55547924888486,326.66624115307974,348.58666666666664,348.58666666666664,348.58666666666664,9026103,7248852.466666667,69.17479862991519,66.07248645774943,NaN,NaN,NaN,NaN,12.266393451441672,44.97734305689205,1306295197,-1.1166960811437043,16.65463696700442,17.771333048148126
2024-11-22T13:30:00-05:00,351.42,354.75,350.71,352.65,319.00015022390625,NaN,NaN,NaN,NaN,NaN,288.82180000000005,378.35320165908183,199.29039834091827,328.7589929224638,349.5159693556358,351.2370230779772,347.79491563329435,2631636,7273205.533333333,69.62550892023992,66.03609288929468,NaN,NaN,NaN,NaN,11.67879391919584,45.46412384576394,1308926833,-0.9270990999195092,16.612459173248737,17.539558273168247
2024-11-25T09:30:00-05:00,360.31,361.93,345.6,350.06,319.3415070319105,NaN,NaN,NaN,NaN,NaN,291.4588,380.2798789972743,202.6377210027257,332.972194337971,352.53,352.53,352.53,8023962,7343290.566666666,67.37332351561255,66.53403497324865,NaN,NaN,NaN,NaN,12.011022924967564,46.1941404782308,1300902871,-1.0848558724730353,16.18348843257695,17.268344305049986
2024-11-25T13:30:00-05:00,350.08,351,338.2,338.45,319.3415070319105,NaN,NaN,NaN,NaN,NaN,293.8498,381.15265232362077,206.54694767637926,332.972194337971,350.2253474128779,354.43117780319847,346.01951702255735,2409330,7374973.633333334,58.273662566219144,66.5146416247522,NaN,NaN,NaN,NaN,12.067378430327025,45.95747212923867,1298493541,-2.0252200994942484,14.736819180682176,16.762039280176424
2024-11-26T09:30:00-05:00,341,346.96,338.48,342.94,319.3415070319105,NaN,NaN,NaN,NaN,NaN,296.3746,381.8901544410494,210.85904555895058,332.972194337971,342.79333333333335,342.79333333333335,342.79333333333335,5026058,7358046.433333334,60.49584069065757,66.41823766924578,NaN,NaN,NaN,NaN,11.813279971017952,45.7377086623174,1303519599,-2.374731796960191,13.793624533976185,16.168356330936376
2024-11-26T13:30:00-05:00,342.94,343.4,335.66,338.16,319.3415070319105,NaN,NaN,NaN,NaN,NaN,298.7786,382.07065724533425,215.48654275466572,332.972194337971,341.6343395491059,343.3571832116241,339.9114958865877,2274563,7359511.633333334,57.01469917675947,66.05027743855747,NaN,NaN,NaN,NaN,11.522331401659525,45.175699973430454,1301245036,-2.921763844360248,12.516151525486066,15.437915369846314
2024-11-27T09:30:00-05:00,341.97,342.55,326.61,331.7,319.3415070319105,NaN,NaN,NaN,NaN,NaN,301.145,381.2601622353725,221.02983776462747,332.972194337971,333.62000000000006,333.62000000000006,333.62000000000006,5499920,7017913.533333333,52.60871286857791,64.9352131223882,NaN,NaN,NaN,NaN,11.837879158683844,43.589192243509075,1295745116,-3.664475881041998,10.857320518543816,14.521796399585813
2024-11-27T13:30:00-05:00,331.69,334.44,331.38,332.98,319.3415070319105,NaN,NaN,NaN,NaN,NaN,303.5332,380.10442273439196,226.96197726560808,332.972194337971,333.47072659186693,333.7539553390253,333.18749784470856,1527730,6930415.2,53.377513746506466,63.87441503031423,NaN,NaN,NaN,NaN,11.210887790206426,42.11600649429637,1297272846,-3.988601352088974,9.536044709474595,13.524646061563569
2024-11-29T09:30:00-05:00,336,345.45,334.68,345.11,319.3415070319105,NaN,NaN,NaN,NaN,NaN,305.2972,381.5539896560044,229.04041034399557,332.972194337971,341.74666666666667,341.74666666666667,341.74666666666667,4368505,6672180.4,59.99986664633516,63.12826571310372,NaN,NaN,NaN,NaN,11.300824376620252,41.47629653849833,1301641351,-3.3318611986670224,9.359819563229792,12.691680761896814
2024-12-02T09:30:00-05:00,352.43,359.43,351.18,356,321.486191507287,NaN,NaN,NaN,NaN,NaN,307.2064,383.6650368447679,230.74776315523206,332.972194337971,355.5366666666667,355.5366666666667,355.5366666666667,7208519,6772065.8,64.8298230066184,62.73845366555857,NaN,NaN,NaN,NaN,11.516479778290233,41.61390496370236,1308849870,-2.166300795902824,9.983804767018285,12.150105562921109
2024-12-02T13:30:00-05:00,355.91,360,355.36,357.08,324.7656828024103,NaN,NaN,NaN,NaN,NaN,309.00440000000003,385.8406739502635,232.16812604973657,335.3296927952212,356.01234088775544,356.84788119499444,355.17680058051644,2336310,6176064.666666667,65.27761047106279,62.6415924222959,NaN,NaN,NaN,NaN,11.0253026512695,41.76870432877772,1311186180,-1.3640361649871888,10.445060356687122,11.809096521674311
2024-12-03T09:30:00-05:00,351.72,355.69,348.2,349.07,324.7656828024103,NaN,NaN,NaN,NaN,NaN,310.60200000000003,387.38226413082964,233.82173586917042,335.3296927952212,350.9866666666667,350.9866666666667,350.9866666666667,4956745,6001967.2,59.252090891350214,62.08989388355315,NaN,NaN,NaN,NaN,10.872066747607393,41.06086763308858,1306229435,-1.4085279730560316,10.048436555354272,11.456964528410303
2024-12-03T13:30:00-05:00,349.07,351.61,348.22,351.41,324.7656828024103,NaN,NaN,NaN,NaN,NaN,312.2454,388.931540412463,235.55925958753704,335.3296927952212,350.83508046516044,351.0879263584109,350.58223457190996,1781575,5387232.8,60.4020206243925,61.57915302608492,NaN,NaN,NaN,NaN,10.337633408492579,40.403590701377226,1308011010,-1.317694837904531,9.809845981029639,11.12754081893417
2024-12-04T09:30:00-05:00,353.05,354.8,348.6,352.13,324.7656828024103,NaN,NaN,NaN,NaN,NaN,314.03520000000003,390.18214638552456,237.88825361447547,335.3296927952212,351.8433333333334,351.8433333333334,351.8433333333334,3940380,5325468.733333333,60.76887864536556,61.3195964571152,NaN,NaN,NaN,NaN,10.042088165028824,39.99322944900491,1311951390,-1.247185595368368,9.56855882472371,10.815744420092077
2024-12-04T13:30:00-05:00,352.13,358.1,351.21,357.93,324.7656828024103,NaN,NaN,NaN,NaN,NaN,316.0214,391.4604496239176,240.58235037608245,338.71196216892264,353.0914283573608,354.9118650416246,351.27099167309706,1852176,4996059.866666666,63.687397789798986,60.92763925424976,NaN,NaN,NaN,NaN,9.81693901038391,39.81645267225621,1313803566,-0.8660748655437622,9.733150838162373,10.599225703706136
2024-12-05T09:30:00-05:00,359.84,375.43,359.51,369.26,335.92546955603484,NaN,NaN,NaN,NaN,NaN,318.21840000000003,393.33233216814,243.10446783186006,351.16956973513805,368.06666666666666,368.06666666666666,368.06666666666666,7951583,5102132.5,68.60133504609018,60.85448397752477,NaN,NaN,NaN,NaN,10.365729081070773,40.53781480717411,1321755149,0.04462204566864614,10.655003260791943,10.610381215123297
2024-12-05T13:30:00-05:00,369.14,372.7,366.54,369.39,338.66931184894236,NaN,NaN,NaN,NaN,NaN,320.3586,395.08362552799804,245.633574472002,351.16956973513805,368.41257597415216,369.0379874347451,367.7871645135592,2432464,4805410.1,68.65375008979449,60.94594301853777,NaN,NaN,NaN,NaN,10.065319860994288,41.20765107531215,1324187613,0.5246535412185604,11.266198141646498,10.741544600427938
2024-12-06T09:30:00-05:00,377.32,377.52,370.8,376.2,343.50752494671764,NaN,NaN,NaN,NaN,NaN,322.7296,396.86605763967987,248.59314236032014,355.46432463048836,374.84,374.84,374.84,5336602,4874066.533333333,71.35168970173234,61.88008781393156,NaN,NaN,NaN,NaN,9.927082728066125,42.0448312977269,1329524215,1.1346944561507186,12.159912670616336,11.025218214465617
2024-12-06T13:30:00-05:00,376.2,389.48,375.6,389.41,351.38809199459416,NaN,NaN,NaN,NaN,NaN,325.4658,399.1442662261646,251.78733377383543,364.8954597043907,378.9955794223631,383.91954104831626,374.07161779640995,3801007,4681681.9,75.71763257018105,62.96735866246896,NaN,NaN,NaN,NaN,10.209433961775687,43.28781397902265,1333325222,2.200090253887577,13.77533103182509,11.575240777937513
2024-12-09T09:30:00-05:00,397.77,404.81,378.01,386.64,358.0195423584762,NaN,NaN,NaN,NaN,NaN,328.20480000000003,400.5825090811801,255.82709091881998,371.74236776351256,389.82,389.82,389.82,8321512,4813880.166666667,73.19854581498943,64.12334770805681,NaN,NaN,NaN,NaN,11.394474393077425,44.90685821668038,1325003710,2.470223143748475,14.663019707623107,12.192796563874632
2024-12-09T13:30:00-05:00,386.67,390,382.48,389.85,358.0195423584762,NaN,NaN,NaN,NaN,NaN,331.031,401.7620057329883,260.2999942670117,371.74236776351256,389.3351301059485,390.29287500969735,388.37738520219966,2132814,4526815.466666667,74.26697770197495,65.67036662472803,NaN,NaN,NaN,NaN,11.117726222143322,46.410256437362534,1327136524,2.603739328705812,15.447470724756897,12.843731396051085
2024-12-10T09:30:00-05:00,392.68,409.19,390.85,408.01,365.9799342563802,NaN,NaN,NaN,NaN,NaN,334.2142,404.18639517379813,264.2420048262019,375.3487153686481,402.68333333333334,402.68333333333334,402.68333333333334,7875690,4688875.5,79.29557773657866,67.5216569097332,NaN,NaN,NaN,NaN,11.705031491990226,48.26577352230473,1335012214,3.592767296156101,17.334690516246212,13.741923220090111
2024-12-10T13:30:00-05:00,408.02,409.73,399.53,400.89,370.7463008810902,NaN,NaN,NaN,NaN,NaN,337.3376,404.95417803349744,269.7210219665026,377.55697229491847,402.8834612712355,403.1997496918651,402.56717285060586,3153098,4450127.566666666,73.25160784438094,68.46820985245074,NaN,NaN,NaN,NaN,11.597529242562356,49.99998312791371,1331859116,3.444667809790033,18.047757982327653,14.60309017253762
2024-12-11T09:30:00-05:00,409.7,417.86,402.39,417.33,375.4673781137679,NaN,NaN,NaN,NaN,NaN,340.82599999999996,406.5671810055172,275.0848189944827,383.63657783593476,412.5266666666666,412.5266760107284,412.52665732260476,6906822,4542485.633333334,77.5134936869286,69.37418632961575,NaN,NaN,NaN,NaN,11.981277153807904,51.77605528829782,1338765938,4.0872955498105625,19.712209609800823,15.62491405999026
2024-12-11T13:30:00-05:00,417.35,424.88,415.1,424.8,385.57408819950575,NaN,NaN,NaN,NaN,NaN,344.23900000000003,409.3421558374859,279.13584416251416,392.6112622687478,415.6988389501157,420.0229980252916,411.37467987493983,3716965,4415310.5,79.1398824128118,70.36434861116926,NaN,NaN,NaN,NaN,11.824043071393051,53.556075671642276,1342482903,4.610087970596986,21.387524023236494,16.77743605263951
2024-12-12T09:30:00-05:00,424.83,429.3,416.79,423.41,388.48753873589186,NaN,NaN,NaN,NaN,NaN,347.67800000000005,410.95455464704065,284.40144535295946,397.23000981499825,423.16666666666674,423.16666666666674,423.16666666666674,6639034,4541553.866666666,78.00923480118578,71.70414460472895,NaN,NaN,NaN,NaN,11.873039994864977,55.28731544374944,1335843869,4.4544324678778295,22.345476637486797,17.891044169608968
2024-12-12T13:30:00-05:00,423.33,423.75,415,417.74,388.48753873589186,NaN,NaN,NaN,NaN,NaN,350.2482,414.2552298251688,286.2411701748312,397.23000981499825,421.9576964127562,423.90225084148267,420.01314198402974,2566232,4424996.933333334,73.40247553577791,72.63274852697076,NaN,NaN,NaN,NaN,11.649965709517478,56.63939265107839,1333277637,3.598406515313986,22.38905231375145,18.790645798437463
2024-12-13T09:30:00-05:00,420,431.6,415.71,428.6,388.8619619473725,NaN,NaN,NaN,NaN,NaN,353.0402,418.2838342936229,287.7965657063772,399.6302062815989,425.3033333333333,425.3033333333333,425.3033333333333,6774766,4589932,76.29051468608327,73.74143681559346,NaN,NaN,NaN,NaN,11.952825301694803,58.05470255795353,1340052403,3.394980714741827,23.03437169186475,19.639390977122922
2024-12-13T13:30:00-05:00,428.61,436.3,428.23,436.19,397.95300913158286,NaN,NaN,NaN,NaN,NaN,355.8272,423.1034698181164,288.5509301818836,406.68916502527907,428.3216879963861,432.30306064805586,424.3403153447164,3893760,4528483.566666666,78.08179471299893,74.76960802439346,NaN,NaN,NaN,NaN,11.67548063728803,59.458033934466215,1343946163,3.3948343546166875,23.882933920393782,20.488099565777095
2024-12-16T09:30:00-05:00,441.09,461.45,436.14,459.15,412.5912814437836,NaN,NaN,NaN,NaN,NaN,359.0742000000001,430.20250447465924,287.9458955253409,425.10633202022325,452.2466666666666,452.2466666666666,452.2466666666666,8958647,4777483.6,82.41091294280261,75.7560064455872,NaN,NaN,NaN,NaN,12.649374877481744,61.133698522989185,1352904810,4.4952472607051135,26.107158641658486,21.611911380953373
2024-12-16T13:30:00-05:00,459.14,463.17,456.78,463.17,424.5455413781571,NaN,NaN,NaN,NaN,NaN,361.9158,437.93150775464824,285.90009224535174,430.9000656161786,454.64642240148356,458.56343969887917,450.72940510408796,3362525,4588697.666666667,83.04244660223252,76.78377048218991,NaN,NaN,NaN,NaN,12.202276671947336,62.71033814070209,1356267335,5.0088318000881245,27.87295113106353,22.864119330975406
2024-12-17T09:30:00-05:00,476.1,483.98,457.55,474.04,433.34188040642266,NaN,NaN,NaN,NaN,NaN,364.97020000000003,446.30270130077184,283.6376986992282,444.9490524929429,471.85666666666657,471.8566742960611,471.85665903727204,10502661,4851065.166666667,84.64760372502172,77.73347862671059,NaN,NaN,NaN,NaN,13.218542623951098,64.3912082297513,1366769996,5.553415594058258,29.80588882354823,24.252473229489972
2024-12-17T13:30:00-05:00,474,482.45,469,479.72,438.16884038794893,NaN,NaN,NaN,NaN,NaN,367.7522,454.87271664585126,280.6316833541488,444.9490524929429,473.0664577948951,475.26357392583066,470.8693416639595,3184301,4689743.133333334,85.42402163854925,78.42679213159404,NaN,NaN,NaN,NaN,13.235075293668876,65.95201616958269,1369954297,5.745010105193291,31.433735860981585,25.688725755788294
2024-12-18T09:30:00-05:00,466.49,488.5,461.12,475.36,438.16884038794893,NaN,NaN,NaN,NaN,NaN,370.2468,462.2685029566401,278.22509704335994,444.9490524929429,474.99333333333334,474.99333333333334,474.99333333333334,8548489,4894381.766666667,81.99606573290426,79.05518641144509,NaN,NaN,NaN,NaN,14.245427058406813,66.4228823663634,1361405808,5.051490686662298,32.003089114116165,26.951598427453867
2024-12-18T13:30:00-05:00,475.3,477.48,427,440.13,NaN,NaN,NaN,495.40445862184293,495.40445862184293,495.40445862184293,372.5478,465.68374986169545,279.41185013830454,444.9490524929429,460.7433587705044,474.1110453129445,447.37567222806433,9714155,5050651.666666667,60.77413702132291,78.09141207711279,NaN,NaN,NaN,NaN,16.833610839949184,63.71263358854738,1351691653,1.8579897872911673,29.274085661567824,27.416095874276657
2024-12-19T09:30:00-05:00,451.88,456.36,420.02,433.88,NaN,NaN,NaN,485.78225151833254,NaN,NaN,374.659,468.4722172564191,280.84578274358086,444.9490524929429,436.75333333333333,436.75333333333333,436.75333333333333,11573628,5360620.5,57.91060530115402,76.56391404601105,NaN,NaN,NaN,NaN,18.22692435138139,60.70714660543661,1340118025,-0.8898413145478052,26.3037942310919,27.193635545639705
2024-12-19T13:30:00-05:00,433.8,440.86,429.26,436.15,NaN,NaN,NaN,482.07078554022655,NaN,NaN,376.77600000000007,471.26444771716757,282.28755228283256,444.9490524929429,436.4019986836623,436.9883765891128,435.81562077821184,4154859,5315785.133333334,58.67225526739712,75.52253171908363,NaN,NaN,NaN,NaN,17.753572611997004,57.91633726397662,1344272884,-2.6685347503396635,23.857967107715126,26.52650185805479
2024-12-20T09:30:00-05:00,425.56,447.08,417.58,443.32,NaN,NaN,NaN,481.2266589247617,NaN,NaN,379.0382,474.37116115740884,283.7052388425912,444.9490524929429,435.99333333333334,435.99333333333334,435.99333333333334,8529257,5549169.366666666,61.068659545502484,74.34790070898177,NaN,NaN,NaN,NaN,18.592603139711507,54.510883494867734,1352802141,-3.427760740122384,22.24180093290181,25.669561673024194
2024-12-20T13:30:00-05:00,443.41,444.9,420.12,420.6,NaN,NaN,NaN,481.2266589247617,NaN,NaN,381.1598,475.3699456523658,286.94965434763424,444.9490524929429,433.6075006647444,437.08459839619167,430.13040293329715,4015664,5537408,50.98080283175574,72.33653788176348,NaN,NaN,NaN,NaN,19.034560058303537,51.348676423552334,1348786477,-5.407901815585731,18.90968440354203,24.31758621912776
2024-12-23T09:30:00-05:00,431,434.51,415.44,433.34,NaN,NaN,NaN,475.3534846814461,NaN,NaN,383.6028,476.75771708246066,290.44788291753935,444.9490524929429,427.7633333333333,427.7633333333333,427.7633333333333,6654746,5518948.9,55.427087968528205,70.72352739371651,NaN,NaN,NaN,NaN,19.037091482710427,48.08382247747963,1355441223,-5.774186485375925,17.099853112407857,22.87403959778378
2024-12-23T13:30:00-05:00,433.33,434.15,425.9,431.24,NaN,NaN,NaN,475.3534846814461,NaN,NaN,385.8298,478.1054686014258,293.55413139857416,444.9490524929429,428.37822563688945,429.5014443442214,427.2550069295575,1994348,5507550.166666667,54.54877226723907,69.37683430310658,NaN,NaN,NaN,NaN,18.26658494823111,45.052172384697826,1353446875,-6.04362957009338,15.319502635167055,21.363132205260435
2024-12-24T09:30:00-05:00,435.91,462.7,435.15,462.465,NaN,NaN,NaN,475.3534846814461,NaN,NaN,388.66409999999996,481.47396946850074,295.8542305314992,444.50024199435427,453.4383333333333,453.4383333333333,453.4383333333333,6873951,5571457.033333333,63.74761178184076,68.48091266708926,NaN,NaN,NaN,NaN,19.20897173764317,43.773124791923514,1360320826,-4.097751272671605,16.24094311442093,20.338694387092534
2024-12-26T09:30:00-05:00,465.02,465.34,451.02,455.85,NaN,NaN,NaN,475.3534846814461,NaN,NaN,391.00409999999994,484.5688878144356,297.4393121855643,444.4501935954834,457.40333333333336,457.40333333333336,457.40333333333336,6586209,5731611.5,60.93403082447496,67.25607238933755,NaN,NaN,NaN,NaN,18.85975947066866,42.700919955883,1353734617,-3.270879401414472,16.250095135324443,19.520974536738915
2024-12-26T13:30:00-05:00,455.9,459.11,451.04,453.98,NaN,NaN,NaN,475.3534846814461,NaN,NaN,393.30609999999996,487.2906523326052,299.3215476673947,417.0001548763868,456.5931473391345,457.82833946960665,455.3579552086623,2833583,5694718.266666667,60.12613525277541,65.66430255433559,NaN,NaN,NaN,NaN,18.089062365620897,41.70530117955966,1350901034,-2.87845525855116,15.922905463549966,18.801360722101126
2024-12-27T09:30:00-05:00,449.39,449.9,426.5,432.7,NaN,NaN,NaN,475.3534846814461,NaN,NaN,395.0360999999999,488.67239666513086,301.399803334869,412.95344909051676,436.3666666666666,436.3666666666666,436.3666666666666,7092015,5869379.566666666,51.72212822694084,63.427136956100476,NaN,NaN,NaN,NaN,18.759843625219407,39.005246564340354,1343809019,-4.011046330127947,13.787552809441195,17.79859913956914
2024-12-27T13:30:00-05:00,432.59,435.15,428.6,431.69,NaN,NaN,NaN,475.3534846814461,NaN,NaN,396.7503,489.868304282954,303.63229571704596,412.95344909051676,435.1458041079303,437.1628536355383,433.1287545803223,2598185,5690932.966666667,51.355232838162806,61.049110464181986,NaN,NaN,NaN,NaN,17.88771193770373,36.498052993065286,1341210834,-4.737389066649751,11.876862806256952,16.614251872906703
2024-12-30T09:30:00-05:00,419.39,427,415.75,422.18,NaN,NaN,NaN,471.02109533563714,NaN,NaN,398.37369999999993,490.3715048609869,306.375895139013,412.95344909051676,421.6433333333333,421.64334096272785,421.6433257039388,5759644,5801838.966666667,47.909131892637376,58.36947548233114,NaN,NaN,NaN,NaN,17.74858965643918,34.390963156725135,1335451190,-5.70267980511629,9.48590211651134,15.18858192162763
2024-12-30T13:30:00-05:00,422.12,424.49,416.93,417.2,NaN,NaN,NaN,469.13036372947187,NaN,NaN,399.87909999999994,490.58750229416546,309.1706977058344,412.95344909051676,421.1528381090282,422.0422701694214,420.26340604863503,1751619,5682339.533333333,46.16224912001814,55.80991715283927,NaN,NaN,NaN,NaN,17.020833252407808,32.43437973726643,1333699571,-6.4650448085285355,7.107275910966962,13.572320719495497
2024-12-31T09:30:00-05:00,423.99,427.94,408.58,411.37,NaN,NaN,NaN,467.1194381054049,NaN,NaN,401.2382999999999,490.547241716047,311.92935828395287,412.95344909051676,415.9633333333333,415.9633333333333,415.9633333333333,5416528,5736190.233333333,44.133458100080595,54.621297229893386,NaN,NaN,NaN,NaN,17.187916591521535,31.104389235405964,1328283043,-7.099765328688537,4.6976140586348265,11.797379387323364
2024-12-31T13:30:00-05:00,411.43,412.64,402.55,403.71,NaN,NaN,NaN,455.6094636460684,NaN,NaN,402.5213,490.0750231831978,314.9675768168022,412.95344909051676,412.8313295228921,417.35417696150245,408.3084820842817,2597417,5545387.066666666,41.54963674690596,53.45265661887566,NaN,NaN,NaN,NaN,16.680922549269997,30.201347235052374,1325685626,-7.721812184605236,2.1451141565668195,9.866926341172055
2025-01-02T09:30:00-05:00,390.1,392.71,373.04,377.65,NaN,NaN,NaN,432.88926075306523,NaN,NaN,403.0457,489.67834576382313,316.4130542361769,412.95344909051676,381.1333333333334,381.1333333333334,381.1333333333334,9922344,5805038.066666666,34.2113446575064,51.70544871816918,NaN,NaN,NaN,NaN,17.68014236717928,30.651673012675534,1315763282,-9.45995215154738,-1.9580138482621692,7.50193830328521
2025-01-02T13:30:00-05:00,377.62,381.24,374.86,379.03,NaN,NaN,NaN,426.66088526428956,NaN,NaN,403.5733,489.28831645826165,317.8582835417384,412.95344909051676,380.5135973300406,381.6643939535373,379.36280070654396,2877601,5638435.1,34.86736270150247,49.83392751502633,NaN,NaN,NaN,NaN,16.872989340952188,31.06983266332562,1318640883,-10.033803649294711,-5.040316258333178,4.9934873909615325
2025-01-03T09:30:00-05:00,381.81,399.77,379.455,399.03,NaN,NaN,NaN,426.66088526428956,NaN,NaN,404.55269999999996,488.90781017620844,320.1975898237915,412.95344909051676,392.7516666666666,392.7516666666666,392.7516666666666,7037194,5767904.966666667,43.63897189948314,49.309511019864,NaN,NaN,NaN,NaN,17.149204388027034,30.104860704166818,1325678077,-8.636665478378688,-5.802344457011827,2.8343210213668604
2025-01-03T13:30:00-05:00,398.95,411.86,397.72,410.73,NaN,NaN,NaN,426.66088526428956,NaN,NaN,405.99830000000003,488.22307085671946,323.7735291432806,399.2347592724134,398.3164631965224,405.1751957521049,391.45773064093993,4632446,5692092.433333334,48.046882456243196,48.78235348327222,NaN,NaN,NaN,NaN,16.934261217453674,28.46268574718393,1330310523,-6.587391361184017,-5.399918180113161,1.1874731810708559
2025-01-06T09:30:00-05:00,423.19,426.43,405.16,406.68,NaN,NaN,NaN,426.66088526428956,NaN,NaN,407.2731,487.49991424287094,327.04628575712906,391.3428074179307,412.75666666666666,412.75666666666666,412.75666666666666,7555419,5820040.9,46.68577539221443,48.22071084934189,NaN,NaN,NaN,NaN,17.24395684477841,26.71254504580562,1322755104,-5.226911610046726,-5.346166331487552,-0.11925472144082594
2025-01-06T13:30:00-05:00,406.65,411.37,401.7,411.14,NaN,NaN,NaN,426.66088526428956,NaN,NaN,408.73269999999997,486.4944295386368,330.97097046136315,387.70591739798056,411.49258116392616,413.57258963296044,409.4125726948919,2790495,5691756.266666667,48.418716244750854,47.12578973954975,NaN,NaN,NaN,NaN,16.702959927294238,24.896117173333472,1325545599,-3.814471912087537,-4.8873446115502475,-1.0728726994627102
2025-01-07T09:30:00-05:00,405.8,414.32,391.2,398.49,NaN,NaN,NaN,426.66088526428956,NaN,NaN,410.0685,484.7238361589118,335.41316384108814,387.70591739798056,401.33666666666664,401.33666666666664,401.33666666666664,7529939,5857213.166666667,44.04566868600444,45.919478158230426,NaN,NaN,NaN,NaN,17.16131993248751,23.58799188369168,1318015660,-3.5267334238490635,-5.481289479274039,-1.9545560554249761
2025-01-07T13:30:00-05:00,398.48,398.72,390,394.6,NaN,NaN,NaN,426.66088526428956,NaN,NaN,411.30089999999996,482.7926826799709,339.80911732002903,387.70591739798056,399.5845295537853,402.58684885050656,396.582210257064,2564566,5716873.166666667,42.76652694256294,44.67950613607239,NaN,NaN,NaN,NaN,16.558368508738404,22.436473410845093,1315451094,-3.391938717898481,-6.1944794527980775,-2.8025407348995968
2025-01-08T09:30:00-05:00,393.05,402.48,387.4,398.71,NaN,NaN,NaN,426.66088526428956,NaN,NaN,412.3729,481.42839866853467,343.31740133146536,383.3874350503762,396.1966666666667,396.1966666666667,396.1966666666667,7067778,5822673.766666667,44.597254239275564,44.170586565524864,NaN,NaN,NaN,NaN,16.452770758114234,21.12958453606744,1322518872,-2.841800147898082,-6.354790919772199,-3.5129907718741173
2025-01-08T13:30:00-05:00,398.7,400.5,394.09,394.95,NaN,NaN,NaN,426.66088526428956,NaN,NaN,413.1519,480.50386225470993,345.7999377452901,383.3874350503762,396.27992129318216,396.41932226948563,396.1405203168787,2520972,5608084.6,43.23475196889494,43.590552217720024,NaN,NaN,NaN,NaN,15.735429989677504,19.916044866631047,1319997900,-2.5559392402302805,-6.7079148221619675,-4.151975581931687
2025-01-10T09:30:00-05:00,391.3,399.28,384.22,397.3,NaN,NaN,NaN,426.66088526428956,NaN,NaN,413.95630000000006,479.54804157803613,348.364558421964,383.3874350503762,393.59999999999997,393.59999999999997,393.59999999999997,5748746,5687625.3,44.37851587463858,43.33836535929154,NaN,NaN,NaN,NaN,15.68718499041482,19.37889208734149,1325746646,-2.054956324078347,-6.720670987029621,-4.665714662951274
2025-01-10T13:30:00-05:00,397.4,397.76,392.56,394.64,NaN,NaN,NaN,426.66088526428956,NaN,NaN,414.8677,478.04985701319384,351.6855429868062,383.3874350503762,393.9468339805877,394.5473748282193,393.34629313295613,1917482,5401452.666666667,43.314649435159055,43.134965381801614,NaN,NaN,NaN,NaN,14.938100348242333,18.880107363715474,1323829164,-1.7604442875030824,-6.866270022330127,-5.105825734827045
2025-01-13T09:30:00-05:00,383.21,397.58,380.07,394.99,NaN,NaN,NaN,426.66088526428956,NaN,NaN,415.7393,476.55381866158194,354.9247813384181,383.3874350503762,390.87999999999994,390.87999999999994,390.87999999999994,5460373,5477321.733333333,43.506553201614786,43.09018646048263,NaN,NaN,NaN,NaN,15.121807466225023,19.119124564103934,1329289537,-1.414679429132529,-6.874175021242706,-5.459495592110177
2025-01-13T13:30:00-05:00,395.06,403.79,391.42,403.34,NaN,NaN,NaN,426.66088526428956,NaN,NaN,416.76349999999996,474.92549536639063,358.6015046336093,383.3874350503762,393.30877838203185,397.19176497276896,389.4257917912947,2136320,5263582.766666667,48.02711682623471,43.55286360900611,NaN,NaN,NaN,NaN,14.925249790066093,18.84623592975537,1331425857,-0.5411502090974256,-6.13593335348196,-5.594783144384534
2025-01-14T09:30:00-05:00,414.45,422.62,402.18,408.94,NaN,NaN,NaN,426.66088526428956,NaN,NaN,417.78369999999995,473.5209459603101,362.0464540396898,386.28212446365524,411.24666666666667,411.24666666666667,411.24666666666667,6057488,5141693.866666666,50.86671290767178,44.7425327697322,NaN,NaN,NaN,NaN,15.319160519347088,17.693526805426124,1337483345,0.44311445847276776,-5.040890071293575,-5.4840045297663425
2025-01-14T13:30:00-05:00,408.99,412,394.54,396.26,NaN,NaN,NaN,426.66088526428956,NaN,NaN,418.32370000000003,472.6759934496775,363.97140655032257,386.28212446365524,408.1417529252344,412.87266415298757,403.41084169748126,2609168,4842878.533333333,44.886563608966966,45.45818997740823,NaN,NaN,NaN,NaN,15.47207762510801,16.704907486165695,1334874177,0.2775923368910105,-5.137014108652579,-5.41460644554359
2025-01-15T09:30:00-05:00,409.83,420.81,405.67,420.8,NaN,NaN,NaN,426.66088526428956,NaN,NaN,419.3519,471.87687527424407,366.82692472575593,386.28212446365524,415.76,415.76,415.76,6125352,4908561.633333334,55.73322784091088,46.32206540179594,NaN,NaN,NaN,NaN,16.12050065188601,15.781724059993696,1340999529,1.7747438322726277,-3.1961766552028053,-4.970920487475433
2025-01-15T13:30:00-05:00,420.75,429.78,418.54,428.08,377.08961550863074,377.08961550863074,377.08961550863074,NaN,NaN,NaN,420.38950000000006,471.4942359155655,369.2847640844346,390.1478077253915,419.2433235124881,423.8992785740393,414.5873684509369,3428476,4738535.6,58.35186750858101,47.0581357626772,NaN,NaN,NaN,NaN,15.771893462465579,15.437064388289382,1344428005,3.1300059064323653,-1.058413104434976,-4.188419010867341
2025-01-16T09:30:00-05:00,423.49,423.65,410.5,411.85,377.08961550863074,NaN,NaN,NaN,NaN,NaN,420.8383,471.2361554944553,370.4404445055447,390.1478077253915,415.3333333333333,415.3333333333333,415.3333333333333,6044601,4806166.833333333,51.095015796341336,47.37308150582913,NaN,NaN,NaN,NaN,15.901043929432323,14.584780694474766,1338383404,2.8178021698840943,-0.6661662985122234,-3.4839684683963177
2025-01-16T13:30:00-05:00,411.76,415.88,409.15,413.66,377.08961550863074,NaN,NaN,NaN,NaN,NaN,421.37870000000004,470.8694673333093,371.8879326666908,390.1478077253915,414.6273860113831,415.7327351356022,413.52203688716406,2465547,4666526.866666666,51.81471767311301,47.61565303642642,NaN,NaN,NaN,NaN,15.245969363044301,13.704671287984702,1340848951,2.621677717269817,-0.20687132180904655,-2.8285490390788635
2025-01-17T09:30:00-05:00,421.67,439.21,419.8,437.14,382.0215711143341,NaN,NaN,NaN,NaN,NaN,422.32450000000006,471.17229087123394,373.4767091287662,397.82571755540044,432.05,432.05,432.05,8138877,4871344.5,60.031810436914206,48.757520304348546,NaN,NaN,NaN,NaN,15.981971551398276,14.16172486423731,1348987828,3.8855441199824994,2.028381110899261,-1.8571630090832385
2025-01-17T13:30:00-05:00,437.1,439.72,426.23,426.48,385.81036333640986,NaN,NaN,NaN,NaN,NaN,422.6939,471.3821933481962,374.00560665180376,399.8675740443204,431.67484299377605,432.24444979533473,431.1052361922174,3530533,4759897.233333333,55.41173245542017,49.66074926955264,NaN,NaN,NaN,NaN,15.803973583441257,14.610550267677786,1345457295,3.810659557071302,2.9061614372558893,-0.9044981198154128
2025-01-21T09:30:00-05:00,432.67,433.1,406.3,418.785,385.81036333640986,NaN,NaN,NaN,NaN,NaN,423.05180000000007,471.3552894706344,374.74831052936577,399.8675740443204,419.39500000000004,419.39500000000004,419.39500000000004,8240184,4815029.733333333,52.28370658261249,50.20978157979099,NaN,NaN,NaN,NaN,16.589404041766883,13.714527793042963,1337217111,3.0811315066235334,2.9469162634640043,-0.13421524315952937
2025-01-21T13:30:00-05:00,418.83,424.63,415.51,424.08,385.81036333640986,NaN,NaN,NaN,NaN,NaN,423.18680000000006,471.4632917018596,374.91030829814054,399.8675740443204,419.8865350274118,420.7509411513075,419.02212890351615,2664466,4809392.5,54.19963623494835,50.9929875987948,NaN,NaN,NaN,NaN,16.05587518164068,12.882506923739198,1339881577,2.8014975976711853,3.3676567539294524,0.566159156258267
2025-01-22T09:30:00-05:00,416.81,428,416.1,421.24,385.81036333640986,NaN,NaN,NaN,NaN,NaN,423.11560000000003,471.39286569059044,374.8383343094096,399.8675740443204,421.78,421.7800076293945,421.77999237060544,5169352,4745303.733333333,52.97109740459605,51.606743422363195,NaN,NaN,NaN,NaN,15.75902695438063,12.313163140418382,1334712225,2.2929656174242146,3.432366178038535,1.1394005606143205
2025-01-22T13:30:00-05:00,421.35,421.4,414.6,415.08,385.81036333640986,NaN,NaN,NaN,NaN,NaN,422.94900000000007,471.2785157848665,374.61948421513364,399.8675740443204,420.3822566356071,422.54795597132545,418.2165572998888,2153251,4730472.6,50.307478306668614,52.106231198899586,NaN,NaN,NaN,NaN,15.119096457639154,11.68155370955989,1332558974,1.4505220709600954,2.95255314931444,1.5020310783543445
2025-01-23T09:30:00-05:00,416.11,420.73,408.95,412.32,385.81036333640986,NaN,NaN,NaN,NaN,NaN,422.8406000000001,471.2406253156916,374.4405746843086,399.8675740443204,414,414,414,4953701,4703607.833333333,49.11577751873859,52.50689007869414,NaN,NaN,NaN,NaN,14.880589567807789,10.989324072512296,1327605273,0.6566255302805797,2.322812991205069,1.6661874609244893
2025-01-23T13:30:00-05:00,412.38,413.41,409.33,412.35,385.81036333640986,NaN,NaN,NaN,NaN,NaN,422.5156000000001,470.97476332913294,374.0564366708673,399.8675740443204,413.44225693982827,414.4289640193527,412.45554986030385,1582784,4697980,49.129883206579166,52.58565910586161,NaN,NaN,NaN,NaN,14.10911888439295,10.346539409539531,1329188057,0.11132938047545715,1.8053491865188107,1.6940198060433536
2025-01-24T09:30:00-05:00,414.64,418,407.78,410.24,385.81036333640986,NaN,NaN,NaN,NaN,NaN,421.9966000000001,470.4146664397035,373.5785335602967,399.8675740443204,412.00666666666666,412.00666666666666,412.00666666666666,5553913,4702559.5,48.11951823688045,52.389430915090806,NaN,NaN,NaN,NaN,13.831324678364885,9.8104308388868,1323634144,-0.38638707803516725,1.2110359584993944,1.5974230365345616
2025-01-24T13:30:00-05:00,410.24,410.62,405.79,406.51,385.81036333640986,NaN,NaN,NaN,NaN,NaN,420.9438000000001,468.36354671209693,373.5240532879033,399.8675740443204,410.84902699911356,412.77643379281255,408.92162020541457,2003545,4682763.766666667,46.30656671572715,52.49085970843081,NaN,NaN,NaN,NaN,13.188372915624536,9.153661244618098,1321630599,-0.9306943496972937,0.4340550994129444,1.364749449110238
2025-01-27T09:30:00-05:00,394.6,406.69,393.45,394.06,385.81036333640986,NaN,NaN,NaN,NaN,NaN,419.5616000000001,465.99612820649463,373.1270717935056,399.8675740443204,398.06666666666666,398.06666666666666,398.06666666666666,4340734,4496710.1,40.783339517808685,51.423010542494936,NaN,NaN,NaN,NaN,13.192060564508498,9.363258065683707,1317289865,-2.030039141629984,-1.1727994779272422,0.8572396637027421
2025-01-27T13:30:00-05:00,393.9,397.43,389,397.28,385.81036333640986,NaN,NaN,NaN,NaN,NaN,418.02640000000014,462.1741512922191,373.87864870778117,389.9458701202194,396.9122769545517,398.55663105853665,395.2679228505668,2139328,4472101,42.68736138911576,50.30411724824743,NaN,NaN,NaN,NaN,12.851913381329322,9.851394393863318,1319429193,-2.4149915659692054,-2.1614997937587646,0.2534917722104407
2025-01-28T09:30:00-05:00,396.83,397.14,386.5,394.07,385.81036333640986,NaN,NaN,NaN,NaN,NaN,416.3134000000001,457.2854779770769,375.34132202292335,389.9458701202194,392.57,392.57,392.57,3666874,4359757,41.262992161557605,49.60182984576287,NaN,NaN,NaN,NaN,12.703919568377225,10.469285951923677,1315762319,-2.736840176259411,-3.167558448113823,-0.43071827185441214
2025-01-28T13:30:00-05:00,394.08,400.59,392.42,398.11,385.81036333640986,NaN,NaN,NaN,NaN,NaN,414.7684000000001,452.4081675040593,377.1286324959409,389.9458701202194,394.0102191078715,396.0991299086226,391.92130830712034,1743064,4263444.266666667,43.80446850106656,49.029669190616694,NaN,NaN,NaN,NaN,12.380068170635992,10.710672783235022,1317505383,-2.533348827401134,-3.5974043061058296,-1.0640554787046956
2025-01-29T09:30:00-05:00,395.225,398.57,384.71,389.93,NaN,NaN,NaN,431.74406472687923,431.74406472687923,431.74406472687923,413.7644000000002,451.3226063277699,376.2061936722305,389.9458701202194,391.07,391.07,391.07,3352587,4123349.8666666667,40.0279292945155,47.60082053758822,NaN,NaN,NaN,NaN,12.485777587019138,11.466143682261997,1314152796,-2.785329759865902,-4.545717678537073,-1.7603879186711713
2025-01-29T13:30:00-05:00,389.98,391.84,384.49,388.08,NaN,NaN,NaN,427.44842542111195,NaN,NaN,412.8484000000001,450.63287725931536,375.0639227406848,389.9458701202194,389.9915166698919,391.4058804167254,388.5771529230584,1949327,4095310.933333333,39.204707409181154,46.44317589142828,NaN,NaN,NaN,NaN,12.118936330803482,12.182530438944655,1312203469,-2.899268495538194,-5.384473538093914,-2.48520504255572
2025-01-30T09:30:00-05:00,410.66,412.5,384.42,403.91,NaN,NaN,NaN,427.44842542111195,NaN,NaN,412.20360000000016,449.4723280190706,374.93487198092976,389.9458701202194,400.2766666666667,400.2766666666667,400.2766666666667,7457768,4092905.2333333334,48.89076475739673,46.20082290391288,NaN,NaN,NaN,NaN,13.259012307174661,11.60911689776774,1319661237,-1.7858078841245968,-4.717464897711466,-2.931657013586869
2025-01-30T13:30:00-05:00,403.93,407.5,398.96,400.16,NaN,NaN,NaN,427.44842542111195,NaN,NaN,411.34040000000016,447.6738978684884,375.00690213151194,389.9458701202194,400.75389748737297,401.5865476106171,399.9212473641288,2449857,4089081.6,46.98119225129168,45.685219762223106,NaN,NaN,NaN,NaN,12.92193999951933,11.076661466674889,1317211380,-1.206886225941198,-4.440264796013366,-3.2333785700721682
2025-01-31T09:30:00-05:00,401.5,419.99,401.31,415.9,NaN,NaN,NaN,427.44842542111195,NaN,NaN,411.24640000000016,447.5078354950194,374.98496450498095,385.76169609617557,412.3999999999999,412.3999999999999,412.3999999999999,6492598,4069908.933333333,54.93705118025116,45.825645031912764,NaN,NaN,NaN,NaN,13.41537285669652,11.464962649685088,1323703978,0.25320574779640825,-2.916871385326658,-3.1700771331230664
2025-01-31T13:30:00-05:00,415.91,416.92,401.45,404.5,NaN,NaN,NaN,427.44842542111195,NaN,NaN,410.6696000000001,446.42084964752485,374.9183503524754,384.8707167008952,410.66707235130065,412.96371762205393,408.37042708054736,3696507,4109093.433333333,49.180826396366555,45.74516989546261,NaN,NaN,NaN,NaN,13.562131938361057,11.825528033908848,1320007471,0.4564692671377495,-2.5994905492008797,-3.0559598163386292
2025-02-03T09:30:00-05:00,386.68,389.15,374.37,380.32,NaN,NaN,NaN,425.66888934362964,NaN,NaN,409.6512000000001,445.8981287835489,373.40427121645126,384.8707167008952,381.28,381.28,381.28,9033682,4218591.3,39.68319765125801,45.071414190642564,NaN,NaN,NaN,NaN,14.745551085620983,11.838980725503626,1310973789,-0.9553084788678228,-4.250095414923408,-3.294786936055585
2025-02-03T13:30:00-05:00,380.4,385.33,378.34,383.76,NaN,NaN,NaN,424.70121255528284,NaN,NaN,408.07710000000014,441.758151414104,374.39604858589627,384.8707167008952,381.53347880932404,382.02243497817256,381.0445226404755,2427774,4235601.033333333,41.41652785496938,44.52046023695616,NaN,NaN,NaN,NaN,14.19158315093377,11.851472510555922,1313401563,-1.5405338632401158,-5.2204542651057295,-3.6799204018656138
2025-02-04T09:30:00-05:00,382.77,390.69,381.4,386.8,NaN,NaN,NaN,424.70121255528284,NaN,NaN,406.6961000000002,438.0077876127648,375.38441238723556,384.8707167008952,386.2966666666667,386.2966666666667,386.2966666666667,3730142,4177926.6666666665,42.97607995768061,44.15307178844188,NaN,NaN,NaN,NaN,13.841470068724217,11.437316891754321,1317131705,-1.5990296358678293,-5.6787074467004,-4.079677810832571
2025-02-04T13:30:00-05:00,386.78,394,385.12,392.34,NaN,NaN,NaN,424.70121255528284,NaN,NaN,405.4633000000001,433.9583702831103,376.96822971688994,384.8707167008952,387.7782293252833,389.7814067083918,385.7750519421748,2040453,4174731.1,45.80737936531002,44.11741554912637,NaN,NaN,NaN,NaN,13.487079349529628,10.79382908902911,1319172158,-1.161126375706755,-5.5310857804660145,-4.36995940475926
2025-02-05T09:30:00-05:00,387.5,388.39,380.01,380.46,NaN,NaN,NaN,424.70121255528284,NaN,NaN,404.41850000000005,432.67215068446535,376.16484931553475,384.8707167008952,382.9533333333333,382.9533333333333,382.9533333333333,5388780,4152440.8333333335,41.09530343741273,44.13969868624095,NaN,NaN,NaN,NaN,13.404430824563224,10.571044834888376,1313783378,-1.5441026929612551,-6.300087770960829,-4.755985077999574
2025-02-05T13:30:00-05:00,380.475,381.45,375.52,378.16,NaN,NaN,NaN,418.69154119409524,NaN,NaN,403.3479000000001,431.4432015353034,375.2525984646968,384.8707167008952,381.41760591261453,383.57863663537984,379.25657518984923,2721428,4156182.8333333335,40.23242596109546,43.96434615566807,NaN,NaN,NaN,NaN,12.870542908522994,10.683462978488125,1311061950,-1.806621633120547,-7.014262119400257,-5.20764048627971
2025-02-06T09:30:00-05:00,373.04,375.4,363.18,371.73,NaN,NaN,NaN,409.7116984125454,NaN,NaN,402.3389000000001,431.2677287554091,373.41007124459105,384.8707167008952,370.1033333333333,370.1033333333333,370.1033333333333,7884850,4214832.766666667,37.84032441075436,43.71986988775355,NaN,NaN,NaN,NaN,13.021218415057067,11.574398086637583,1303177100,-2.239327841751689,-8.006800288469321,-5.767472446717632
2025-02-06T13:30:00-05:00,371.77,374.31,367.42,374.31,NaN,NaN,NaN,409.7116984125454,NaN,NaN,401.4811,431.1309769838912,371.8312230161089,384.8707167008952,370.5854141706631,371.41509631798107,369.75573202334516,2662010,4189283.9,39.39732439046566,43.40507387985349,NaN,NaN,NaN,NaN,12.58327424255299,12.401694972776367,1305839110,-2.175919926598147,-8.487372354965316,-6.311452428367169
2025-02-07T09:30:00-05:00,370.18,380.54,366.31,369.58,NaN,NaN,NaN,409.7116984125454,NaN,NaN,400.64529999999996,431.4659447959824,369.8246552040175,381.08957336071614,372.1433333333334,372.1433333333334,372.1433333333334,6951459,4219512.5,37.54076395094391,43.227419212455516,NaN,NaN,NaN,NaN,12.700897510942065,12.56844793919584,1298887651,-2.2664289985242068,-9.144488676522428,-6.8780596779982215
2025-02-07T13:30:00-05:00,369.55,370,360.34,361.54,NaN,NaN,NaN,404.35199840332297,NaN,NaN,399.80190000000005,432.49216490501146,367.1116350949886,361.21777724854934,369.60472121414375,373.39018785428846,365.81925457399905,3126294,4241537.4,34.55956965908595,42.89562365887729,NaN,NaN,NaN,NaN,12.483690545874778,13.124681761989102,1295761357,-2.6547364380720992,-10.196480225588346,-7.541743787516246
2025-02-10T09:30:00-05:00,356.2,362.7,350.54,359.96,NaN,NaN,NaN,395.67918029408105,NaN,NaN,399.44809999999995,433.44642859950756,365.44977140049235,361.21777724854934,357.73333333333335,357.7333371480306,357.7333295186361,6696822,4193468.9,33.98835021669741,41.83116547739876,NaN,NaN,NaN,NaN,12.460569792598006,14.234836447272162,1289064535,-2.7910296179009784,-11.030530809892468,-8.23950119199149
2025-02-10T13:30:00-05:00,359.95,360,350.51,350.64,NaN,NaN,NaN,393.83285391707733,NaN,NaN,398.8803,435.0994013919454,362.6611986080546,361.21777724854934,356.55445408745464,358.38349993011997,354.7254082447893,2782007,4168518.033333333,30.758762917895965,40.67242052501336,NaN,NaN,NaN,NaN,12.248386235983864,15.267446631724857,1286282528,-3.2498078252474585,-12.301760973550813,-9.051953148303355
2025-02-11T09:30:00-05:00,345.83,349.39,329.13,329.66,NaN,NaN,NaN,379.01749692084655,NaN,NaN,397.4929,438.5713370729932,356.41446292700687,361.21777724854934,336.06,336.06,336.06,9546842,4212073.3,24.99997835957231,38.53405818067915,NaN,NaN,NaN,NaN,12.90993007627073,17.289937530054747,1276735686,-4.623370479256266,-14.831166247373687,-10.207795768117421
2025-02-11T13:30:00-05:00,329.7,334.6,325.1,328.64,NaN,NaN,NaN,369.09579251535354,NaN,NaN,395.85110000000003,441.03844386042067,350.6637561395794,355.99922179883947,333.9069591711217,337.0058608912206,330.80805745102276,4608384,4276870.566666666,24.757292492510246,36.78952004468942,NaN,NaN,NaN,NaN,12.666363642251392,19.33184221360158,1272127302,-5.213959711750977,-16.725245407806142,-11.511285696055165
2025-02-12T09:30:00-05:00,329.98,345.6,329.15,344.96,NaN,NaN,NaN,369.09579251535354,NaN,NaN,394.6167,441.87780653000056,347.3555934699994,352.57237743907154,339.90333333333336,339.90333333333336,339.90333333333336,8900628,4401246.433333334,35.53940435540572,36.493534809271395,NaN,NaN,NaN,NaN,12.973051953519152,20.115337178633887,1281027930,-4.1643547494297675,-16.716729132842374,-12.552374383412607
2025-02-12T13:30:00-05:00,344.99,346.4,335.67,336.59,NaN,NaN,NaN,369.09579251535354,NaN,NaN,393.1257,442.8473868583521,343.4040131416479,351.09005724880467,339.80081545391243,339.9600992955252,339.6415316122997,3687028,4452372.333333333,32.93289484993552,35.88756102319755,NaN,NaN,NaN,NaN,12.81283395683921,20.765680224152266,1277340902,-3.707896580976506,-17.18724510963324,-13.479348528656732
2025-02-13T09:30:00-05:00,345,358.69,342.82,350.46,NaN,NaN,NaN,369.09579251535354,NaN,NaN,392.16509999999994,443.2716752517246,341.05852474827526,351.09005724880467,350.6566666666667,350.6566666666667,350.6566666666667,8786013,4580116.066666666,40.69494695117426,35.724622951304234,NaN,NaN,NaN,NaN,13.476202959922125,20.255942838132544,1286126915,-2.2193837335650954,-16.253578195613102,-14.034194462048006
2025-02-13T13:30:00-05:00,350.48,356.91,349.97,355.98,NaN,NaN,NaN,369.09579251535354,NaN,NaN,391.3927,443.48655995335787,339.2988400466421,351.09005724880467,351.5283895644067,353.079019535854,349.97775959295944,2776722,4619914,43.4976728572905,35.55964391501713,NaN,NaN,NaN,NaN,13.009331319927686,19.78261526539994,1288903637,-0.6898483791302059,-14.896504935960763,-14.206656556830557
2025-02-14T09:30:00-05:00,360.5,362,347.5,351.27,NaN,NaN,NaN,369.09579251535354,NaN,NaN,390.4439,443.6855417211199,337.2022582788801,341.6100457990437,353.5899999999999,353.5900066072494,353.58999339275044,6219235,4642091.4,41.68733523647126,35.60193190066418,NaN,NaN,NaN,NaN,13.115807654218566,18.89849698194928,1282684402,0.13393592039554214,-14.03923665633613,-14.173172576731671
2025-02-14T13:30:00-05:00,351.22,356.44,351.2,355.9,NaN,NaN,NaN,369.09579251535354,NaN,NaN,389.66290000000004,443.75606644789707,335.569733552103,333.908036639235,353.8500003754217,354.26529162034785,353.43470913049555,2437695,4656563.066666666,44.14813350464675,35.881625296632116,NaN,NaN,NaN,NaN,12.553249964631528,18.07753000445938,1285122097,1.0679367101560029,-12.838251689036667,-13.90618839919267
2025-02-18T09:30:00-05:00,355.1,359.1,350.02,351.3,NaN,NaN,NaN,369.09579251535354,NaN,NaN,388.74289999999996,443.84059505487613,333.6452049451238,332.22142931138796,353.47333333333336,353.47333333333336,353.47333333333336,4382597,4657958.5,42.240883428954234,36.19595094078925,NaN,NaN,NaN,NaN,12.305160681443565,17.068683709815037,1280739500,1.4305861151641217,-12.117955755237517,-13.548541870401639
2025-02-18T13:30:00-05:00,351.29,354.67,350.5,354.11,NaN,NaN,NaN,369.09579251535354,NaN,NaN,387.93229999999994,443.84563176300776,332.0189682369921,331.0113822542871,353.3810276714938,353.54398722574825,353.2180681172394,1406140,4633518.9,43.83705059160002,36.513074240870274,NaN,NaN,NaN,NaN,11.724077775626169,16.13189786478815,1282145640,1.885741153819552,-11.191365428127199,-13.077106581946751
2025-02-19T09:30:00-05:00,353.95,367.34,353.67,362.9,NaN,NaN,NaN,369.09579251535354,NaN,NaN,387.2905,443.60033424766885,330.98066575233116,340.8602846427437,361.3033333333333,361.3033333333333,361.3033333333333,7418762,4758581.833333333,48.62023557712533,37.30446507131181,NaN,NaN,NaN,NaN,11.863072220224296,15.816567866509033,1289564402,2.752348596372679,-9.636670836480903,-12.389019432853582
2025-02-19T13:30:00-05:00,362.95,364.2,357.35,360.65,NaN,NaN,NaN,369.09579251535354,NaN,NaN,386.4367,443.04104540245146,329.8323545975485,340.8602846427437,361.1667408545069,361.41005178242546,360.9234299265883,2338093,4778416.133333334,47.50495407439752,38.22913538669121,NaN,NaN,NaN,NaN,11.504995633065416,15.523761439535564,1287226309,3.1205972726506115,-8.488272842040317,-11.608870114690928
2025-02-20T09:30:00-05:00,361.54,362.3,348,353.42,NaN,NaN,NaN,369.09579251535354,NaN,NaN,385.32629999999995,442.29836581510006,328.35423418489984,340.8602846427437,354.5733333333333,354.5733333333333,354.5733333333333,4958003,4831930,44.01135813834038,38.945064523951416,NaN,NaN,NaN,NaN,11.704638802132171,14.489879620284036,1282268306,2.8322556867001243,-8.068550506315773,-10.900806193015898
2025-02-20T13:30:00-05:00,353.4,354.88,350.9,354.4,NaN,NaN,NaN,369.09579251535354,NaN,NaN,384.48909999999995,442.02138560347703,326.9568143965229,340.8602846427437,354.31108307803,354.80167466463655,353.8204914914234,1416767,4814178,44.60601826143797,39.934154191347275,NaN,NaN,NaN,NaN,11.15287888769416,13.529846502407619,1283685073,2.664979123376078,-7.5695822887958,-10.234561412171878
2025-02-21T09:30:00-05:00,353.54,354.98,337.21,340.12,NaN,NaN,NaN,369.09579251535354,NaN,NaN,382.87549999999993,440.7681585414773,324.98284145852256,340.8602846427437,344.1033333333333,344.1033333333333,344.1033333333333,6334526,4776736.6,38.23364254094601,40.87941591858826,NaN,NaN,NaN,NaN,11.625530395716009,13.787033159222112,1277350547,1.6024211083263538,-8.231535026763936,-9.83395613509029
2025-02-21T13:30:00-05:00,340.11,342.77,334.43,337.5,NaN,NaN,NaN,369.09579251535354,NaN,NaN,381.06389999999993,438.8537907176679,323.274009282332,340.8602846427437,342.0208703692046,344.8293228972847,339.2124178411245,3482848,4811169.633333334,37.18404614922742,41.76704117978233,NaN,NaN,NaN,NaN,11.390849653164864,14.229001649805786,1273867699,0.7748807890333183,-8.865355148798642,-9.64023593783196
2025-02-24T09:30:00-05:00,337.8,342.39,324.7,338.36,NaN,NaN,NaN,369.09579251535354,NaN,NaN,379.5940999999999,437.9130278944677,321.27517210553214,340.8602846427437,335.15,335.15,335.15,5591060,4781118.366666666,37.78776439975979,41.92763832580762,NaN,NaN,NaN,NaN,11.840788963653088,15.29414897250101,1279458759,0.3583453993991039,-9.19230418858308,-9.550649587982184
2025-02-24T13:30:00-05:00,338.38,338.53,329.9,330.4,NaN,NaN,NaN,369.09579251535354,NaN,NaN,377.92889999999994,437.01165299239193,318.84614700760795,340.8602846427437,334.5936144683817,335.5518381096339,333.6353908271295,1885003,4720734.9,34.48419289350481,42.038445328919714,NaN,NaN,NaN,NaN,11.611446894820725,16.283214343575143,1277573756,-0.3424331259198148,-9.978690995381953,-9.636257869462138
2025-02-25T09:30:00-05:00,327.07,327.45,298.77,302.38,NaN,NaN,NaN,352.03283772695016,NaN,NaN,375.23369999999994,435.54829063311286,314.919109366887,340.8602846427437,309.53333333333336,309.53333333333336,309.53333333333336,11894789,4816105.133333334,25.900407423407273,40.98169250550779,NaN,NaN,NaN,NaN,13.041343545190673,18.71120971810157,1265678967,-2.464035635523638,-12.716302413866686,-10.252266778343047
2025-02-25T13:30:00-05:00,302.41,304.28,297.27,302.52,NaN,NaN,NaN,338.88452692117966,NaN,NaN,372.7544999999999,434.6103972532141,310.8986027467857,340.8602846427437,307.19750468476457,310.8911745095165,303.50383486001266,4756884,4893742.133333334,25.999522084865475,39.73182459319172,NaN,NaN,NaN,NaN,12.610533291962767,21.01990971871288,1270435851,-3.5622437344652855,-14.705071446424654,-11.142827711959368
2025-02-26T09:30:00-05:00,303.73,309,293.41,293.41,NaN,NaN,NaN,338.88452692117966,NaN,NaN,370.2469999999999,434.55206371974214,305.94193628025766,339.591227714195,298.60666666666674,298.60666666666674,298.60666666666674,7711038,5026438.666666667,23.77133956760727,38.45211061684429,NaN,NaN,NaN,NaN,12.823352342536854,22.633887189082877,1262724813,-4.54363247627364,-16.822368307301417,-12.278735831027777
2025-02-26T13:30:00-05:00,293.4,294.88,288.04,290.84,NaN,NaN,NaN,329.14576729801706,NaN,NaN,367.58219999999994,433.75874391580123,301.40565608419865,335.46298217135603,295.968043373487,299.4951305190681,292.4409562279059,4315541,5102274.933333334,23.168119729167785,36.95353820431007,NaN,NaN,NaN,NaN,12.395970032355649,24.361167883742027,1258409272,-4.972631709820936,-18.494525468303948,-13.521893758483012
2025-02-27T09:30:00-05:00,290.88,297.23,280.88,291.33,NaN,NaN,NaN,327.2573233299254,NaN,NaN,364.9839999999999,432.71251299120576,297.2554870087941,331.4203857370848,289.81333333333333,289.81333333333333,289.81333333333333,6676894,5145212.066666666,23.566368181006794,35.61964425802812,NaN,NaN,NaN,NaN,12.678400744330247,26.251339855060014,1265086166,-4.82629936763448,-19.554767968026113,-14.728468600391633
2025-02-27T13:30:00-05:00,291.33,291.82,281.26,281.95,NaN,NaN,NaN,324.44585408765596,NaN,NaN,362.3213999999999,432.38991355751693,292.2528864424829,327.32730858966784,288.37958550096164,290.57757001136696,286.1816009905563,2840997,5149197.7,21.291243966820375,34.00922949911528,NaN,NaN,NaN,NaN,12.527086405449515,28.006499542712426,1262245169,-4.945911552344663,-20.91085804082246,-15.964946488477798
2025-02-28T09:30:00-05:00,279.46,293,273.6,286.04,NaN,NaN,NaN,322.12831526548985,NaN,NaN,359.7957999999999,431.5565227488699,288.03507725112985,316.47784687173424,284.21333333333337,284.21333333333337,284.21333333333337,8296937,5162933.933333334,24.704633547736876,32.30097221130182,NaN,NaN,NaN,NaN,13.018008805060262,29.936631897154935,1270542106,-4.355045681432859,-21.408753590268873,-17.053707908836014
2025-02-28T13:30:00-05:00,286.06,293.62,282.86,293.31,NaN,NaN,NaN,322.12831526548985,NaN,NaN,357.41499999999985,429.9381129227105,284.8918870772892,312.5112774973874,285.90264646679236,288.5109910024641,283.29430193112063,3480232,5190208,30.476180334147486,31.084631229855386,NaN,NaN,NaN,NaN,12.856722461841672,31.64697728441067,1274022338,-3.13697389383389,-20.974925276128374,-17.837951382294484
2025-03-03T09:30:00-05:00,300.32,303.93,285.02,285.41,NaN,NaN,NaN,322.12831526548985,NaN,NaN,354.9183999999998,428.5812061762539,281.2555938237457,310.3120219979099,291.4533333333334,291.4533333333334,291.4533333333334,7771325,5217536.866666666,27.967448821452606,29.938637707220547,NaN,NaN,NaN,NaN,13.289099428852982,31.94931486710838,1266251013,-2.5505990865927224,-21.02620024053539,-18.475601153942666
2025-03-03T13:30:00-05:00,285.415,290.26,277.3,284.78,NaN,NaN,NaN,322.12831526548985,NaN,NaN,352.4837999999998,427.20405202206166,277.76354797793795,289.06061759832795,288.8719878630859,292.3768033097013,285.3671724164705,4215577,5253846.3,27.771119493909765,28.736144938111384,NaN,NaN,NaN,NaN,13.265592326792055,32.62486798259022,1262035436,-1.9211306977636795,-20.877014526147263,-18.955883828383584
2025-03-04T09:30:00-05:00,270.93,278.26,261.84,271.1,NaN,NaN,NaN,310.72635749414195,NaN,NaN,350.02459999999985,427.16411518748544,272.88508481251426,273.8317952629299,270.4,270.4,270.4,9112109,5334355.866666666,23.855108096023642,27.709106763474068,NaN,NaN,NaN,NaN,13.956621446306908,33.90825951157232,1252923327,-2.1260917273019615,-21.613498487511038,-19.487406760209076
2025-03-04T13:30:00-05:00,271.05,284.35,270.13,272.15,NaN,NaN,NaN,310.72635749414195,NaN,NaN,347.5219999999998,426.46478444544675,268.5792155545529,273.8317952629299,272.0318867445814,274.4256877268039,269.6380857623589,4234702,5382779.033333333,24.73240477591645,26.819703808237573,NaN,NaN,NaN,NaN,13.97543420014213,34.42924213766145,1257158029,-1.898432573693384,-21.860447477325806,-19.962014903632422
2025-03-05T09:30:00-05:00,272.98,278.26,267.74,272.37,NaN,NaN,NaN,310.72635749414195,NaN,NaN,345.0879999999999,425.62838947012966,264.54761052987016,267.5713605374055,272.79,272.79,272.79,6827080,5292120.3,24.927570813750577,25.90111855209406,NaN,NaN,NaN,NaN,13.728617471560549,35.02085191824854,1263985109,-1.460191488674969,-21.787254264476132,-20.327062775801163
2025-03-05T13:30:00-05:00,272.33,279.55,271.2,279.17,NaN,NaN,NaN,310.72635749414195,NaN,NaN,342.70919999999984,423.8684730218819,261.54992697811775,267.5713605374055,273.9998278099091,275.78704736511594,272.2126082547023,3128429,5242788.466666667,30.892335765393725,25.64455732865756,NaN,NaN,NaN,NaN,13.344430509306225,35.42029734982064,1267113538,-0.48968675084524094,-20.939171214357714,-20.449484463512473
2025-03-06T09:30:00-05:00,272.03,272.65,261.77,263.02,NaN,NaN,NaN,307.4330118409698,NaN,NaN,340.1709999999998,423.18125799261384,257.1607420073858,267.5713605374055,265.81333333333333,265.81333333333333,265.81333333333333,7375696,5191957.4,25.674772069298967,25.628440517649818,NaN,NaN,NaN,NaN,13.634114044355783,36.23134349101863,1259737842,-0.699944218590737,-21.324414736750896,-20.62447051816016
2025-03-06T13:30:00-05:00,263,266.62,260.02,263.46,NaN,NaN,NaN,302.6146931209258,NaN,NaN,337.67859999999985,422.2540049364251,253.10319506357465,267.5713605374055,264.96855073123737,266.1318408018054,263.8052606606693,3889707,5198713.366666666,26.041269802164706,25.631422497456906,NaN,NaN,NaN,NaN,13.1316773269018,37.06169137275025,1263627549,-0.5789281605389824,-21.348130718833886,-20.769202558294904
2025-03-07T09:30:00-05:00,259.32,266.24,250.72,260.27,NaN,NaN,NaN,298.1049343427019,NaN,NaN,334.80579999999986,419.94349224873486,249.66810775126487,267.5713605374055,259.07666666666665,259.07666666666665,259.07666666666665,8832906,5200276.466666667,25.075856007659823,25.72460224317495,NaN,NaN,NaN,NaN,13.302271803551672,38.22066028545245,1254794643,-0.486958761359908,-21.377901009994787,-20.89094224863488
2025-03-07T13:30:00-05:00,260.32,264.26,258.46,262.66,NaN,NaN,NaN,298.1049343427019,NaN,NaN,332.05579999999986,417.45418547326506,246.65741452673467,267.5713605374055,259.8138026234627,261.0217692057036,258.60583604122183,3289190,5217358.733333333,27.251886515196304,26.016299870748412,NaN,NaN,NaN,NaN,12.766395246155126,39.296845704390215,1258083833,-0.060803991490814724,-20.966947237998397,-20.906143246507582
2025-03-10T09:30:00-04:00,252.5,253.35,225.59,227.1,NaN,NaN,NaN,281.38449596101555,NaN,NaN,328.2797999999999,415.1976988692215,241.36190113077834,254.6930884299244,235.34666666666666,235.34666666666666,235.34666666666666,13915626,5473905.1,18.597363945149098,25.66137099675858,NaN,NaN,NaN,NaN,14.502367014286904,41.29447759767677,1244168207,-1.8692698000280181,-23.242730496542606,-21.373460696514588
2025-03-10T13:30:00-04:00,227.16,228.83,220.18,222.05,NaN,NaN,NaN,265.69383705369665,NaN,NaN,324.6307999999999,413.7345623304434,235.5270376695564,246.17575302089705,230.82852618265593,236.50901248316688,225.14803988214499,8803415,5686095.766666667,17.735943549705695,25.407420966964676,NaN,NaN,NaN,NaN,14.084340798980696,43.26718294523312,1235364792,-3.032212362218395,-25.163726149287584,-22.13151378706919
2025-03-11T09:30:00-04:00,225.3,236.25,218.13,223.83,NaN,NaN,NaN,265.69383705369665,NaN,NaN,321.50099999999986,413.5067553199815,229.4952446800182,246.17575302089705,226.07000000000002,226.07000000000002,226.07000000000002,12463255,5955451.033333333,19.157347834515235,25.01118627316313,NaN,NaN,NaN,NaN,14.372602170482073,44.263636070528094,1247828047,-3.2868044194789086,-26.240019311417825,-22.953214891938917
2025-03-11T13:30:00-04:00,223.75,237.05,223.57,230.5,NaN,NaN,NaN,265.69383705369665,NaN,NaN,318.43579999999986,412.13679850823513,224.73480149176459,246.17575302089705,227.44830570020056,229.45618574143504,225.4404256589661,5872825,6104340.533333333,24.426804082643997,24.57908796948431,NaN,NaN,NaN,NaN,14.308844872590498,45.09935714702865,1253700872,-2.6391541733953865,-26.25215760868315,-23.613003435287762
2025-03-12T09:30:00-04:00,247.22,251.84,241.1,250.19,NaN,NaN,NaN,265.69383705369665,NaN,NaN,315.7035999999999,409.2382111562997,222.16898884370008,246.17575302089705,247.71000000000004,247.71000000000004,247.71000000000004,8752756,6148807,37.39894030655798,25.252765932706126,NaN,NaN,NaN,NaN,14.811070238834034,44.34892814925709,1262453628,-0.6230256778917713,-24.391785532652477,-23.768759854760706
2025-03-12T13:30:00-04:00,250.12,251.1,245.76,248.275,NaN,NaN,NaN,265.69383705369665,NaN,NaN,312.82229999999987,405.6091212023683,220.0354787976314,237.25060241671758,247.87372672377208,248.16115947588622,247.58629397165794,2839955,6165535.733333333,36.738441276784364,25.893288917197168,NaN,NaN,NaN,NaN,14.13456522177446,43.65210122275492,1259613673,0.7677890600547741,-22.80902352969224,-23.576812589747014
2025-03-13T09:30:00-04:00,248.08,248.27,232.6,236.05,NaN,NaN,NaN,265.69383705369665,NaN,NaN,309.93409999999983,403.10897643544433,216.75922356455533,235.00048193337406,238.97333333333336,238.97333333333336,238.97333333333336,8267887,6275865.2,32.76074654631145,26.529405949360584,NaN,NaN,NaN,NaN,14.244596277362001,43.58381251804157,1251345786,1.0340503817938895,-22.284249612504652,-23.318299994298542
2025-03-13T13:30:00-04:00,236.02,242.6,235.45,240.73,NaN,NaN,NaN,265.69383705369665,NaN,NaN,307.1854999999999,400.25586646000806,214.1151335399917,234.9155084373594,239.14399153038582,239.42091004178027,238.86707301899136,3140110,6333309.966666667,35.633841521191144,27.30808000259449,NaN,NaN,NaN,NaN,13.737839400407575,43.520401577950594,1254485896,1.6579863468632325,-21.245817060719503,-22.903803407582735
2025-03-14T09:30:00-04:00,247.36,250.58,240.73,248.01,NaN,NaN,NaN,265.69383705369665,NaN,NaN,304.7110999999999,397.3634732948065,212.05872670519324,234.9155084373594,246.43999999999997,246.43999999999997,246.43999999999997,7126699,6359715.733333333,39.933460042871275,28.37992923324597,NaN,NaN,NaN,NaN,13.46013658609275,42.644692055317876,1261612595,2.6355451344337375,-19.609371989540563,-22.2449171239743
2025-03-14T13:30:00-04:00,247.98,251.58,247.42,249.97,NaN,NaN,NaN,265.69383705369665,NaN,NaN,302.2242999999998,393.9408855886514,210.50771441134822,224.63817115803775,247.45321099962996,248.94738820433184,245.95903379492808,3277057,6352856.033333333,41.07471686910813,29.107242169225568,NaN,NaN,NaN,NaN,12.795841115657554,41.73121895951525,1264889652,3.4379856973643506,-17.94743500226886,-21.38542069963321
2025-03-17T09:30:00-04:00,245.04,245.25,232.8,236.34,NaN,NaN,NaN,265.69383705369665,NaN,NaN,299.55949999999984,391.0354175357113,208.08358246428838,224.63817115803775,238.13,238.13,238.13,7912105,6430224.2,35.95821264886564,29.841773639194617,NaN,NaN,NaN,NaN,13.108281035967726,41.60532811158761,1256977547,3.085847045660806,-17.528111892557206,-20.613958938218012
2025-03-17T13:30:00-04:00,236.39,240.42,235.86,237.86,NaN,NaN,NaN,265.69383705369665,NaN,NaN,297.0858999999998,388.41272177082624,205.75907822917338,224.63817115803775,238.10715519002378,238.144328417347,238.06998196270055,2988179,6466996.733333333,36.90215549016272,30.617551188337327,NaN,NaN,NaN,NaN,12.497689533398601,41.488429467083364,1259965726,2.9883045373626764,-16.878578266514666,-19.866882803877342
2025-03-18T09:30:00-04:00,228.16,230.1,222.28,226.95,NaN,NaN,NaN,265.0233368903645,NaN,NaN,294.42569999999984,386.0202035471028,202.83119645289685,224.63817115803775,226.44333333333333,226.44333333333333,226.44333333333333,7615815,6324364.266666667,33.127816442323805,31.192691219384756,NaN,NaN,NaN,NaN,12.717854566727272,41.95631381924325,1252349911,2.255386787104392,-17.04764931999685,-19.303036107101242
2025-03-18T13:30:00-04:00,226.955,227.76,223.33,225.48,NaN,NaN,NaN,263.21727612262066,NaN,NaN,291.92249999999984,384.0743637955863,199.7706362044134,224.63817115803775,226.17429548972015,226.5927849816039,225.7558059978364,3147560,6270720.133333334,32.64335278681628,31.5777959530719,NaN,NaN,NaN,NaN,12.12586495481818,42.39077786053457,1249202351,1.759947167740215,-17.10310214742597,-18.863049315166187
2025-03-19T09:30:00-04:00,231.58,237.07,229.21,234.31,NaN,NaN,NaN,263.21727612262066,NaN,NaN,290.01549999999986,382.90805032025037,197.12294967974933,224.63817115803775,233.52999999999997,233.5300026973983,233.52999730260166,7211339,6254063.5,38.464666467127365,32.99688899035606,NaN,NaN,NaN,NaN,12.087588886616881,41.77311960313799,1256413690,2.0926366653527744,-16.24725348347522,-18.339890148827994
2025-03-19T13:30:00-04:00,234.32,241.4,232.07,235.83,NaN,NaN,NaN,263.21727612262066,NaN,NaN,288.15929999999986,381.5979499476539,194.72065005234583,224.63817115803775,234.73551452448646,236.1661595657261,233.30486948324682,5120319,6280889.433333334,39.43501932921349,34.54682297460662,NaN,NaN,NaN,NaN,11.890618251858532,40.758851443106245,1261534009,2.45566465198673,-15.27030933384458,-17.72597398583131
2025-03-20T09:30:00-04:00,233.39,238,230.06,234.32,NaN,NaN,NaN,263.21727612262066,NaN,NaN,285.9464999999999,379.13975847399126,192.75324152600857,224.63817115803775,234.12666666666667,234.12666666666667,234.12666666666667,7392193,6304732.733333333,38.780775456564434,35.94849637618156,NaN,NaN,NaN,NaN,11.608431233868638,39.93365470482252,1254141816,2.6197132110111454,-14.451332472067378,-17.071045683078523
2025-03-20T13:30:00-04:00,234.34,236.65,231.9,236.19,NaN,NaN,NaN,263.21727612262066,NaN,NaN,283.9384999999999,377.0069199124497,190.87008008755015,224.63817115803775,234.35254757770244,234.7084559891934,233.99663916621148,2977528,6309283.766666667,40.10600237713978,37.06843911150269,NaN,NaN,NaN,NaN,11.118543288592306,39.16740059070193,1257119344,2.860178470522875,-13.495822594924931,-16.356001065447806
2025-03-21T09:30:00-04:00,234.92,246.89,234.55,245.33,NaN,NaN,NaN,263.21727612262066,NaN,NaN,281.8358999999999,373.5380678193056,190.13373218069427,224.63817115803775,242.25666666666663,242.25666936406495,242.25666396926832,9677434,6355300.333333333,46.23249078580483,37.699407002877464,NaN,NaN,NaN,NaN,11.205790196549998,37.371103335270554,1266796778,3.5933701418744306,-11.864288388104768,-15.457658529979199
2025-03-21T13:30:00-04:00,245.36,249.52,244.52,249.11,NaN,NaN,NaN,263.21727612262066,NaN,NaN,279.69849999999997,369.34728484954474,190.0497151504552,228.0797034680536,243.9744168643539,246.50981630777858,241.43901742092925,4442091,6387362.3,48.57526618505129,38.54489449632511,NaN,NaN,NaN,NaN,10.762519468224998,35.446675858444046,1271238869,4.2467053680362135,-10.149276819933931,-14.395982187970144
2025-03-24T09:30:00-04:00,258.075,275.755,256.34,274.03,229.3621888421851,229.3621888421851,229.3621888421851,NaN,NaN,NaN,278.15369999999996,365.44706274448396,190.86033725551596,245.28026277444286,268.7083333333333,268.7083333333333,268.7083333333333,11091133,6498022.566666666,60.72502326380433,40.542342833288885,NaN,NaN,NaN,NaN,11.896982363351782,34.163526999690255,1282330002,6.155165521840294,-6.702025285669777,-12.85719080751007
2025-03-24T13:30:00-04:00,274.06,278.63,273.31,278.41,240.22674844026764,NaN,NaN,NaN,NaN,NaN,276.60389999999995,361.0252831985715,192.1825168014284,251.5902102195543,271.0109999106273,274.6567864163708,267.3652134048838,4424412,6504983.733333333,62.406233916260405,42.45465657579383,NaN,NaN,NaN,NaN,11.427197908826654,33.142756415067126,1286754414,7.425425347535626,-3.5754091230905374,-11.000834470626163
2025-03-25T09:30:00-04:00,283.54,283.6,271.28,277.2,241.6414416929827,NaN,NaN,NaN,NaN,NaN,275.1218999999999,356.8033084327648,193.44049156723503,255.80816817564343,277.35999999999996,277.35999999999996,277.35999999999996,11051262,6569622.166666667,61.621478620867606,44.003800759936425,NaN,NaN,NaN,NaN,11.49096948676761,32.487734518968516,1275703152,7.855419665382694,-1.1815598888977945,-9.036979554280489
2025-03-25T13:30:00-04:00,277.28,288.2,277.14,288.145,246.99046707057437,NaN,NaN,NaN,NaN,NaN,273.8026,352.41130669944914,195.19389330055083,260.43653454051474,279.54426860659805,282.83269180964345,276.25584540355266,4875830,6590993.1,65.80965396277327,45.770581980912525,NaN,NaN,NaN,NaN,11.460185951998495,32.14301157518143,1280578982,8.494010442183296,1.5805334984486308,-6.913476943734665
2025-03-26T09:30:00-04:00,282.66,284.9,269.65,270.89,246.99046707057437,NaN,NaN,NaN,NaN,NaN,271.96239999999995,346.3357443443286,197.5890556556713,260.43653454051474,275.14666666666665,275.14666666666665,275.14666666666665,10038211,6698030.8,55.52261448747652,47.16803925509902,NaN,NaN,NaN,NaN,11.96267266971289,31.10786712331577,1270540771,7.41085176691239,2.3500877649058225,-5.060764002006567
2025-03-26T13:30:00-04:00,270.86,273.5,266.51,271.98,246.99046707057437,NaN,NaN,NaN,NaN,NaN,270.18899999999996,340.11449858242077,200.26350141757916,260.43653454051474,273.63948721180606,275.75741024632265,271.52156417728946,5083536,6763201.033333333,55.99061072194249,48.53150034308329,NaN,NaN,NaN,NaN,11.607481764733397,29.859324466406463,1275624307,6.459159071002559,3.013184836746632,-3.445974234255927
2025-03-27T09:30:00-04:00,272.4,291.85,271.88,274,246.99046707057437,NaN,NaN,NaN,NaN,NaN,268.6006,334.376380060445,202.82481993955497,260.43653454051474,279.24333333333334,279.24333333333334,279.24333333333334,12511643,6934399.266666667,56.89578540646925,50.22921241195082,NaN,NaN,NaN,NaN,12.20480449582387,29.792449372982478,1288135950,5.684384705028207,3.659506647029332,-2.024878057998875
2025-03-27T13:30:00-04:00,273.92,279.66,272.06,273.23,246.99046707057437,NaN,NaN,NaN,NaN,NaN,266.9772,328.04030732873116,205.9140926712688,260.43653454051474,278.1799614578509,280.0236546112861,276.3362683044157,4162051,6943477.4,56.41942054582277,51.92750296616556,NaN,NaN,NaN,NaN,11.87588988897931,29.730351071945922,1283973899,4.87010712867127,4.062755852840212,-0.8073512758310577
2025-03-28T09:30:00-04:00,275.5,276.09,260.79,263.28,246.99046707057437,NaN,NaN,NaN,NaN,NaN,265.4404,322.8194908551189,208.06130914488114,260.43653454051474,266.71999999999997,266.71999999999997,266.71999999999997,8925812,6946574.266666667,50.53178037351736,52.789439673764846,NaN,NaN,NaN,NaN,12.120469182623642,28.64125225230922,1275048087,3.476809368319645,3.5386604345684987,0.061851066248853726
2025-03-28T13:30:00-04:00,263.29,265.35,260.6,263.5,246.99046707057437,NaN,NaN,NaN,NaN,NaN,263.9604,317.51871217803676,210.4020878219632,260.43653454051474,265.75034127351086,267.33824668873797,264.16243585828374,3328406,6947881.466666667,50.654395878806746,53.590823713021514,NaN,NaN,NaN,NaN,11.594007098150525,27.613350922280176,1278376493,2.434733234227254,3.1052676090329214,0.6705343748056672
2025-03-31T09:30:00-04:00,249.34,256.89,243.37,254.28,NaN,NaN,NaN,286.982572118731,286.982572118731,286.982572118731,262.2788,311.49114054828124,213.06645945171874,260.43653454051474,251.51333333333332,251.51333333333332,251.51333333333332,9201114,6790731.066666666,45.55785720050982,54.07490098044618,NaN,NaN,NaN,NaN,12.20372087685406,25.972936511954302,1269175379,1.0594353681033468,1.9948285849348508,0.935393216831504
2025-03-31T13:30:00-04:00,254.3,260.57,252.62,259.26,NaN,NaN,NaN,286.982572118731,NaN,NaN,260.856,306.05828140260155,215.65371859739844,260.43653454051474,253.31527298587616,256.0558191384284,250.57472683332395,3977834,6629878.366666666,48.5679188292528,54.679323584168536,NaN,NaN,NaN,NaN,11.899883671364483,24.175730815523305,1273153213,0.4511721213391604,1.4993583685054546,1.0481862471662942
2025-04-01T09:30:00-04:00,263.67,277.45,259.27,273.34,NaN,NaN,NaN,286.982572118731,NaN,NaN,260.2752,304.0521978851913,216.4982021148087,260.43653454051474,270.02,270.02,270.02,9781722,6540493.933333334,55.97865686845912,55.37547830435813,NaN,NaN,NaN,NaN,12.349177694838447,23.494756717176973,1282934935,0.9352699067759358,2.217273630636214,1.2820037238602782
2025-04-01T13:30:00-04:00,273.32,275.91,267.08,268.54,NaN,NaN,NaN,286.982572118731,NaN,NaN,259.5956,301.75331367804455,217.43788632195543,258.93570568474354,270.16007226784905,270.3814659691967,269.9386785665014,3915517,6475250.333333333,53.166197667011645,55.70340198164102,NaN,NaN,NaN,NaN,12.097807859492846,22.86242362585538,1279019418,0.8716520566194446,2.371568794634584,1.4999167380151393
2025-04-02T09:30:00-04:00,254.55,284.39,251.28,283.59,NaN,NaN,NaN,286.982572118731,NaN,NaN,259.3992,301.01294697669033,217.78545302330966,258.93570568474354,273.08666666666664,273.08666666666664,273.08666666666664,16965185,6748997.966666667,59.958995202811025,55.648685691570066,NaN,NaN,NaN,NaN,13.598678726671926,21.351819038814853,1295984603,1.7328655653434497,3.6659986946944514,1.9331331293510017
2025-04-02T13:30:00-04:00,283.6,284.98,278.38,282.76,NaN,NaN,NaN,286.982572118731,NaN,NaN,259.2376,300.42225399830363,218.0529460016963,258.93570568474354,275.5620216413172,279.56643120526684,271.55761207736754,6482710,6870423.133333334,59.446906976668,55.4373051958849,NaN,NaN,NaN,NaN,13.098773103338218,19.907668844959712,1289501893,2.1112251650672116,4.572164585685016,2.4609394206178044
2025-04-03T09:30:00-04:00,265.31,276.3,261.51,268.26,NaN,NaN,NaN,286.982572118731,NaN,NaN,258.77619999999996,299.01849976331,218.53390023668993,249.52856454779484,268.69,268.69,268.69,10232014,6935894.033333333,51.217257178713105,54.6941465214453,NaN,NaN,NaN,NaN,13.681003595956915,19.621824066700302,1279269879,1.2899076800415634,4.073324020669759,2.7834163406281953
2025-04-03T13:30:00-04:00,268.28,270.5,264.89,267.19,NaN,NaN,NaN,286.982572118731,NaN,NaN,258.48099999999994,298.2527925168087,218.70920748319114,248.74537151028295,268.36990431246244,268.8894394257982,267.8503691991267,3884105,6960693.866666666,50.65992122467223,53.61202275443808,NaN,NaN,NaN,NaN,13.10450333910285,19.35639677260228,1275385774,0.6138419241771413,3.550718745849622,2.9368768216724805
2025-04-04T09:30:00-04:00,255.32,261,236,240.98,NaN,NaN,NaN,286.982572118731,NaN,NaN,257.5797999999999,296.85179709513307,218.30780290486678,248.74537151028295,245.99333333333334,245.99333333333334,245.99333333333334,13877555,7185722.4,39.36104421256062,52.45762487765837,NaN,NaN,NaN,NaN,14.396324529166932,20.484530019717262,1261508219,-1.541517516063251,1.0099799265934166,2.5514974426566677
2025-04-04T13:30:00-04:00,240.95,246.21,238.42,239.33,NaN,NaN,NaN,282.6745564519147,NaN,NaN,256.5001999999999,294.738142568085,218.2622574319148,248.74537151028295,244.61736194362882,246.74740318640752,242.48732070085012,5791029,7269521.466666667,38.77474231709734,51.22791999159801,NaN,NaN,NaN,NaN,13.924444205655009,21.532082320609742,1255717190,-2.9402068219715938,-1.1237610848078248,1.816445737163769
2025-04-07T09:30:00-04:00,223.79,252,214.25,233.07,NaN,NaN,NaN,276.79775843137315,NaN,NaN,255.4533999999999,293.33232434798214,217.57447565201764,248.74537151028295,233.10666666666665,233.10666666666665,233.10666666666665,14849453,7500766.4,36.55030213974457,49.77467118683196,NaN,NaN,NaN,NaN,15.626269619536794,23.346458648762997,1240867737,-4.078806446286371,-3.2820623206941946,0.7967441255921763
2025-04-07T13:30:00-04:00,233.045,237.37,227.75,233.3,NaN,NaN,NaN,275.55945122994706,NaN,NaN,254.42379999999986,291.8541419466113,216.99345805338842,248.74537151028295,233.02090136256845,233.15645173635244,232.88535098878447,5944732,7599318.166666667,36.69400150822369,48.36571268414632,NaN,NaN,NaN,NaN,15.197250360998453,25.031236667762446,1246812469,-4.571226560074029,-4.91728907450036,-0.34606251442633096
2025-04-08T09:30:00-04:00,245.04,250.44,228.22,229.65,NaN,NaN,NaN,275.55945122994706,NaN,NaN,253.59479999999985,291.34573609223844,215.84386390776126,248.74537151028295,236.10333333333332,236.10333333333332,236.10333333333332,14003058,7812226.266666667,35.326658200630504,47.27963252894011,NaN,NaN,NaN,NaN,15.698875335212849,25.52206630034365,1232809411,-4.87001418480841,-6.433580245436843,-1.5635660606284336
2025-04-08T13:30:00-04:00,229.6,235.16,217.8,221.67,NaN,NaN,NaN,270.9187975049724,NaN,NaN,252.58519999999987,290.99155103521605,214.1788489647837,248.74537151028295,231.79818503110883,237.25695440116826,226.3394156610494,8709829,7997635.233333333,32.47723924136838,45.98126419769451,NaN,NaN,NaN,NaN,15.817527096983358,26.370545582773413,1224099582,-5.297004512577859,-8.184821701350756,-2.8878171887728983
2025-04-09T09:30:00-04:00,224.69,253.8,223.88,246.35,NaN,NaN,NaN,270.9187975049724,NaN,NaN,252.06479999999982,290.0879467377483,214.0416532622513,248.74537151028295,241.34333333333333,241.34333333333333,241.34333333333333,12584465,8176739.433333334,46.77573558483931,46.06825551086091,NaN,NaN,NaN,NaN,16.98270373291312,25.837396860753586,1236684047,-3.68560842731796,-7.494827722920348,-3.8092192956023885
2025-04-09T13:30:00-04:00,246.37,274.68,246.37,272.14,211.98888491799,211.98888491799,211.98888491799,NaN,NaN,NaN,251.92419999999987,289.5957589993331,214.25264100066664,236.68729720822637,253.16182329049207,264.68479528610067,241.63885129488347,13238224,8447336.266666668,57.01841299503819,46.67186223698843,NaN,NaN,NaN,NaN,17.7932248948479,24.155879834332154,1249922271,-0.801825420008095,-4.811501070612508,-4.009675650604413
2025-04-10T09:30:00-04:00,260.05,262.49,239.33,245.83,211.98888491799,NaN,NaN,NaN,NaN,NaN,251.58039999999983,289.15426543011426,214.00653456988542,236.0048377665811,249.2166666666667,249.2166666666667,249.2166666666667,13896594,8664149.633333333,47.06719323806442,46.03532912053167,NaN,NaN,NaN,NaN,18.865851688073047,22.93136622790077,1236025677,-0.5947803732324433,-4.7531511171449665,-4.158370743912523
2025-04-10T13:30:00-04:00,245.83,256.52,245.03,252.45,211.98888491799,NaN,NaN,NaN,NaN,NaN,251.36019999999985,288.78174347218055,213.93865652781915,218.18545669854888,250.0202165253424,251.04742381965096,248.99300923103382,8503894,8848361.833333334,49.457426931554004,45.77041692514184,NaN,NaN,NaN,NaN,18.339005138924968,21.794317879071627,1244529571,0.02655482773232798,-4.125177209247113,-4.151732036979441
2025-04-11T09:30:00-04:00,251.84,257.74,241.39,245.55,211.98888491799,NaN,NaN,NaN,NaN,NaN,251.06579999999983,288.4339032625467,213.69769673745293,218.18545669854888,248.22666666666672,248.22666666666672,248.22666666666672,11629253,8913422.466666667,47.07154118026536,44.84988449496001,NaN,NaN,NaN,NaN,18.196933343287473,20.925345237165736,1232900318,0.012112314627803933,-4.136591643694686,-4.14870395832249
2025-04-11T13:30:00-04:00,245.6,252.27,245.05,252.27,211.98888491799,NaN,NaN,NaN,NaN,NaN,250.85799999999983,288.0811700423312,213.63482995766842,218.18545669854888,248.7276382994077,249.48192670276,247.97334989605537,5129833,8936347.2,49.62057835213433,44.148003878921884,NaN,NaN,NaN,NaN,17.412866675909797,20.1184420696817,1238030151,0.46910272258930164,-3.562325555085863,-4.031428277675165
2025-04-14T09:30:00-04:00,258.3,261.79,245.95,247.99,211.98888491799,NaN,NaN,NaN,NaN,NaN,251.27579999999983,287.886847368797,214.66475263120265,218.18545669854888,251.91,251.91,251.91,7388808,8812936.366666667,48.03388212983022,43.92061994685882,NaN,NaN,NaN,NaN,17.300519056201956,18.75349658190764,1230641343,0.4945584779865868,-3.413230180191931,-3.907788658178518
2025-04-14T13:30:00-04:00,247.97,256,247.21,252.44,211.98888491799,NaN,NaN,NaN,NaN,NaN,251.88359999999983,287.5300268077503,216.23717319224937,218.18545669854888,251.90146806378158,251.9139068890362,251.88902923852694,3476249,8781330.933333334,49.83016833645161,43.86135188341449,NaN,NaN,NaN,NaN,16.692624837901814,17.48604720040316,1234117592,0.8042032469285347,-2.9025345995178498,-3.7067378464463845
2025-04-15T09:30:00-04:00,249.91,258.75,247.54,252.11,211.98888491799,NaN,NaN,NaN,NaN,NaN,252.4491999999998,287.1829281822781,217.7154718177215,221.3326416326275,252.79999999999998,252.79999999999998,252.79999999999998,6418057,8626890.766666668,49.692988906921045,44.599347933011664,NaN,NaN,NaN,NaN,16.301008778051685,16.350124993716012,1227699535,0.9688587185307234,-2.49566444828298,-3.4645231668137035
2025-04-15T13:30:00-04:00,252.08,254.22,250.85,254.12,211.98888491799,NaN,NaN,NaN,NaN,NaN,252.92159999999978,287.08621856600234,218.7569814339972,222.601113306102,252.86478158765735,252.97819453813813,252.75136863717657,2094023,8534163.866666667,50.585306680324834,45.44295967324221,NaN,NaN,NaN,NaN,15.377365293905138,15.295340087506517,1229793558,1.1811313039019962,-1.9881090369362084,-3.1692403408382046
2025-04-16T09:30:00-04:00,247.61,251.95,245.2,246.635,211.98888491799,NaN,NaN,NaN,NaN,NaN,252.85049999999978,287.0523379184573,218.64866208154226,222.601113306102,247.9283333333333,247.9283333333333,247.9283333333333,5875184,8395396.3,47.225978566300185,46.205507989424746,NaN,NaN,NaN,NaN,14.916124915769059,14.507884573827454,1223918374,0.8034809388893596,-2.164889167226505,-2.9683701061158647
2025-04-16T13:30:00-04:00,246.65,246.71,233.89,241.57,211.98888491799,NaN,NaN,NaN,NaN,NaN,252.71639999999982,287.04130268246007,218.3914973175396,222.601113306102,244.23749894865952,247.83891579296966,240.63608210434938,6170549,8431630.066666666,45.04597905527362,46.80207781421403,NaN,NaN,NaN,NaN,14.766401707499842,14.532283957394654,1217747825,0.22848280430597034,-2.6827666007334017,-2.911249405039372
2025-04-17T09:30:00-04:00,243.43,244.33,237.68,239.38,211.98888491799,NaN,NaN,NaN,NaN,NaN,252.7829999999998,286.99101742282727,218.5749825771723,222.601113306102,240.46333333333334,240.46333333333334,240.46333333333334,5107514,8184825.766666667,44.09811766994992,47.42861063345113,NaN,NaN,NaN,NaN,14.186658728392711,14.554940527849913,1212640311,-0.25711171168106706,-3.232639044640706,-2.975527332959639
2025-04-17T13:30:00-04:00,239.4,242.15,238.76,241.46,211.98888491799,NaN,NaN,NaN,NaN,NaN,252.7975999999998,286.985645351562,218.60955464843758,222.601113306102,240.57049125600793,240.7238604218221,240.41712209019374,2493343,8129202.166666667,45.27591671836837,48.34280188180827,NaN,NaN,NaN,NaN,13.415468819221804,14.575978771844083,1215133654,-0.3881266705321913,-3.460685671124878,-3.072559000592687
2025-04-21T09:30:00-04:00,230.21,232.2,223.17,223.5,211.98888491799,NaN,NaN,NaN,NaN,NaN,252.3073999999998,287.44563445992156,217.169165540078,222.601113306102,226.29000000000002,226.29000000000002,226.29000000000002,5764967,8023840.666666667,37.858740320805424,47.705873648662994,NaN,NaN,NaN,NaN,13.763649617848818,15.567680626894347,1209368687,-1.5680513753970247,-5.0326232198389675,-3.464571844441943
2025-04-21T13:30:00-04:00,223.47,227.87,222.79,227.5,211.98888491799,NaN,NaN,NaN,NaN,NaN,251.8579999999998,287.6725664779073,216.0434335220923,222.601113306102,226.2172026601339,226.32642377099233,226.10798154927545,2561030,7998261.466666667,40.208113225503666,46.50513795083911,NaN,NaN,NaN,NaN,13.143388930859617,16.50989709281518,1211929717,-1.9385489818378963,-5.887758071739313,-3.9492090899014167
2025-04-22T09:30:00-04:00,230.87,242.78,229.87,235.87,211.98888491799,NaN,NaN,NaN,NaN,NaN,251.84859999999983,287.6796960502245,216.0175039497752,222.601113306102,236.17333333333332,236.17333333333332,236.17333333333332,7404723,7938381.766666667,44.90225176894005,46.35049927447307,NaN,NaN,NaN,NaN,13.296004007226786,16.004737620016726,1219334440,-1.4989897313065281,-5.822946254034576,-4.323956522728048
2025-04-22T13:30:00-04:00,235.865,238.61,234.47,238.05,211.98888491799,NaN,NaN,NaN,NaN,NaN,251.85239999999985,287.67760092002794,216.02719907997175,222.601113306102,236.44318664271088,236.8456187122272,236.04075457319456,3329501,7916770.666666667,46.08939620151327,46.10992565089874,NaN,NaN,NaN,NaN,12.642003720996302,15.535660966703876,1222663941,-0.9663597967034816,-5.5319062686074005,-4.565546471903919
2025-04-23T09:30:00-04:00,254.89,259.44,244.43,255.97,211.98888491799,NaN,NaN,NaN,NaN,NaN,252.43279999999984,287.5589095574271,217.30669044257257,229.38972820045558,253.28,253.28,253.28,12176507,7996596.833333333,54.7250276421081,46.65660325531608,NaN,NaN,NaN,NaN,13.266860598067993,15.280677603071974,1234840448,0.6033762562369853,-3.8113261516076875,-4.414702407844673
2025-04-23T13:30:00-04:00,255.96,258.23,250.34,250.72,214.06132566652343,NaN,NaN,NaN,NaN,NaN,252.93759999999983,287.21503719942274,218.66016280057693,230.24478256036446,253.23446189672399,253.31367637404628,253.1552474194017,4024051,8000214.633333334,52.092337599734265,46.8331574872875,NaN,NaN,NaN,NaN,12.882799126777423,15.043907336842349,1230816397,1.2608316871123302,-2.8386627989542603,-4.0994944860665905
2025-04-24T09:30:00-04:00,250.66,258.15,249.21,255.37,214.06558359077235,NaN,NaN,NaN,NaN,NaN,253.35879999999983,287.2254117325065,219.49218826749322,231.29182604829154,254.24333333333334,254.24333333333334,254.24333333333334,7245621,7676229.166666667,54.19423824707027,47.27318292423322,NaN,NaN,NaN,NaN,12.601170617721891,14.726836290460724,1238062018,1.9409435791497125,-1.67331501212945,-3.6142585912791625
2025-04-24T13:30:00-04:00,255.34,259.52,254.58,259.52,218.56260251846453,NaN,NaN,NaN,NaN,NaN,253.83260000000007,287.36624830971783,220.2989516902823,235.56346083863326,255.30239674841002,256.9524830732866,253.65231042353344,2984738,7559630.1,56.0476386097163,47.71728794375212,NaN,NaN,NaN,NaN,12.053944145027469,14.532169492799701,1241046756,2.563270877964415,-0.4101699938236436,-2.9734408717880587
2025-04-25T09:30:00-04:00,261.7,286.85,259.66,286.69,232.79021149489793,NaN,NaN,NaN,NaN,NaN,254.88000000000002,289.173246507147,220.58675349285306,254.01976867090661,277.73333333333335,277.73333333333335,277.73333333333335,13761325,7677273.8,65.80334962383739,48.86802799496043,NaN,NaN,NaN,NaN,13.145090991811225,15.930909398101084,1254808081,4.579996896125136,2.751555248368362,-1.8284416477567744
2025-04-25T13:30:00-04:00,286.62,286.62,281.05,284.9,244.4404291542208,NaN,NaN,NaN,NaN,NaN,255.85420000000005,290.730857486632,220.9775425133681,257.5358149367253,279.5327548042864,282.42763770358533,276.6378719049875,5316968,7725035.9,64.7831460865984,49.88215938112283,NaN,NaN,NaN,NaN,12.609013063824708,17.22973931016665,1249491113,5.506386623701983,5.0545416318707055,-0.45184499183127835
2025-04-28T09:30:00-04:00,288.99,294.85,272.42,276.55,244.4404291542208,NaN,NaN,NaN,NaN,NaN,256.47860000000003,291.69544716382126,221.2617528361788,260.3676519493803,281.2733333333333,281.2733333333333,281.2733333333333,12221072,7669819.8,60.10206318737685,50.80187971119973,NaN,NaN,NaN,NaN,13.310512130694374,17.628508525342635,1237270041,5.269617763772224,6.1351772128840025,0.8655594491117777
2025-04-28T13:30:00-04:00,276.52,286.71,275.4,285.93,244.4404291542208,NaN,NaN,NaN,NaN,NaN,257.21500000000003,293.3135357043733,221.11646429562677,260.3676519493803,281.61124531936025,282.2121987424495,281.010291896271,3863980,7605584.833333333,63.30937003902527,52.10640763861057,NaN,NaN,NaN,NaN,13.167618407073347,17.998794225148913,1241134021,5.435692104868775,7.660174580197747,2.224482475328972
2025-04-29T09:30:00-04:00,285.46,289.3,279.48,284.89,244.52877623941006,NaN,NaN,NaN,NaN,NaN,257.4322,294.05962809207267,220.80477190792735,260.3676519493803,284.5566666666667,284.5566666666667,284.5566666666667,6594052,7330404.8,62.70746977253032,53.43564707450917,NaN,NaN,NaN,NaN,12.928502806568106,18.499740314188422,1234539969,5.168185769799252,8.684714687578037,3.5165289177787846
2025-04-29T13:30:00-04:00,284.885,293.32,284.16,291.995,249.44155913761873,NaN,NaN,NaN,NaN,NaN,257.70390000000003,295.1423124818339,220.2654875181661,263.5378377980827,286.26090257040875,288.7254639520587,283.7963411887588,3153062,7237349.133333334,65.14545666748754,54.85489992801768,NaN,NaN,NaN,NaN,12.659324034670382,19.20843266393106,1237693031,5.150958121889006,9.955226570140042,4.804268448251036
2025-04-30T09:30:00-04:00,279.95,281.41,270.79,278.02,249.44155913761873,NaN,NaN,NaN,NaN,NaN,257.7203,295.19356158262667,220.24703841737335,263.5378377980827,276.74,276.74,276.74,8615615,7057767.7,57.22151473909535,56.23795524360981,NaN,NaN,NaN,NaN,13.269729460765353,18.581918293249064,1229077416,3.9344869793892494,9.722377172487597,5.787890193098348
2025-04-30T13:30:00-04:00,277.99,284.45,277.73,282.08,249.44155913761873,NaN,NaN,NaN,NaN,NaN,257.59900000000005,294.7151028126593,220.48289718734077,263.5378377980827,278.2211074124023,280.3977799929637,276.04443483184093,3989084,6900409.533333333,58.789785086851076,57.565217519420344,NaN,NaN,NaN,NaN,12.801891642139253,18.212253269445554,1233066500,3.1721067503618547,9.753023631050667,6.580916880688812
2025-05-01T09:30:00-04:00,280.01,290.85,279.92,284.1,249.44155913761873,NaN,NaN,NaN,NaN,NaN,257.86320000000006,295.53783426550933,220.1885657344908,263.5378377980827,284.95666666666665,284.95666666666665,284.95666666666665,6483187,6697033.6,59.5836787377206,58.613890874333244,NaN,NaN,NaN,NaN,12.668185096272165,18.301416608289053,1239549687,2.5968892329519173,9.827028421878708,7.230139188926791
2025-05-01T13:30:00-04:00,284.15,284.63,279.825,280.57,249.44155913761873,NaN,NaN,NaN,NaN,NaN,258.035,296.04243590404315,220.02756409595688,263.5378377980827,284.07954953491816,285.5318138329074,282.6272852369289,2364898,6334589.4,57.49906196235854,59.42886700010791,NaN,NaN,NaN,NaN,12.10652901796701,18.3746855347687,1237184789,1.8090286599573977,9.491425013873538,7.682396353916141
2025-05-02T09:30:00-04:00,284.9,294.49,279.82,292.15,249.44155913761873,NaN,NaN,NaN,NaN,NaN,258.3980000000001,297.343529499544,219.45247050045617,265.9132770896757,288.82,288.82,288.82,8871322,6167080.333333333,62.17430669178196,59.96095836079889,NaN,NaN,NaN,NaN,12.289634088112225,19.081965221230085,1246056111,1.889350250457305,10.044084166987773,8.154733916530468
2025-05-02T13:30:00-04:00,292.17,294.78,285.8,287.25,252.48306539658614,NaN,NaN,NaN,NaN,NaN,258.67840000000007,298.2439878985751,219.11281210142505,267.4286216717406,288.97414147612903,289.19008517118317,288.7581977810749,4520082,6034286.6,59.20642310352703,60.469107325355516,NaN,NaN,NaN,NaN,12.053231653247064,19.756663296688796,1241536029,1.4535996999406908,9.97173354145633,8.51813384151564
2025-05-05T09:30:00-04:00,284.64,284.85,274.38,280.49,252.48306539658614,NaN,NaN,NaN,NaN,NaN,259.02260000000007,299.0391908712862,219.0060091287139,267.4286216717406,279.9066666666667,279.9066666666667,279.9066666666667,6946465,5878193.666666667,55.285549511112265,60.547058129929944,NaN,NaN,NaN,NaN,12.111572249443702,19.196187728836257,1234589564,0.5952139908654281,9.262151330097424,8.666937339231996
2025-05-05T13:30:00-04:00,280.5,283.39,279.26,280.205,252.48306539658614,NaN,NaN,NaN,NaN,NaN,259.35670000000005,299.7939700666093,218.91942993339077,267.4286216717406,280.198071657381,280.6666880748155,279.72945523994645,2686104,5796736.033333333,55.11981817168249,60.48078524149896,NaN,NaN,NaN,NaN,11.541459945912008,18.675746130116046,1231903460,-0.07121049037109728,8.577924226268124,8.649134716639221
2025-05-06T09:30:00-04:00,273.12,277.72,271.37,273.67,252.48306539658614,NaN,NaN,NaN,NaN,NaN,259.7445000000001,300.3511382380993,219.13786176190087,267.4286216717406,274.25333333333333,274.25333333333333,274.25333333333333,6252198,5758849.033333333,51.320796158167234,59.446317136808226,NaN,NaN,NaN,NaN,11.348141378346863,17.44209280706491,1225651262,-0.9810804161330644,7.42278419647289,8.403864612605954
2025-05-06T13:30:00-04:00,273.68,276.71,272.75,275.27,252.48306539658614,NaN,NaN,NaN,NaN,NaN,260.0647000000001,300.90283744087594,219.22656255912423,267.4286216717406,274.43219868833063,274.7245377059306,274.1398596707307,2340516,5720991.266666667,52.18964666980096,58.54678146417984,NaN,NaN,NaN,NaN,10.820416994179228,16.29655757851743,1227991778,-1.4744475693271824,6.560805150946976,8.035252720274158
2025-05-07T09:30:00-04:00,276.92,277.92,272.16,275.35,252.48306539658614,NaN,NaN,NaN,NaN,NaN,260.1049000000001,300.99914837259973,219.21065162740044,267.4286216717406,275.1433333333334,275.1433333333334,275.1433333333334,4007443,5640637.466666667,52.23555178137948,57.98488779232289,NaN,NaN,NaN,NaN,10.45895863745214,15.348499853608564,1231999221,-1.7745380169965639,5.817080199028453,7.591618216025017
2025-05-07T13:30:00-04:00,275.38,277.25,271,276.21,252.48306539658614,NaN,NaN,NaN,NaN,NaN,260.2583000000001,301.3350974705896,219.18150252941058,267.4286216717406,275.0079039935922,275.1674273893474,274.84838059783704,2888312,5667113.766666667,52.760644750464046,57.231407414568515,NaN,NaN,NaN,NaN,10.158318734776987,14.34547441753006,1234887533,-1.8839328240216489,5.236702185997956,7.120635010019605
2025-05-08T09:30:00-04:00,279.63,289.81,279.44,287.1,252.48306539658614,NaN,NaN,NaN,NaN,NaN,260.3285000000001,301.57619410524444,219.0808058947557,267.74407638361345,285.45,285.45,285.45,7660395,5726620.8,58.919269064504206,56.9608216497095,NaN,NaN,NaN,NaN,10.404153110864346,14.561490709924426,1242547928,-1.2236836092512418,5.591030498455552,6.814714107706794
2025-05-08T13:30:00-04:00,287.11,289.79,284.66,284.9,254.1410115539214,NaN,NaN,NaN,NaN,NaN,260.3713,301.7163342270992,219.02626577290084,269.5722611068908,285.7321180997278,286.18214862925646,285.28208757019917,3010434,5621283.633333334,57.29420701542345,56.4000181031335,NaN,NaN,NaN,NaN,10.02742788865975,14.762077267147763,1239537494,-0.9482319838522155,5.629424127891525,6.577656111743741
2025-05-09T09:30:00-04:00,290.2,307.03,290,297.91,263.91710193783405,NaN,NaN,NaN,NaN,NaN,260.96430000000004,303.57602434952616,218.3525756504739,279.79080888551255,298.31333333333333,298.31333333333333,298.31333333333333,11370413,5830046.933333334,63.67478586422455,56.86096604064272,NaN,NaN,NaN,NaN,10.891897325184052,16.162897520664668,1250907907,0.04442421709673727,6.633186383114662,6.588762166017925
2025-05-09T13:30:00-04:00,297.9,301.09,296.51,298.27,265.150188213387,NaN,NaN,NaN,NaN,NaN,261.58590000000004,305.4316521176223,217.74014788237776,279.79080888551255,298.3874124070432,298.51961226962555,298.25521254446085,3570305,5865945.666666667,63.83579927433724,57.22139562546317,NaN,NaN,NaN,NaN,10.441047516242334,17.46365918464465,1254478212,0.6271789740281442,7.372735883553105,6.745556909524961
2025-05-12T09:30:00-04:00,321.99,322.21,311.52,318.34,281.4801796582331,NaN,NaN,NaN,NaN,NaN,263.13310000000007,309.35634791227824,216.90985208772193,290.974917686728,317.3566666666666,317.3566666666666,317.3566666666666,8522061,5957848.8,71.43706965420424,58.068066405211994,NaN,NaN,NaN,NaN,11.40525840793931,19.73197788318798,1263000273,2.1788831657441303,9.469160866705124,7.290277700960994
2025-05-12T13:30:00-04:00,318.4,319.82,316.14,318.61,283.7017624010407,NaN,NaN,NaN,NaN,NaN,264.71870000000007,312.96204199907726,216.47535800092288,292.9919341493824,317.5644822560192,317.9250267590137,317.20393775302466,2831282,5966857.2,71.5237839425362,59.06983226093897,NaN,NaN,NaN,NaN,10.853454235943646,21.838273817549645,1265831555,2.9880073346465377,11.025286869269166,8.037279534622629
2025-05-13T09:30:00-04:00,319.98,329.48,316.81,329.39,288.697136837357,NaN,NaN,NaN,NaN,NaN,266.64510000000007,317.3110148339378,215.97918516606236,301.68254731950594,325.22666666666663,325.22666666666663,325.22666666666663,8421767,6000758.666666667,74.81173830107193,59.972505947316826,NaN,NaN,NaN,NaN,10.983207504804815,24.18275621451284,1274253322,3.953194479063198,12.978772633451626,9.025578154388429
2025-05-13T13:30:00-04:00,329.39,337.58,328.66,333.94,299.02158516293173,NaN,NaN,NaN,NaN,NaN,268.65790000000004,321.8007838167444,215.5150161832557,310.8820378556048,328.55174126689445,332.5640541665511,324.5394283672378,5783842,6082570.033333333,76.06777931004746,61.17688853349686,NaN,NaN,NaN,NaN,10.835835540175896,26.64547298816621,1280037164,4.559007992632585,14.72433814517916,10.165330152546575
2025-05-14T09:30:00-04:00,342.4,350,337,344.57,308.7615131100712,NaN,NaN,NaN,NaN,NaN,270.95630000000006,327.0126821811566,214.89991781884348,320.6116302844838,343.8566666666666,343.8566666666666,343.8566666666666,9473618,5992473.733333333,78.73564732339526,62.8518955200885,NaN,NaN,NaN,NaN,11.208990144449047,29.307735431534088,1289510782,5.285435825774128,16.772124934764236,11.486689108990108
2025-05-14T13:30:00-04:00,344.58,350,343.32,347.47,312.58962615052246,NaN,NaN,NaN,NaN,NaN,273.4723000000001,331.70470947135766,215.23989052864252,323.14930422758704,344.79741592948784,346.21382931979747,343.3810025391782,4179108,5997642.3,79.41000002823378,64.58690850984216,NaN,NaN,NaN,NaN,10.885490848416973,31.779836271804257,1293689890,5.544024711666269,18.416719998572944,12.872695286906675
2025-05-15T09:30:00-04:00,340.31,346.12,334.72,345.43,312.58962615052246,NaN,NaN,NaN,NaN,NaN,275.4539000000001,336.5332735491763,214.3745264508239,323.14930422758704,342.09,342.09,342.09,7606263,6009663.7,77.54698353723951,66.46020760834732,NaN,NaN,NaN,NaN,11.018670073530046,32.99058215227929,1286083627,5.167930339254589,19.33260821097491,14.164677871720322
2025-05-15T13:30:00-04:00,345.41,345.45,339.6,342.77,312.58962615052246,NaN,NaN,NaN,NaN,NaN,276.8665000000001,340.7753894364456,212.9576105635546,323.14930422758704,342.2362475312633,342.4689982221438,342.0034968403828,3003077,6010275,75.07374648005906,68.0947861662229,NaN,NaN,NaN,NaN,10.649479353992183,34.11484618414896,1283080550,4.362398574689479,19.61767609008217,15.255277515392692
2025-05-16T09:30:00-04:00,346.07,351.63,342.33,347.83,313.73378641810564,NaN,NaN,NaN,NaN,NaN,278.9065000000001,345.19001279918604,212.62298720081418,326.8124437645246,347.2633333333334,347.2633333333334,347.2633333333334,6962051,5783632.533333333,76.60245501561252,69.8352792543824,NaN,NaN,NaN,NaN,10.55308797156417,35.42130827076154,1290042601,3.8126606543821495,20.021103333370377,16.208442678988227
2025-05-16T13:30:00-04:00,347.91,349.93,346.87,349.84,316.2477052172826,NaN,NaN,NaN,NaN,NaN,280.8543000000001,349.59189940556473,212.11670059443543,328.5459550116197,347.6920188670669,348.40565065306515,346.97838708106866,2512271,5690142.633333334,77.2006199424604,71.58099176809642,NaN,NaN,NaN,NaN,10.017867402166729,36.634451636901794,1292554872,3.248733830789508,20.26935996747511,17.020626136685603
2025-05-19T09:30:00-04:00,336.31,343,333.37,342.01,316.2477052172826,NaN,NaN,NaN,NaN,NaN,282.7835000000001,352.85104173652593,212.7159582634743,328.5459550116197,339.46000000000004,339.46000000000004,339.46000000000004,6428564,5497059.033333333,69.72278665982839,72.35267159633386,NaN,NaN,NaN,NaN,10.478734016297675,36.087860548863034,1286126308,2.0701053199225647,19.60825778658881,17.538152466666244
2025-05-19T13:30:00-04:00,342.01,342.75,339.31,341.97,316.2477052172826,NaN,NaN,NaN,NaN,NaN,284.5775000000001,356.00819444573375,213.14680555426645,328.5459550116197,339.9576264533248,340.78802659785293,339.12722630879665,2308586,5445212.566666666,69.68565184437355,73.23777479840173,NaN,NaN,NaN,NaN,9.975967300847842,35.58031168139848,1283817722,1.0604007667298916,18.86365342507861,17.80325265834872
2025-05-20T09:30:00-04:00,347.95,354.56,342.89,350.36,316.5498749077061,NaN,NaN,NaN,NaN,NaN,286.6249000000001,359.59525078687665,213.65454921312352,330.6699689659493,349.27,349.27,349.27,8015260,5492586.166666667,72.94105008952621,73.89965081449472,NaN,NaN,NaN,NaN,10.162683922215852,35.793303096795654,1291832982,0.7450708968810709,18.734591279450058,17.989520382568987
2025-05-20T13:30:00-04:00,350.35,354.99,341.65,343.79,316.5498749077061,NaN,NaN,NaN,NaN,NaN,288.4519000000001,362.47392158520034,214.42987841479982,330.6699689659493,348.37335659658254,349.5573217056442,347.1893914875209,4597051,5540719.133333334,66.88393533858155,74.1173748190836,NaN,NaN,NaN,NaN,10.389635070629009,35.842385371976626,1287235931,-0.07491867888408166,17.895872033963883,17.970790712847965
2025-05-21T09:30:00-04:00,344.43,347.35,335.55,336,316.5498749077061,NaN,NaN,NaN,NaN,NaN,290.12970000000007,364.5824143738888,215.67698562611133,330.6699689659493,339.6333333333334,339.6333333333334,339.6333333333334,6528954,5471163.766666667,60.47178962433824,73.33414053123603,NaN,NaN,NaN,NaN,10.490375422726938,35.169247451230476,1280706977,-1.2459207679381343,16.413389752925298,17.659310520863432
2025-05-21T13:30:00-04:00,336.035,340.18,332.21,334.6,316.5498749077061,NaN,NaN,NaN,NaN,NaN,291.73930000000007,366.48765219615143,216.9909478038487,330.6699689659493,338.18367353911293,340.0951221688406,336.2722249093853,3755351,5463372.666666667,59.370186300158096,72.4660264139233,NaN,NaN,NaN,NaN,10.310348606817872,34.16799271214065,1276951626,-2.164910258333034,14.953172697947139,17.118082956280173
2025-05-22T09:30:00-04:00,331.89,345.15,331.4,344.78,316.5498749077061,NaN,NaN,NaN,NaN,NaN,293.70220000000006,368.7636261031583,218.64077389684184,330.6699689659493,340.4433333333333,340.4433333333333,340.4433333333333,6900766,5477291.966666667,64.44251999135203,71.72536796322903,NaN,NaN,NaN,NaN,10.556037992045166,33.59072901225606,1283852392,-2.1338253711354085,14.45080124236091,16.58462661349632
2025-05-22T13:30:00-04:00,344.75,347.27,340.67,341.03,316.5498749077061,NaN,NaN,NaN,NaN,NaN,295.6914000000001,370.39188441716993,220.99091558283027,330.6699689659493,341.306425459977,342.5118631108382,340.1009878091158,3537709,5516385.666666667,61.40156095056678,70.67778093755183,NaN,NaN,NaN,NaN,10.273463849756224,33.20223946558015,1280314683,-2.392998428545166,13.59337857781486,15.986377006360026
2025-05-23T09:30:00-04:00,337.55,343.17,333.22,343.05,316.5498749077061,NaN,NaN,NaN,NaN,NaN,297.7648000000001,371.8506655874378,223.6789344125624,330.6699689659493,339.81333333333333,339.81333333333333,339.81333333333333,6553988,5439141.2,62.43001262563153,69.51309274485443,NaN,NaN,NaN,NaN,10.25035928905935,31.965997246597276,1286868671,-2.446831214770995,12.927837987896282,15.374669202667278
2025-05-23T13:30:00-04:00,343.05,343.05,339.02,339.3,316.5498749077061,NaN,NaN,NaN,NaN,NaN,299.7216000000001,372.91855759906844,226.5246424009317,330.6699689659493,339.98930014569095,340.2760770570136,339.7025232343683,2467623,5370725.9,59.27259056791866,68.07470635483192,NaN,NaN,NaN,NaN,9.806047911269399,30.818058043256038,1284401048,-2.7317897904588673,11.959931964593693,14.69172175505256
2025-05-27T09:30:00-04:00,347.35,363,347.25,361.52,322.22446006455067,NaN,NaN,NaN,NaN,NaN,302.4820000000001,374.37122147304046,230.5927785269597,333.5890631069503,357.25666666666666,357.25666666666666,357.25666666666666,8536522,5423727.8,69.20953625545981,67.47917440613335,NaN,NaN,NaN,NaN,10.798473060464442,31.1279201185447,1292937570,-1.483104503060149,12.837841126227374,14.320945629287523
2025-05-27T13:30:00-04:00,361.54,363.78,357.8,362.75,328.5694846070711,NaN,NaN,NaN,NaN,NaN,305.1870000000001,375.75318583995994,234.6208141600403,337.2612504855602,358.55567399050693,360.4924472439092,356.61890073710464,3840136,5462195.533333333,69.65096113934914,67.09183259608265,NaN,NaN,NaN,NaN,10.454296413288407,31.459884806715166,1296777706,-0.6747715683869178,13.477481168803877,14.152252737190794
2025-05-28T09:30:00-04:00,364.89,364.89,358.64,362.61,330.1567807612951,NaN,NaN,NaN,NaN,NaN,307.7218000000001,377.24366774706175,238.19993225293842,340.55000038844815,362.0466666666666,362.0466666666666,362.0466666666666,5702255,5443864.1,69.52877757705382,66.5865699218999,NaN,NaN,NaN,NaN,10.153989526624951,31.834314699626233,1291075451,-0.27070936403529444,13.813866032146677,14.084575396181972
2025-05-28T13:30:00-04:00,362.57,364,355.9,356.76,330.1567807612951,NaN,NaN,NaN,NaN,NaN,310.0960000000001,378.0282428600723,242.16375713992798,340.55000038844815,361.0022177310565,362.4886850389417,359.51575042317126,2815207,5459687.133333334,64.44173461972966,65.67522097027626,NaN,NaN,NaN,NaN,10.007275989008885,31.821379930022697,1288260244,-0.5049996888563069,13.453325785111588,13.958325473967895
2025-05-29T09:30:00-04:00,365.29,367.72,359.45,361.11,332.2360647019239,NaN,NaN,NaN,NaN,NaN,312.19880000000006,379.80743032365046,244.59016967634966,343.42240024860683,362.76000000000005,362.76000000000005,362.76000000000005,5461845,5508167.2,66.4097655534726,65.43857660553655,NaN,NaN,NaN,NaN,10.075327704079681,32.05947847347495,1293722089,-0.47502395866360203,13.364545525638391,13.839569484301993
2025-05-29T13:30:00-04:00,361.11,362.4,355.99,358.37,332.2360647019239,NaN,NaN,NaN,NaN,NaN,314.3518,380.83906349489877,247.86453650510128,343.42240024860683,361.47989673259127,363.29012659966156,359.669666865521,2731253,5502931.9,64.00671513780935,65.03293826935341,NaN,NaN,NaN,NaN,9.813518582359702,31.809345684792454,1290990836,-0.7323673229597745,12.924110330602275,13.65647765356205
2025-05-30T09:30:00-04:00,355.54,363.68,345.3,348.41,332.2360647019239,NaN,NaN,NaN,NaN,NaN,316.2126,381.18332079760364,251.24187920239638,343.42240024860683,352.46333333333337,352.46333333333337,352.46333333333337,7514655,5498073.9,56.0649693183922,63.82750392855812,NaN,NaN,NaN,NaN,10.425410112191154,30.294095061170257,1283476181,-1.6154006844814486,11.637226797960238,13.252627482441687
2025-05-30T13:30:00-04:00,348.31,352.42,345.45,345.78,332.2360647019239,NaN,NaN,NaN,NaN,NaN,317.93780000000004,381.357857715521,254.51774228447908,343.42240024860683,350.8086365699568,353.0087478847604,348.60852525515315,4250662,5539414.833333333,54.15421945347707,62.91823850819351,NaN,NaN,NaN,NaN,10.178595104177502,28.887076624949643,1279225519,-2.3728490459746627,10.286566174973359,12.659415220948022
2025-06-02T09:30:00-04:00,343.65,348.01,333.33,338.25,332.2360647019239,NaN,NaN,NaN,NaN,NaN,318.969,381.99869985649696,255.939300143503,343.42240024860683,339.8633333333333,339.8633333333333,339.8633333333333,5163883,5332530.5,49.00462283644149,62.09915516620089,NaN,NaN,NaN,NaN,10.50012402530768,27.29292163325544,1274061636,-3.319174817455009,8.510446699129261,11.82962151658427
2025-06-02T13:30:00-04:00,338.22,343.05,337.89,342.71,332.2360647019239,NaN,NaN,NaN,NaN,NaN,320.1252,382.7321559700843,257.5182440299157,343.42240024860683,340.2339452944262,340.8374420176703,339.63044857118206,1947446,5278435.2,51.92085573768149,61.56706012602399,NaN,NaN,NaN,NaN,10.118686594928562,25.81263485525368,1276009082,-3.561538469698828,7.377698429460736,10.939236899159564
2025-06-03T09:30:00-04:00,346.55,355.4,343.85,354.5,332.2360647019239,NaN,NaN,NaN,NaN,NaN,321.68420000000003,383.7529950377648,259.6154049622353,343.42240024860683,351.25,351.25,351.25,5763931,5186497.533333333,58.652275066209384,61.153471202799516,NaN,NaN,NaN,NaN,10.30235183814795,24.679439521163857,1281773013,-2.874066258099102,7.346654076535685,10.220720334634787
2025-06-03T13:30:00-04:00,354.5,354.52,343.04,344.345,332.2360647019239,NaN,NaN,NaN,NaN,NaN,322.8525,384.3820663969773,261.32293360302276,343.42240024860683,349.65573920130896,351.59300675105004,347.7184716515679,3903537,5222239.366666666,51.91075175716778,60.475556260413875,NaN,NaN,NaN,NaN,10.386469563994524,23.54214562303914,1277869476,-3.0337574243950236,6.428523554141009,9.462280978536032
2025-06-04T09:30:00-04:00,345.11,345.58,327.33,332.87,NaN,NaN,NaN,368.45926497743557,368.45926497743557,368.45926497743557,323.8121,384.43338441694505,263.1908155830549,343.42240024860683,335.26,335.26,335.26,7507140,5191751.8,45.54086253759952,59.26918839698301,NaN,NaN,NaN,NaN,10.948150309423486,22.667965926699736,1270362336,-3.793387678262686,4.720546380707674,8.51393405897036
2025-06-04T13:30:00-04:00,332.83,335.6,331.95,332.15,NaN,NaN,NaN,365.5063232647546,NaN,NaN,324.6152,384.589658428902,264.64074157109803,343.42240024860683,334.7180702529947,335.6150781142952,333.8210623916942,2740110,5090294.066666666,45.16636053556186,58.261600537528956,NaN,NaN,NaN,NaN,10.426853858750382,21.85622763724172,1267622226,-4.194222184130351,3.2711563288074217,7.4653785129377725
2025-06-05T09:30:00-04:00,322.51,324.55,301.5,302.37,NaN,NaN,NaN,347.4935358436294,NaN,NaN,325.1022,383.9399930299921,266.2644069700079,339.75692019888544,309.4733333333333,309.4733333333333,309.4733333333333,13457850,5223101.8,33.05757139006455,55.67931733285786,NaN,NaN,NaN,NaN,11.871364297411066,22.95944004613332,1254164376,-6.194139888814923,-0.2772963480808812,5.916843540734042
2025-06-05T13:30:00-04:00,302.36,305,273.22,284.57,NaN,NaN,NaN,326.3454205780099,NaN,NaN,325.152,383.8480980985971,266.45590190140285,336.3755361591084,297.8070530913596,308.72113708449945,286.89296909821974,15376798,5596358.133333334,28.192404618771945,52.71799186710235,NaN,NaN,NaN,NaN,13.293409704738846,24.999124648274528,1238787578,-8.312839662053573,-4.474206036832925,3.838633625220648
2025-06-06T09:30:00-04:00,298.86,305.5,291.14,300.07,NaN,NaN,NaN,326.3454205780099,NaN,NaN,325.4714,383.4397626486045,267.5030373513955,329.3251716107708,298.90333333333336,298.90333333333336,298.90333333333336,12034532,5743967.1,36.900956483689974,50.38743321757636,NaN,NaN,NaN,NaN,13.838880440114641,26.84660345365823,1250822110,-8.250849143339686,-6.47492780395396,1.775921339385726
2025-06-06T13:30:00-04:00,300.07,302,293.16,295.19,NaN,NaN,NaN,326.3454205780099,NaN,NaN,325.7638,382.96568173688075,268.56191826311925,329.3251716107708,298.2805020883984,299.2461539301974,297.3148502465994,5006438,5810745.8,35.44353426118478,48.31613319196602,NaN,NaN,NaN,NaN,13.481817551535022,28.562119487228816,1245815672,-8.107092476477971,-8.357944256211738,-0.2508517797337668
2025-06-09T09:30:00-04:00,286,297.85,281.85,297.06,NaN,NaN,NaN,326.3454205780099,NaN,NaN,325.862,382.8491770488773,268.8748229511227,329.3251716107708,292.25333333333333,292.25333333333333,292.25333333333333,6713110,5802447.766666667,36.47884945511098,46.17821061351162,NaN,NaN,NaN,NaN,13.661687726425376,30.510724950147576,1252528782,-7.470375399634882,-9.58882102927737,-2.1184456296424874
2025-06-09T13:30:00-04:00,297,309.83,296.9,308.71,NaN,NaN,NaN,326.3454205780099,NaN,NaN,326.2912,382.4255554540363,270.1568445459637,329.3251716107708,297.50242498680467,303.836880385566,291.1679695880433,4609709,5872362.366666666,42.64960390953816,44.65270266863511,NaN,NaN,NaN,NaN,13.609424317394993,31.16681016291033,1257138491,-5.9168948005647675,-9.514564130348447,-3.5976693297836793
2025-06-10T09:30:00-04:00,314.94,321.21,310.69,319.98,NaN,NaN,NaN,326.3454205780099,NaN,NaN,327.081,381.7064266070303,272.4555733929697,327.9201372886166,317.29333333333335,317.29333333333335,317.29333333333335,8974576,5957229.433333334,47.920333967622845,44.070943000723005,NaN,NaN,NaN,NaN,13.53017972329535,30.819782244340537,1266113067,-3.8810055185671946,-8.448926227992672,-4.5679207094254775
2025-06-10T13:30:00-04:00,320,327.81,318.05,326.1,285.0386147604298,285.0386147604298,285.0386147604298,NaN,NaN,NaN,327.9989,380.9597847090014,275.0380152909986,315.1751098308933,319.6368562866924,322.8296419776189,316.44407059576594,4835182,6041449.3,50.57664406694671,43.81540190168513,NaN,NaN,NaN,NaN,13.260881171631395,29.988023720046613,1270948249,-1.9692918722673438,-7.029535549759657,-5.060243677492314
2025-06-11T09:30:00-04:00,334.49,335.4,326.03,330.93,293.26822318041025,NaN,NaN,NaN,NaN,NaN,329.14410000000004,379.7816980350572,278.50650196494286,309.4510878647147,330.7866666666666,330.78667327391605,330.7866600594171,7199154,6014245.766666667,52.63013650574872,44.074367163778504,NaN,NaN,NaN,NaN,12.982961087943439,28.659214483226457,1278147403,-0.313460668838089,-5.452069513539925,-5.138608844701836
2025-06-11T13:30:00-04:00,330.96,331.08,322.48,326.39,293.26822318041025,NaN,NaN,NaN,NaN,NaN,330.16650000000004,378.41998112830856,281.9130188716915,302.61930698353035,329.4619031184406,331.3919566805192,327.53184955636203,3391716,5974067.933333334,50.505930375557526,43.97330106648394,NaN,NaN,NaN,NaN,12.66989243880462,27.627091892532242,1274755687,0.497929899150825,-4.516196470763305,-5.01412636991413
2025-06-12T09:30:00-04:00,323.13,332.56,322.77,325.1,293.26822318041025,NaN,NaN,NaN,NaN,NaN,331.1615,376.83538751792616,285.4876124820738,303.24535646945947,326.81,326.81,326.81,5884660,5952591.466666667,49.88977218908499,43.34740800383219,NaN,NaN,NaN,NaN,12.464185836032863,26.55358573524447,1268871027,0.9437795264924542,-3.8344019617985623,-4.7781814882910165
2025-06-12T13:30:00-04:00,325.11,325.76,316.88,319.19,293.26822318041025,NaN,NaN,NaN,NaN,NaN,332.0211,375.0680547025128,288.97414529748715,303.24535646945947,324.6841630520948,327.6271218265165,321.7412042776731,3070527,5929764,47.05733905097077,43.000735667675265,NaN,NaN,NaN,NaN,12.208172562030516,25.91276503741316,1265800500,0.8401543284589064,-3.727988577717383,-4.5681429061762895
2025-06-13T09:30:00-04:00,313.99,332.98,313.3,332.2,293.26822318041025,NaN,NaN,NaN,NaN,NaN,332.9231,374.0127098248717,291.83349017512825,303.24535646945947,326.16,326.16,326.16,8062660,5968493.8,53.337753302247684,43.55765643657871,NaN,NaN,NaN,NaN,12.74187452188548,24.72973619555186,1273863160,1.603076476859881,-2.5642973101014377,-4.167373786961319
2025-06-13T13:30:00-04:00,332.15,332.99,323.29,325.37,293.26822318041025,NaN,NaN,NaN,NaN,NaN,333.7325,372.5371648871003,294.92783511289974,303.24535646945947,326.5575021832769,327.0693804122183,326.04562395433544,4862102,6012640.233333333,49.98537102955975,43.901871471864276,NaN,NaN,NaN,NaN,12.52459777032223,23.630393875277544,1269001058,1.5993438888036495,-2.168193925956757,-3.7675378147604066
2025-06-16T09:30:00-04:00,331.2,332.05,326.45,329.27,293.26822318041025,NaN,NaN,NaN,NaN,NaN,334.35970000000003,371.8184972262868,296.90090277371326,304.2518420098906,329.25666666666666,329.25666666666666,329.25666666666666,5413614,5974627.766666667,51.84649502147981,45.243937445536794,NaN,NaN,NaN,NaN,12.1071265010135,22.60957600645139,1274414672,1.7964009374670957,-1.5220366429265368,-3.3184375803936326
2025-06-16T13:30:00-04:00,329.22,330.67,327.21,329.09,294.07002849703036,NaN,NaN,NaN,NaN,NaN,334.97610000000003,371.02698011630315,298.9252198836969,306.7014736079125,329.1826334598448,329.3020540307905,329.0632128888991,2080569,5961725.966666667,51.75077832004902,46.92667842419944,NaN,NaN,NaN,NaN,11.489474608083967,21.661673699684254,1272334103,1.8445085548854179,-1.0128018867868605,-2.8573104416722783
2025-06-17T09:30:00-04:00,326.02,327.26,317.34,318.62,294.07002849703036,NaN,NaN,NaN,NaN,NaN,334.9817,371.0223271649125,298.9410728350875,306.7014736079125,321.0733333333333,321.0733333333333,321.0733333333333,5283826,5853302.766666667,46.386417144284806,47.60421132852764,NaN,NaN,NaN,NaN,11.508083564649398,21.519948256481264,1267050277,1.1358479048440664,-1.4375005606171953,-2.5733484654612617
2025-06-17T13:30:00-04:00,318.53,320.69,314.75,316.27,294.07002849703036,NaN,NaN,NaN,NaN,NaN,334.93489999999997,371.0664050608232,298.80339493917677,306.7014736079125,319.7443480157424,321.5699086677363,317.9187873637485,2800247,5818639.8,45.25258088303868,48.304857515802915,NaN,NaN,NaN,NaN,11.110363310031584,21.56746496238509,1264250030,0.5056193311439499,-1.9413243015313242,-2.446943632675274
2025-06-18T09:30:00-04:00,317.32,329.33,315.45,321.99,294.07002849703036,NaN,NaN,NaN,NaN,NaN,334.7869,371.0683553671726,298.5054446328274,306.7014736079125,322.25666666666666,322.25666666666666,322.25666666666666,5436765,5809790.133333334,48.54916948173811,49.16702323199057,NaN,NaN,NaN,NaN,11.308194502172185,20.731441179038697,1269686795,0.4714442249259059,-1.8576383515178918,-2.3290825764437977
2025-06-18T13:30:00-04:00,321.96,325.17,320.09,322.14,294.07002849703036,NaN,NaN,NaN,NaN,NaN,334.5509,371.0044233792308,298.09737662076924,306.7014736079125,322.3251877223231,322.4236472907871,322.22672815385914,2633133,5803721,48.63651397042406,49.59465966491099,NaN,NaN,NaN,NaN,10.863323466302745,19.955133380217053,1272319928,0.4561164959744035,-1.758936956475793,-2.2150534524501966
2025-06-20T09:30:00-04:00,327.81,332.35,317.79,321.51,294.07002849703036,NaN,NaN,NaN,NaN,NaN,334.0897,370.6079579217596,297.5714420782404,306.81535327184076,323.8833333333334,323.8833333333334,323.8833333333334,6719510,5845643.166666667,48.265903629958004,49.61934321222065,NaN,NaN,NaN,NaN,11.127371790138264,18.53911646740655,1265600418,0.402588083303673,-1.7118183483206053,-2.1144064316242783
2025-06-20T13:30:00-04:00,321.51,324.64,319.63,322.02,294.07002849703036,NaN,NaN,NaN,NaN,NaN,333.5807,370.04819862603995,297.11320137396,306.81535327184076,323.3245927858035,324.15289955997633,322.4962860116306,3057564,5856520.2,48.60730932322291,49.4786764448118,NaN,NaN,NaN,NaN,10.690416662271245,17.2242436197968,1268657982,0.3997568270668155,-1.614710397790759,-2.0144672248575746
2025-06-23T09:30:00-04:00,327.7,357.53,327.4,351.12,305.9553645919293,NaN,NaN,NaN,NaN,NaN,333.69450000000006,370.34425231839964,297.0447476816005,321.42882609397805,345.3499999999999,345.3500066072494,345.34999339275043,14528710,6090322.033333333,63.43484083883755,50.250441040032435,NaN,NaN,NaN,NaN,12.463244043537584,18.273398583305344,1283186692,2.2524858673214956,0.8011401092942947,-1.4513457580272007
2025-06-23T13:30:00-04:00,351.17,354.88,346.42,348.71,314.64625711047796,NaN,NaN,NaN,NaN,NaN,333.8133,370.6181357480393,297.00846425196073,321.76906087518245,346.3571405185127,348.27344647585176,344.4408345611737,4013077,6082402.533333333,61.84347467644181,51.060265632952735,NaN,NaN,NaN,NaN,12.177298040427756,19.24761390656328,1279173615,3.1550925776434484,2.4925199640271103,-0.6625726136163383
2025-06-24T09:30:00-04:00,356.16,356.24,340.48,342.23,314.64625711047796,NaN,NaN,NaN,NaN,NaN,333.70130000000006,370.3686641708814,297.0339358291187,321.871248700146,346.31666666666666,346.31666666666666,346.31666666666666,7632748,6164698.033333333,57.65530574337046,51.61494660111599,NaN,NaN,NaN,NaN,12.433205323254343,19.5603501024664,1271540867,3.147935897317965,3.272347258031118,0.12441136071315295
2025-06-24T13:30:00-04:00,342.2,343.7,340.48,340.48,314.64625711047796,NaN,NaN,NaN,NaN,NaN,333.51410000000004,369.94478583982584,297.08341416017424,321.871248700146,345.1775410126672,347.2093943397896,343.1456876855448,2399051,6179751.533333333,56.541661186862925,52.29239818225114,NaN,NaN,NaN,NaN,11.775119228736173,19.850747998662154,1269141816,2.865615080974579,3.7064302119313766,0.8408151309567977
2025-06-25T09:30:00-04:00,342.71,342.98,320.4,327.03,314.64625711047796,NaN,NaN,NaN,NaN,NaN,333.21450000000004,369.6071488318745,296.8218511681256,321.871248700146,330.13666666666666,330.13666666666666,330.13666666666666,8685980,6277153.166666667,48.74813122123391,51.9645680336073,NaN,NaN,NaN,NaN,12.546896426683592,18.490278276561963,1260455836,1.6724284556055413,2.9313507004637245,1.2589222448581832
2025-06-25T13:30:00-04:00,326.99,328.39,322.62,327.55,314.64625711047796,NaN,NaN,NaN,NaN,NaN,332.9261,369.26514804972476,296.5870519502753,321.871248700146,329.14264934963785,330.8567957773699,327.4285029219058,2920861,6244397.3,49.04058405254707,51.89708324953496,NaN,NaN,NaN,NaN,12.062832396206192,17.226984963183217,1263376697,0.8585985628765234,2.3321704484538373,1.473571885577314
2025-06-26T09:30:00-04:00,324.67,331.1,323.62,329.01,314.64625711047796,NaN,NaN,NaN,NaN,NaN,332.49910000000006,368.5089416375317,296.48925836246843,321.871248700146,327.91,327.91,327.91,5336276,6172035.166666667,49.90490595117134,51.7583983159415,NaN,NaN,NaN,NaN,11.735487225048606,16.155073910324255,1268712973,0.38323611275923253,1.9526170265263545,1.569380913767122
2025-06-26T13:30:00-04:00,329.01,329.11,324.77,325.72,314.64625711047796,NaN,NaN,NaN,NaN,NaN,332.13770000000005,368.04959213672925,296.22580786327086,321.871248700146,327.562310339555,328.16044466049084,326.9641760186191,1803119,6140802.133333334,47.93200886598734,51.48562906922281,NaN,NaN,NaN,NaN,11.207238137545136,15.159727932669506,1266909854,-0.1590695921542098,1.3705439235743597,1.5296135157285695
2025-06-27T09:30:00-04:00,324.54,329.32,320.07,324.57,314.64625711047796,NaN,NaN,NaN,NaN,NaN,331.9091,367.86522858415344,295.9529714158466,321.871248700146,324.65333333333336,324.65333333333336,324.65333333333336,4372938,5837971.733333333,47.229166237454386,51.54582543302064,NaN,NaN,NaN,NaN,11.067435413434769,14.333848804408273,1262536916,-0.577973118751526,0.807147117289162,1.385120236040688
2025-06-27T13:30:00-04:00,324.53,325.88,317.5,323.73,314.64625711047796,NaN,NaN,NaN,NaN,NaN,331.6917000000001,367.711509417041,295.6718905829592,321.871248700146,323.65951607091614,324.7915687779219,322.5274633639104,3370180,5437751.133333334,46.69061357956229,51.648542054200895,NaN,NaN,NaN,NaN,10.875475741046571,13.790253895735564,1259166736,-0.8764701421751937,0.2895325583216959,1.1660027004968896
2025-06-30T09:30:00-04:00,319.89,325.57,317.81,319.8,314.64625711047796,NaN,NaN,NaN,NaN,NaN,331.1921,367.1648255620178,295.21937443798214,321.871248700146,321.06,321.06,321.06,3591192,5156306.466666667,44.15382554892064,51.334588916142515,NaN,NaN,NaN,NaN,10.652941759543243,13.28548719482519,1255575544,-1.279049923311311,-0.43280970364224913,0.8462402196690618
2025-06-30T13:30:00-04:00,319.82,320.11,316.6,317.63,314.64625711047796,NaN,NaN,NaN,NaN,NaN,330.7241,366.78145141077437,294.6667485892257,321.871248700146,320.0294843888325,321.43469738907623,318.62427138858874,1931361,5053803.9,42.771960530469094,50.915692241860015,NaN,NaN,NaN,NaN,10.142731633861583,12.932694979144916,1253644183,-1.6105285613852447,-1.166920482062494,0.4436080793227506
2025-07-01T09:30:00-04:00,298.46,305.88,293.21,302.08,NaN,NaN,NaN,333.4895381389043,333.4895381389043,333.4895381389043,329.9047,366.6597194890466,293.1496805109534,314.5949989601168,300.38999999999993,300.38999999999993,300.38999999999993,8346005,5108233.733333333,34.4512932264516,49.928934355895265,NaN,NaN,NaN,NaN,11.162536517157184,14.345806091210761,1245298178,-2.7302753440080725,-2.96923610068734,-0.23896075667926753
2025-07-01T13:30:00-04:00,302.08,304.42,298.33,300.66,NaN,NaN,NaN,333.4895381389043,NaN,NaN,329.13190000000003,366.68054902443316,291.5832509755669,308.40599916809344,300.59496101801784,300.92817047348717,300.2617515625485,3157814,5059837.233333333,33.80457205747574,48.87159597977047,NaN,NaN,NaN,NaN,10.800212480217386,15.657980695271903,1242140364,-3.377427912173057,-4.460745646895589,-1.0833177347225318
2025-07-02T09:30:00-04:00,312.62,316.81,303.83,315.59,NaN,NaN,NaN,333.4895381389043,NaN,NaN,328.2133,364.7821017637987,291.6444982362013,304.92676925925105,312.07666666666665,312.07666666666665,312.07666666666665,7057508,4995934.966666667,45.40822894157441,47.58398084425168,NaN,NaN,NaN,NaN,11.182340160201857,15.545360497920408,1249197872,-2.643326130581041,-4.387475397948833,-1.744149267367792
2025-07-02T13:30:00-04:00,315.54,316.38,312.69,315.65,NaN,NaN,NaN,333.4895381389043,NaN,NaN,327.27130000000005,362.63981757198684,291.90278242801327,304.92676925925105,312.6894408882188,313.85505609076057,311.5238256856771,1950482,4899778.3,45.44961373963294,46.41299077733675,NaN,NaN,NaN,NaN,10.647173005901724,15.440784600379729,1251148354,-2.024907696368743,-4.275283887828721,-2.250376191459978
2025-07-03T09:30:00-04:00,317.99,318.45,312.76,315.2,NaN,NaN,NaN,333.4895381389043,NaN,NaN,326.32310000000007,360.36846837162796,292.2777316283722,304.92676925925105,315.47,315.47,315.47,4244177,4801279.066666666,45.17302228957102,45.52139910206536,NaN,NaN,NaN,NaN,10.293089219765887,15.127853655028604,1246904177,-1.539347693654861,-4.174560808528554,-2.635213114873693
2025-07-07T09:30:00-04:00,291.37,296.16,288.77,291.36,NaN,NaN,NaN,326.7731077204654,NaN,NaN,325.0151000000001,359.30685892193065,290.7233410780695,304.92676925925105,292.0966666666667,292.0966666666667,292.0966666666667,7063188,4923661.466666667,33.53089942725718,43.87777326209352,NaN,NaN,NaN,NaN,11.445725704068325,16.41558742510076,1239840989,-2.6517013115240844,-5.949839754278798,-3.298138442754714
2025-07-07T13:30:00-04:00,291.32,295.51,291.2,294.01,NaN,NaN,NaN,326.69137555135336,NaN,NaN,323.6731000000001,357.45769453004857,289.8885054699516,302.7263323259207,292.4896200382373,293.14219094863165,291.837049127843,2561105,4812876.3,35.520202713154944,42.93292122580216,NaN,NaN,NaN,NaN,10.936031010920587,17.611340211596335,1242402094,-3.010711137114895,-7.061527364148333,-4.050816227033438
2025-07-08T09:30:00-04:00,296.95,304.04,295.64,301.55,NaN,NaN,NaN,326.69137555135336,NaN,NaN,322.5367000000001,355.3860187515321,289.6873812484681,302.7263323259207,300.41,300.41,300.41,4884295,4873335.233333333,40.936591830577676,42.35406463851864,NaN,NaN,NaN,NaN,10.871314510140548,17.83781865884755,1247286389,-2.5597893843529382,-7.250552957474611,-4.690763573121672
2025-07-08T13:30:00-04:00,301.53,303.58,294.36,297.87,NaN,NaN,NaN,326.69137555135336,NaN,NaN,321.5259000000001,354.2384717539869,288.81332824601327,300.08006586073657,299.7036092244214,300.585212729446,298.8220057193968,3135778,4709105.833333333,39.205598335728595,41.58982838027273,NaN,NaN,NaN,NaN,10.753363473701937,18.131838251488528,1244150611,-2.3350561828893657,-7.609583801733379,-5.274527618844013
2025-07-09T09:30:00-04:00,297.55,300.15,293.55,294.49,NaN,NaN,NaN,326.69137555135336,NaN,NaN,320.5001000000001,353.32261620396974,287.67758379603043,295.83733518124615,296.06333333333333,296.06333333333333,296.06333333333333,3916165,4677574.6,37.6316496306196,40.85408843488932,NaN,NaN,NaN,NaN,10.456694654151795,18.460504368212888,1240234446,-2.239407104634556,-8.073786499637208,-5.834379395002652
2025-07-09T13:30:00-04:00,294.51,297.82,293.94,295.82,NaN,NaN,NaN,326.69137555135336,NaN,NaN,319.6515000000001,352.7869938547733,286.5160061452269,295.83733518124615,296.0075775848387,296.0982875552266,295.91686761445084,1479552,4546439.2,38.67492794359945,40.24307141389968,NaN,NaN,NaN,NaN,9.986930750283808,18.76569433374265,1241713998,-1.9239942784084665,-8.239372243013236,-6.315377964604769
2025-07-10T09:30:00-04:00,300.05,307.92,299.99,301.86,NaN,NaN,NaN,326.69137555135336,NaN,NaN,318.8345000000001,351.6686048454155,286.00039515458474,295.83733518124615,303.2566666666667,303.2566666666667,303.2566666666667,5070425,4646101.066666666,43.312525045678484,40.00177937576512,NaN,NaN,NaN,NaN,10.13786426812068,17.943211096808934,1246784423,-1.1824058853053732,-7.793385321236485,-6.610979435931112
2025-07-10T13:30:00-04:00,301.86,310.46,301.82,309.94,NaN,NaN,NaN,326.69137555135336,NaN,NaN,317.94330000000014,349.2397571547578,286.6468428452425,295.83733518124615,304.890494014808,306.9180520759381,302.8629359536779,3292381,4579719.566666666,48.88169532114978,40.33948435949577,NaN,NaN,NaN,NaN,10.030873963254916,16.926399848652444,1250076804,-0.07969121588291905,-6.71059345578476,-6.630902239901841
2025-07-11T09:30:00-04:00,307.58,311.91,305.65,310.83,NaN,NaN,NaN,326.69137555135336,NaN,NaN,317.27300000000014,347.70250811300826,286.843491886992,295.83733518124615,309.4633333333333,309.4633333333333,309.4633333333333,4301972,4629777.066666666,49.47055422739425,40.81795533784757,NaN,NaN,NaN,NaN,9.761525823022424,15.834766202474656,1254378776,0.7328969117890649,-5.71478110016551,-6.447678011954575
2025-07-11T13:30:00-04:00,310.83,314.09,309.87,313.47,NaN,NaN,NaN,326.69137555135336,NaN,NaN,316.88500000000016,347.0022458900132,286.7677541099871,294.91417375488106,310.52309011724475,311.9619493880378,309.0842308464517,2333691,4526341.266666667,51.26398024987631,42.01886155380647,NaN,NaN,NaN,NaN,9.365702549949392,14.81299772236845,1256712467,1.4310526227553586,-4.658862233510376,-6.089914856265735
2025-07-14T09:30:00-04:00,317.65,322.59,312.67,315.34,NaN,NaN,NaN,326.69137555135336,NaN,NaN,316.54880000000014,346.3505738102872,286.7470261897131,302.28933900390484,316.8666666666667,316.8666666666667,316.8666666666667,3921140,4569274.833333333,52.548702908412395,43.35772804315909,NaN,NaN,NaN,NaN,9.405295224953004,14.679451372862026,1260633607,1.96848457629934,-3.6293091358915603,-5.5977937121909
2025-07-14T13:30:00-04:00,315.37,317.26,312.87,316.89,NaN,NaN,NaN,326.69137555135336,NaN,NaN,316.8392000000002,346.364352623476,287.31404737652434,302.28933900390484,316.5016048322402,317.0514869221188,315.95172274236165,1728248,4402899.433333334,53.639593844269456,43.94568267906588,NaN,NaN,NaN,NaN,9.047059851742075,14.555444048320346,1262361855,2.352096694404117,-2.657672844185754,-5.009769538589871
2025-07-15T09:30:00-04:00,319.68,321.2,312.7,314.05,NaN,NaN,NaN,326.69137555135336,NaN,NaN,317.42880000000014,345.4941236973963,289.363476302604,302.28933900390484,315.98333333333335,315.9833371480306,315.9833295186361,3757030,4426214.966666667,51.31191636489458,44.364418580870286,NaN,NaN,NaN,NaN,9.007984148046212,14.805030148925466,1258604825,2.333667490214662,-2.0926851758215435,-4.426352666036205
2025-07-15T13:30:00-04:00,314.04,315.24,310.5,310.77,NaN,NaN,NaN,326.69137555135336,NaN,NaN,317.64280000000014,345.33612310575285,289.9494768942474,302.28933900390484,314.8432166172923,316.58900553665654,313.097427697928,1602359,3995336.6,48.684274265407424,44.61522229343003,NaN,NaN,NaN,NaN,8.703128137471483,14.749513390167458,1257002466,2.0308139910399716,-1.8878351772362407,-3.9186491682762123
2025-07-16T09:30:00-04:00,312.8,321.69,312.63,320.21,NaN,NaN,NaN,326.69137555135336,NaN,NaN,318.14320000000015,345.0897308906281,291.1966691093722,302.28933900390484,318.1766666666667,318.17667048136394,318.1766628519694,6310709,4071924.3333333335,55.71342567894468,46.19968845426485,NaN,NaN,NaN,NaN,8.861476127652093,15.294369366212926,1263313175,2.3726969827349036,-0.9527779398575831,-3.3254749225924867
2025-07-16T13:30:00-04:00,320.22,323.46,318.67,321.71,NaN,NaN,NaN,326.69137555135336,NaN,NaN,318.63620000000014,344.91548823692904,292.35691176307125,305.45300740479956,319.0294043075379,320.4147445766976,317.6440640383782,2391091,3897202.433333333,56.72772491998556,47.71451146903847,NaN,NaN,NaN,NaN,8.57065640424837,15.955003803004871,1265704266,2.5886461378427574,-0.08966725028903966,-2.678313388131797
2025-07-17T09:30:00-04:00,323.12,324.34,317.7,319.47,NaN,NaN,NaN,326.69137555135336,NaN,NaN,318.8514000000001,344.9778044246373,292.7249955753629,306.6144059238396,320.50333333333333,320.50333333333333,320.50333333333333,4444431,3965381.7666666666,54.71250675763697,48.698505392399845,NaN,NaN,NaN,NaN,8.432752375373486,16.424336866924975,1261259835,2.4697638815163705,0.40889146376366625,-2.0608724177527042
2025-07-17T13:30:00-04:00,319.45,319.81,317.07,319.36,NaN,NaN,NaN,326.69137555135336,NaN,NaN,318.83900000000017,344.96383852580834,292.714161474192,306.6144059238396,319.9935338875048,320.79081189310745,319.1962558819021,1817169,3736421.4,54.609911443713045,49.798813471541585,NaN,NaN,NaN,NaN,8.026127205703952,16.76209089158956,1259442666,2.2775503200494307,0.786065482309084,-1.4914848377403467
2025-07-18T09:30:00-04:00,321.66,330.71,321.42,327.56,299.0619694499299,299.0619694499299,299.0619694499299,NaN,NaN,NaN,318.8682000000001,345.02867543604106,292.7077245639592,312.5946197912574,326.56333333333333,326.56333333333333,326.56333333333333,6481743,3855117.466666667,60.54882144225359,51.43575431522972,NaN,NaN,NaN,NaN,8.263546691010811,18.048379331840927,1265924409,2.5745840581381247,1.7267452349323094,-0.8478388232058154
2025-07-18T13:30:00-04:00,327.55,330.9,326.24,329.59,302.158925384024,NaN,NaN,NaN,NaN,NaN,318.84140000000014,344.9550975581707,292.7277024418296,314.0776958330059,327.29693480086075,328.3847523394635,326.209117262258,2947814,3775502.066666667,61.87860620875605,53.09315990559806,NaN,NaN,NaN,NaN,8.006150498795751,19.25784665557606,1268872223,2.7630745423091607,2.6060043546806355,-0.1570701876285252
2025-07-21T09:30:00-04:00,334.37,338,326.89,329.73,305.71942877565925,NaN,NaN,NaN,NaN,NaN,318.90820000000014,345.115713637116,292.70068636288426,318.98715666640476,331.54,331.54,331.54,4363843,3860859.533333333,61.97380270189685,54.42610830961366,NaN,NaN,NaN,NaN,8.227854034596055,20.91538339368614,1273236066,2.7467382447010706,3.276352618247813,0.5296143735467425
2025-07-21T13:30:00-04:00,329.75,330.82,327.81,328.5,305.71942877565925,NaN,NaN,NaN,NaN,NaN,318.9762000000001,345.26514091133504,292.6872590886652,318.98715666640476,331.01009681644854,332.03097596257277,329.9892176703243,1175746,3754286.466666667,60.54332784995847,55.25908206167143,NaN,NaN,NaN,NaN,7.85515017498205,22.454524650502645,1272060320,2.5091862926451483,3.666097239353178,1.1569109467080296
2025-07-22T09:30:00-04:00,329.84,332.34,321.55,331.895,305.71942877565925,NaN,NaN,NaN,NaN,NaN,319.2303000000001,345.7670315553305,292.6935684446697,318.98715666640476,328.59499999999997,328.59499999999997,328.59499999999997,3976368,3774492.7333333334,63.07666151348455,56.23094686782074,NaN,NaN,NaN,NaN,8.064782305340472,22.81233875265402,1276036688,2.4348712719430248,4.200500036636811,1.765628764693786
2025-07-22T13:30:00-04:00,331.88,335.42,329.84,332.11,306.8462992948329,NaN,NaN,NaN,NaN,NaN,319.2285000000001,345.7617243234724,292.69527567652784,318.98715666640476,330.04520443594663,331.91526144687407,328.1751474250192,2391307,3734496.566666667,63.237636622955016,57.08620803732636,NaN,NaN,NaN,NaN,7.887297854959013,23.418362666999542,1278427995,2.2582759784807656,4.588473737794743,2.3301977593139775
2025-07-23T09:30:00-04:00,330.9,336.2,328.68,330.86,306.8462992948329,NaN,NaN,NaN,NaN,NaN,319.3383000000001,346.01731179653615,292.6592882034641,318.98715666640476,331.91333333333336,331.91333333333336,331.91333333333336,3827143,3797689.3,61.55731026783992,57.72967999157118,NaN,NaN,NaN,NaN,7.8610622938905115,23.784326356383957,1274600852,1.9281908633937386,4.740436338556151,2.8122454751624124
2025-07-23T13:30:00-04:00,330.87,335.7,329.42,332.91,307.2317933657465,NaN,NaN,NaN,NaN,NaN,319.4111000000001,346.2176786918017,292.60452130819846,318.98715666640476,332.20261780773325,332.5729352053958,331.8323004100707,2335483,3597338.566666667,63.280538660002115,58.41831890698065,NaN,NaN,NaN,NaN,7.74812927289833,24.124149782240913,1276936335,1.7254084624646913,4.969006053243277,3.2435975907785854
2025-07-24T09:30:00-04:00,310.09,310.15,300.41,304.29,NaN,NaN,NaN,333.8887426963329,333.8887426963329,333.8887426963329,318.9151000000001,345.90409631256546,291.92610368743476,318.98715666640476,304.95,304.95,304.95,10431506,3839794.966666667,37.803058743291245,57.453400505437564,NaN,NaN,NaN,NaN,9.516120039119878,23.835890767958098,1266504829,-0.3481731791428224,2.8083811168500574,3.15655429599288
2025-07-24T13:30:00-04:00,304.3,307.47,302.19,305.12,NaN,NaN,NaN,332.85834530104506,NaN,NaN,318.6451000000002,345.9092108044894,291.38098919551095,318.98715666640476,304.944331854665,304.9543382956886,304.9343254136414,3347108,3716114.966666667,38.5754220408804,56.73133963225706,NaN,NaN,NaN,NaN,9.213540036325602,23.568221683266913,1269851937,-1.605411208785577,1.1497902850109085,2.7552014937964855
2025-07-25T09:30:00-04:00,308.74,323.62,308.02,317.84,NaN,NaN,NaN,332.85834530104506,NaN,NaN,318.67650000000015,345.933212219189,291.4197877808113,318.98715666640476,316.49333333333334,316.49333333333334,316.49333333333334,9239252,3959073.966666667,49.0230989493561,56.25345915157216,NaN,NaN,NaN,NaN,9.876858605159487,22.13379173248578,1279091189,-1.5226233029732907,0.8519223650798722,2.374545668053163
2025-07-25T13:30:00-04:00,317.8,318.57,312.7,316.065,NaN,NaN,NaN,332.85834530104506,NaN,NaN,318.55800000000016,345.8075769508372,291.30842304916314,318.98715666640476,316.25952404497286,316.5949444645285,315.9241036254172,4489328,3967245.6666666665,47.80126312441134,55.61585473760257,NaN,NaN,NaN,NaN,9.590654419076667,20.801821063903294,1274601861,-1.5258396507919916,0.4672461045631735,1.993085755355165
2025-07-28T09:30:00-04:00,318.07,330.48,315.71,328.16,NaN,NaN,NaN,332.85834530104506,NaN,NaN,318.6784000000001,346.04317432320175,291.3136256767985,318.19697937055935,324.78333333333336,324.78333333333336,324.78333333333336,7507887,3982068.966666667,55.87208401992267,55.69868168490869,NaN,NaN,NaN,NaN,9.960607674856908,20.5560718613206,1282109748,-0.6941644979791115,1.1253801328812756,1.819544630860387
2025-07-28T13:30:00-04:00,328.13,329.46,325.34,325.54,NaN,NaN,NaN,332.85834530104506,NaN,NaN,318.75900000000007,346.180341615608,291.33765838439217,318.19697937055935,325.2746979449284,326.1347282697564,324.4146676201004,2450744,3978390.2666666666,53.92697530468483,55.64990053212096,NaN,NaN,NaN,NaN,9.543421412367127,20.327876173208097,1279659004,-0.32028809466601915,1.4191845125278633,1.7394726071938824
2025-07-29T09:30:00-04:00,325.58,326.25,318.25,320.43,NaN,NaN,NaN,332.85834530104506,NaN,NaN,318.7272000000001,346.1370263518729,291.3173736481273,318.19697937055935,321.6433333333334,321.6433333333334,321.6433333333334,5113000,3986013.7666666666,50.2523766840153,54.91444019224679,NaN,NaN,NaN,NaN,9.433177025769476,19.35905993614164,1274546004,-0.41112627891753317,1.225564758546966,1.6366910374644992
2025-07-29T13:30:00-04:00,320.45,324.07,320.1,321.34,NaN,NaN,NaN,332.85834530104506,NaN,NaN,318.13160000000005,343.94791812942947,292.31528187057063,318.19697937055935,321.6981038356366,321.78521959684974,321.6109880744234,2021044,3948855.966666667,50.89409252842374,54.12983207222306,NaN,NaN,NaN,NaN,9.042950095357368,18.45944485886564,1276567048,-0.4033572997811783,1.1324944127380263,1.5358517125192046
2025-07-30T09:30:00-04:00,322.18,324.46,316.92,317.85,NaN,NaN,NaN,332.85834530104506,NaN,NaN,317.5144000000001,341.80764594532053,293.22115405467963,318.1575834964475,319.74333333333334,319.74333333333334,319.74333333333334,3948679,3949939.7666666666,48.31976412281859,53.1545436022889,NaN,NaN,NaN,NaN,8.935596517117553,17.281975821993896,1272618369,-0.6140689116161759,0.7682655729989847,1.3823344846151606
2025-07-30T13:30:00-04:00,317.88,319.25,311.64,319.12,NaN,NaN,NaN,332.85834530104506,NaN,NaN,317.0522000000001,340.3039665703025,293.80043342969765,303.8728167680927,318.42466115671334,319.9457866764333,316.9035356369934,2967532,3999539.1,49.32428606352329,52.35318347468638,NaN,NaN,NaN,NaN,8.840911051609156,16.447384916899594,1275585901,-0.6455024072877591,0.5754564755054616,1.2209588827932207
2025-07-31T09:30:00-04:00,319.54,321.36,309.59,309.87,NaN,NaN,NaN,332.85834530104506,NaN,NaN,316.4400000000001,338.78643747893136,294.09356252106886,303.8728167680927,313.6066666666667,313.6066666666667,313.6066666666667,4601664,3983913.7333333334,42.79910819257068,50.90478680890682,NaN,NaN,NaN,NaN,9.050131690779933,15.43882087086184,1270984237,-1.232810649961841,-0.3200544296590806,0.9127562203027604
2025-07-31T13:30:00-04:00,309.85,311.65,306.1,308.27,NaN,NaN,NaN,332.85834530104506,NaN,NaN,316.0648000000001,338.3171758695512,293.812424130449,303.8728167680927,311.70945936064777,314.1094927939635,309.30942592733203,2875477,3970016.933333333,41.769773523204776,49.371368016067514,NaN,NaN,NaN,NaN,8.800122284295648,14.867029355724801,1268108760,-1.6467277933634759,-1.1456535214015844,0.5010742719618915
2025-08-01T09:30:00-04:00,306.12,309.31,297.83,303.27,NaN,NaN,NaN,331.0374348629687,NaN,NaN,315.57920000000007,337.8675101521815,293.2908898478186,303.8728167680927,303.46999999999997,303.46999999999997,303.46999999999997,5706064,4016820,38.64212736673847,47.73456923741742,NaN,NaN,NaN,NaN,8.991542121131674,15.114352282862658,1262402696,-2.1434953655023445,-2.178294934916039,-0.03479956941369455
2025-08-01T13:30:00-04:00,303.2,304.87,301.08,302.63,NaN,NaN,NaN,329.71073327828833,NaN,NaN,315.0516000000001,337.29208007035385,292.8111199296464,303.8728167680927,303.29863318097676,303.5727995043901,303.0244668575634,2229266,4013339.1666666665,38.247350674478824,45.946484381308615,NaN,NaN,NaN,NaN,8.620003398193699,15.344009286633526,1260173430,-2.383020130525652,-3.01357473257076,-0.6305546020451076
2025-08-04T09:30:00-04:00,309,312.13,303.18,308.47,NaN,NaN,NaN,329.71073327828833,NaN,NaN,314.7066000000001,336.8091579913239,292.6040420086763,303.8728167680927,307.9266666666667,307.9266666666667,307.9266666666667,4654826,4037795.3666666667,43.88133181044496,46.380646743248164,NaN,NaN,NaN,NaN,8.682860298322721,14.652746912089428,1264828256,-2.0297839572405234,-3.167784548595762,-1.1380005913552385
2025-08-04T13:30:00-04:00,308.46,310.84,307.49,309.295,NaN,NaN,NaN,329.71073327828833,NaN,NaN,314.4011000000001,336.3717542724565,292.4304457275437,303.4413621852635,308.23543418093027,308.78352144852596,307.6873469133346,1477295,4029430.2666666666,44.64958864347161,46.814515786290386,NaN,NaN,NaN,NaN,8.301941705585381,14.010860421441343,1266305551,-1.6389532312340278,-3.1866921303977733,-1.5477388991637455
2025-08-05T09:30:00-04:00,308.99,312.45,305.5,308.09,NaN,NaN,NaN,329.71073327828833,NaN,NaN,314.0883000000001,335.9639120472049,292.21268795279536,303.4413621852635,308.68,308.68,308.68,3086820,4007089.933333333,43.70838920536776,46.43489366171979,NaN,NaN,NaN,NaN,8.20537444090071,13.636513024683014,1263218731,-1.3708613119933841,-3.2613155391554756,-1.8904542271620914
2025-08-05T13:30:00-04:00,308.07,310.91,308.03,308.68,NaN,NaN,NaN,329.71073327828833,NaN,NaN,313.86590000000007,335.73081826556705,292.0009817344331,303.4413621852635,308.8370846354815,309.0780320543308,308.59613721663226,1312001,3997411.3333333335,44.32719863089426,46.18674619789714,NaN,NaN,NaN,NaN,7.824990552264949,13.288904727693138,1264530732,-1.0760763436157421,-3.235549656681769,-2.159473313066027
2025-08-06T09:30:00-04:00,307.85,319.55,306.95,318.53,NaN,NaN,NaN,329.71073327828833,NaN,NaN,313.88390000000004,335.76266105175887,292.0051389482412,300.60828349284094,315.01,315.01,315.01,4586862,3939949.7666666666,53.514706489339886,46.0183620885698,NaN,NaN,NaN,NaN,8.166062655674597,12.81745922767297,1269117594,-0.18660964171426953,-2.392735365208864,-2.2061257234945946
2025-08-06T13:30:00-04:00,318.55,320.47,317.89,319.97,NaN,NaN,NaN,329.71073327828833,NaN,NaN,314.2417000000001,335.9208325112378,292.5625674887624,304.0266267942727,316.4326625318425,318.50224426374433,314.36308079994063,2167476,3932495.933333333,54.691883051144295,46.07299835617406,NaN,NaN,NaN,NaN,7.767058180269272,12.486571031794309,1271285070,0.49268350398673455,-1.5902713435111764,-2.082954847497911
2025-08-07T09:30:00-04:00,319.79,322.39,317.62,318.42,NaN,NaN,NaN,329.71073327828833,NaN,NaN,314.5969000000001,335.95386063487865,293.2399393651216,306.85030143541815,319.4766666666667,319.4766666666667,319.4766666666667,4040282,3919024.3,53.13219523956964,46.27869968157079,NaN,NaN,NaN,NaN,7.552982595964322,12.407460796625159,1267244788,0.8126965270432904,-1.0670841886937978,-1.8797807157370883
2025-08-07T13:30:00-04:00,318.41,322.36,316.16,322.31,NaN,NaN,NaN,329.71073327828833,NaN,NaN,314.7313000000001,336.1958747043775,293.2667252956227,306.85030143541815,319.75422082744234,320.135018695684,319.3734229592007,2146437,3929999.9,56.48606179666942,46.67812605787405,NaN,NaN,NaN,NaN,7.45634098196687,12.113640459403001,1269391225,1.2360599095652707,-0.3347058287804998,-1.5707657383457705
2025-08-08T09:30:00-04:00,321.46,335,320.98,328.68,303.1053553978846,303.1053553978846,303.1053553978846,NaN,NaN,NaN,314.9919000000001,336.80827219062417,293.17552780937604,315.56459291866764,328.22,328.22,328.22,7080979,3949974.433333333,61.36202120075448,47.60971584915518,NaN,NaN,NaN,NaN,7.925173768969235,13.18524691553136,1276472204,1.8574584627890207,0.7510573401405054,-1.1064011226485153
2025-08-08T13:30:00-04:00,328.7,330.88,327.23,329.7,304.80374833434433,NaN,NaN,NaN,NaN,NaN,315.2819000000001,337.4837127088703,293.0800872911299,315.56459291866764,328.47216581389404,328.92070400278385,328.0236276250042,2238035,3926315.1333333333,62.09447399627659,48.52187213006613,NaN,NaN,NaN,NaN,7.619804214042859,14.180310053364838,1278710239,2.2247488604710455,1.6745349529402915,-0.5502139075307539
2025-08-11T09:30:00-04:00,334.995,346.64,334.2,342.39,314.96107795551046,NaN,NaN,NaN,NaN,NaN,316.3025000000001,338.70252975444015,293.9024702455601,324.2713394679473,341.07666666666665,341.07666666666665,341.07666666666665,6681247,4003561.933333333,69.77199284160083,50.448506747854005,NaN,NaN,NaN,NaN,8.28553248446837,16.295768451829158,1285391486,3.153196703666123,3.3912819720518996,0.23808526838577682
2025-08-11T13:30:00-04:00,342.39,344.08,338.8,339.23,316.4183016848055,NaN,NaN,NaN,NaN,NaN,317.2069000000001,339.58516515974554,294.8286348402546,324.2713394679473,340.9762527735546,341.141797038049,340.81070850906025,2458198,4046310.3333333335,66.17749025709296,52.19191508598887,NaN,NaN,NaN,NaN,8.070851592720627,18.260122678974593,1282933288,3.3659996475311207,4.445584827799678,1.0795851802685572
2025-08-12T09:30:00-04:00,345.12,345.24,332.96,338.79,316.4183016848055,NaN,NaN,NaN,NaN,NaN,317.95170000000013,340.67224529362625,295.231154706374,324.2713394679473,338.99666666666667,338.99666666666667,338.99666666666667,4843718,4075222,65.67017708659867,54.12249006597888,NaN,NaN,NaN,NaN,8.371505050383442,19.16438680327723,1278089570,3.2850070023997047,5.185843933268188,1.9008369308684836
2025-08-12T13:30:00-04:00,338.79,342.5,337.02,340.765,316.4183016848055,NaN,NaN,NaN,NaN,NaN,318.80960000000016,341.6712046540855,295.9479953459148,324.2713394679473,339.29122927929996,339.7778100058698,338.8046485527301,1775106,4054681.966666667,66.89686497374055,56.16888394449758,NaN,NaN,NaN,NaN,8.164968975356055,20.004060632986825,1279864676,3.1707472048160943,5.864270936888602,2.6935237320725074
2025-08-13T09:30:00-04:00,341.59,348.98,338.55,341.5,318.34125581357847,NaN,NaN,NaN,NaN,NaN,319.7498000000001,342.39908183938286,297.10051816061736,327.12951664607124,343.01,343.01,343.01,4152901,4065540.566666667,67.36423539999994,57.846234200894365,NaN,NaN,NaN,NaN,8.326756905687766,21.29361914384087,1284017577,2.9552652105721213,6.387605245287659,3.432340034715538
2025-08-13T13:30:00-04:00,341.48,341.81,338.2,339.34,318.34125581357847,NaN,NaN,NaN,NaN,NaN,320.6202000000001,342.86544290359143,298.3749570964088,327.12951664607124,342.12986269679067,343.56696673820517,340.69275865537617,1557672,4039613.533333333,64.48293846048236,59.26290204496656,NaN,NaN,NaN,NaN,7.989845698138642,22.432150081093383,1282459905,2.496147242710867,6.552524088104121,4.056376845393254
2025-08-14T09:30:00-04:00,335.69,340.45,330.4,333.96,318.34125581357847,NaN,NaN,NaN,NaN,NaN,321.2622000000001,343.15472357860614,299.3696764213941,327.12951664607124,334.93666666666667,334.93666666666667,334.93666666666667,4682823,3847990.7666666666,57.846310047669824,60.27275353370243,NaN,NaN,NaN,NaN,8.136999576843026,22.260079138839643,1277777082,1.6972085871535727,6.17788757933522,4.480678992181647
2025-08-14T13:30:00-04:00,333.99,336.03,332.77,335.58,318.34125581357847,NaN,NaN,NaN,NaN,NaN,321.7750000000001,343.7835280743616,299.7664719256386,327.12951664607124,334.8971066116202,334.96117904409147,334.8330341791489,1785168,3795926.1,59.20774779727685,61.33564990272975,NaN,NaN,NaN,NaN,7.788642464211381,22.100298978175456,1279562250,1.170013957520454,5.9431964390822145,4.7731824815617605
2025-08-15T09:30:00-04:00,337.65,339.31,327.02,330.88,318.34125581357847,NaN,NaN,NaN,NaN,NaN,322.17600000000016,344.10271302315164,300.2492869768487,327.12951664607124,332.4033333333333,332.4033333333333,332.4033333333333,4635862,3642479.7666666666,53.78078487616167,61.35465550178845,NaN,NaN,NaN,NaN,8.110168002481997,21.121762652982188,1274926388,0.43478529860696025,5.316664104820461,4.881878806213501
2025-08-15T13:30:00-04:00,330.87,331.69,327.99,330.63,318.34125581357847,NaN,NaN,NaN,NaN,NaN,322.5192000000001,344.42727279154826,300.611127208452,327.12951664607124,331.7468541436933,332.78557316716433,330.7081351202223,1851724,3554559.6333333333,53.49988085126036,61.26951248751103,NaN,NaN,NaN,NaN,7.79515600230471,20.213121779588437,1273074664,-0.10929551801761583,4.745259408691481,4.854554926709097
2025-08-18T09:30:00-04:00,329.66,335.34,329.59,334.75,318.34125581357847,NaN,NaN,NaN,NaN,NaN,322.9074000000001,344.980120289077,300.83467971092324,327.12951664607124,333.22666666666663,333.22666666666663,333.22666666666663,3004660,3404452.066666667,57.444693977647304,61.57754811165943,NaN,NaN,NaN,NaN,7.649073430711517,19.80477624057879,1276079324,-0.22591465730923677,4.5721616050725515,4.798076262381788
2025-08-18T13:30:00-04:00,334.79,336.26,333.66,335.155,318.34125581357847,NaN,NaN,NaN,NaN,NaN,323.27270000000016,345.5387003781467,301.0066996218536,327.12951664607124,333.7316486141593,334.53980645862254,332.9234907696961,1173153,3361865.7,57.82347278898617,61.67307746825349,NaN,NaN,NaN,NaN,7.288425328517834,19.533960733698233,1277252477,-0.3050634464525306,4.416746954316125,4.721810400768655
2025-08-19T09:30:00-04:00,335.85,340.55,327.85,329.72,318.34125581357847,NaN,NaN,NaN,NaN,NaN,323.58610000000016,345.76497853701443,301.4072214629859,327.12951664607124,332.7066666666667,332.7066666666667,332.7066666666667,4885995,3354298.8666666667,51.23307551774566,60.94958134803857,NaN,NaN,NaN,NaN,7.674966376480845,18.39021628161471,1272366482,-0.7285772911227308,3.811088786865241,4.539666077987972
2025-08-19T13:30:00-04:00,329.62,330.87,327.99,329.32,318.34125581357847,NaN,NaN,NaN,NaN,NaN,323.95710000000014,345.8852121932462,302.02898780675406,327.12951664607124,332.01307384051563,333.36104758734785,330.6651000936834,1293598,3330050.6666666665,50.77440859309977,60.14100524781166,NaN,NaN,NaN,NaN,7.332468778160785,17.32816786182287,1271072884,-1.022748673232023,3.2612302364479433,4.283978909679966
2025-08-20T09:30:00-04:00,329.23,331.37,314.6,321.06,NaN,NaN,NaN,347.4073418887685,347.4073418887685,347.4073418887685,323.9741000000002,345.89188142877515,302.05631857122523,322.52461331685697,322.3433333333333,322.3433333333333,322.3433333333333,5056532,3366979.1,42.34408106336992,58.181868692223745,NaN,NaN,NaN,NaN,8.0065781511493,17.491419014539513,1266016352,-1.7197055421423726,2.1343469820020005,3.854052524144373
2025-08-20T13:30:00-04:00,321.06,324.77,319.58,323.94,NaN,NaN,NaN,346.1949627120062,NaN,NaN,324.0187000000002,345.92694473205285,302.11045526794754,321.9599772746673,322.44827143043216,322.6301010115459,322.2664418493184,1684186,3324200.9,45.72765217030025,56.72116597173855,NaN,NaN,NaN,NaN,7.805393997495779,17.643009370633543,1267700538,-1.9177365884732307,1.4568817885528347,3.3746183770260654
2025-08-21T09:30:00-04:00,322.11,324.9,318.68,319.41,NaN,NaN,NaN,345.56632804327865,NaN,NaN,324.01750000000015,345.92674775065564,302.1082522493447,321.9599772746673,320.99666666666667,320.99666666666667,320.99666666666667,2837052,3265380.5,41.5929733904084,55.00136570772496,NaN,NaN,NaN,NaN,7.692151569103221,17.882088621198715,1264863486,-2.261187459616745,0.5481340525051337,2.809321512121879
2025-08-21T13:30:00-04:00,319.3,322.59,319.17,320.13,NaN,NaN,NaN,344.0419494958569,NaN,NaN,324.0329000000002,345.9301102414784,302.135689758522,321.9599772746673,320.887404688726,321.0551084317069,320.7197009457451,1204259,3209673.2333333334,42.48315154217843,53.25752903404195,NaN,NaN,NaN,NaN,7.386997885595846,18.104090782437808,1266067745,-2.3375839588572114,-0.11265843644963525,2.224925522407576
2025-08-22T09:30:00-04:00,321.67,338.32,319.69,338.02,NaN,NaN,NaN,344.0419494958569,NaN,NaN,324.2421000000002,346.46750529123096,302.0166947087695,321.9599772746673,332.01,332.01,332.01,6333983,3230603.8666666667,59.144901768954284,52.67043377468155,NaN,NaN,NaN,NaN,8.190069465196142,17.538326795450516,1272401728,-1.1415140063262488,0.7980330144997652,1.939547020826014
2025-08-22T13:30:00-04:00,338.02,340.22,337.13,339.97,NaN,NaN,NaN,344.0419494958569,NaN,NaN,324.4497000000002,347.06159053660906,301.8378094633913,321.9599772746673,334.07856690513603,337.30361896090693,330.8535148493651,2605809,3243155.3,60.488465850738166,52.385114302556964,NaN,NaN,NaN,NaN,7.825778789110706,17.221019401227675,1275007537,-0.22523851684886864,1.6579988747649281,1.8832373916137968
2025-08-25T09:30:00-04:00,338.92,348.7,335.02,348.35,317.1326893049276,317.1326893049276,317.1326893049276,NaN,NaN,NaN,324.8221000000002,348.36377131618957,301.28042868381084,326.0437388049219,344.02333333333337,344.02333333333337,344.02333333333337,4559244,3239969.2333333334,65.70765880237421,52.94663921360728,NaN,NaN,NaN,NaN,8.24393744703137,17.76344138182661,1279566781,0.8784954909627856,2.981356755317279,2.1028612643544933
2025-08-25T13:30:00-04:00,348.35,349.54,346.08,346.68,323.73483979106726,NaN,NaN,NaN,NaN,NaN,325.18570000000017,349.4925043156564,300.87889568434395,329.6849910439375,345.0395400285545,346.59921588696113,343.47986417014783,1935478,3255242,63.89626828075355,53.28153353385561,NaN,NaN,NaN,NaN,7.902227629386275,18.343277043811913,1277631303,1.3984955155750365,3.850980658823289,2.4524851432482526
2025-08-26T09:30:00-04:00,344.93,349.13,343.72,347.11,323.73483979106726,NaN,NaN,NaN,NaN,NaN,325.4900000000002,350.4960624649226,300.48393753507776,330.54099283515,346.65333333333336,346.65333333333336,346.65333333333336,3888050,3281949.6666666665,64.17015920642024,54.02363170030265,NaN,NaN,NaN,NaN,7.724211370144396,18.511768100235706,1281519353,1.6561927676255217,4.522726102780155,2.866533335154633
2025-08-26T13:30:00-04:00,347.12,351.9,345.08,351.7,324.9195544377286,NaN,NaN,NaN,NaN,NaN,325.88180000000017,351.8844980723081,299.87910192769226,333.61879426812,347.7385572608225,349.14449938021687,346.33261514142816,2316518,3315433.566666667,67.04415979154895,54.99108019603755,NaN,NaN,NaN,NaN,7.65962484370551,18.94822066236878,1283835871,1.9976814908571403,5.363635198726058,3.365953707868918
2025-08-27T09:30:00-04:00,351.94,355.4,349.15,351.01,328.92366559965,NaN,NaN,NaN,NaN,NaN,326.2848000000002,353.1924603932713,299.3771396067291,337.65003541449596,351.8533333333333,351.8533333333333,351.8533333333333,3931664,3293593.6333333333,66.18470956622694,55.61536702379324,NaN,NaN,NaN,NaN,7.558937354869402,19.692838645469575,1279904207,2.032277296595072,5.906300328612758,3.874023032017686
2025-08-27T13:30:00-04:00,350.97,352.01,349.33,349.94,328.92366559965,NaN,NaN,NaN,NaN,NaN,326.6254000000002,354.28063768401955,298.9701623159808,337.65003541449596,351.4774256049279,352.1059066353425,350.84894457451327,1406548,3268229.3666666667,64.79751462619694,56.113512869308295,NaN,NaN,NaN,NaN,7.210441829521588,20.384269629777453,1278497659,1.84382231455103,6.178800925206474,4.334978610655444
2025-08-28T09:30:00-04:00,351,353.55,340.26,343.43,328.92366559965,NaN,NaN,NaN,NaN,NaN,327.4082000000002,354.7036763109122,300.11272368908817,337.65003541449596,345.74666666666667,345.74666666666667,345.74666666666667,4098009,3270153.6,56.9734212888092,56.523537567241405,NaN,NaN,NaN,NaN,7.644695984555761,19.554650971923866,1274399650,1.174072006313028,5.802568618546729,4.628496612233701
2025-08-28T13:30:00-04:00,343.46,346.86,343.46,345.8,328.92366559965,NaN,NaN,NaN,NaN,NaN,328.2218000000002,355.2350338500897,301.2085661499107,337.65003541449596,345.6467348346151,345.81202703916097,345.4814426300692,1497876,3248534.9,58.91822987528827,57.10523908739772,NaN,NaN,NaN,NaN,7.343646271373207,18.784290789631246,1275897526,0.8017894368325207,5.630733408274352,4.828943971441832
2025-08-29T09:30:00-04:00,347.21,348.72,332.67,333.74,328.92366559965,NaN,NaN,NaN,NaN,NaN,328.53980000000024,355.4307614524933,301.6488385475072,337.65003541449596,338.3766666666667,338.3766666666667,338.3766666666667,5194467,3185651.1666666665,47.22152132201916,57.45362767730124,NaN,NaN,NaN,NaN,7.965528680560836,18.215724733393927,1270703059,-0.28724677864341963,4.4698854981375575,4.757132276780977
2025-08-29T13:30:00-04:00,333.73,334.48,331.71,333.86,328.92366559965,NaN,NaN,NaN,NaN,NaN,328.8957000000002,355.5871192211569,302.2042807788435,337.65003541449596,336.87853194629133,339.17770923843347,334.5793546541492,2205453,3184565.1,47.33355963632296,57.56833535344572,NaN,NaN,NaN,NaN,7.594419489092208,17.795848090233818,1272908512,-0.9904873768296154,3.5190230557439577,4.509510432573573
2025-09-02T09:30:00-04:00,328.24,333.32,325.59,329.81,NaN,NaN,NaN,352.8025464550744,352.8025464550744,352.8025464550744,328.9287000000002,355.6204792445445,302.2369207554559,337.65003541449596,329.5733333333333,329.5733333333333,329.5733333333333,2978916,3061154.066666667,43.94309803104657,57.73620139920559,NaN,NaN,NaN,NaN,7.6426752398713385,18.05926479188517,1269929596,-1.6789158590277191,2.4108656087889244,4.0897814678166435
2025-09-02T13:30:00-04:00,329.85,330.63,327.88,329.34,NaN,NaN,NaN,351.9162943434801,NaN,NaN,329.00470000000024,355.67908557192106,302.3303144280794,337.65003541449596,329.49579383356695,329.6241452297896,329.3674424373443,1087184,3015453.6,43.553212270037825,57.81263430833841,NaN,NaN,NaN,NaN,7.293198437023386,18.303866014847134,1268842412,-2.089678009952201,1.477683955376392,3.567361965328593
2025-09-03T09:30:00-04:00,335.12,343.33,328.51,341.76,NaN,NaN,NaN,351.9162943434801,NaN,NaN,329.4313000000002,356.22549099804274,302.63710900195764,337.65003541449596,337.8666666666666,337.8666666666666,337.8666666666666,5328357,3031608.2333333334,54.93257348259533,57.51175371645563,NaN,NaN,NaN,NaN,7.830827120093143,17.20349257886962,1274170769,-1.4774989675286228,1.7204882559178145,3.1979872234464373
2025-09-03T13:30:00-04:00,341.74,342.01,334.01,334.05,NaN,NaN,NaN,351.9162943434801,NaN,NaN,329.6855000000003,356.4088841606823,302.96211583931824,337.65003541449596,337.5204320996566,338.05664502231895,336.98421917699426,2221568,3046490.3,48.40851458226535,56.64890005442185,NaN,NaN,NaN,NaN,7.842910897229347,16.181717245461936,1271949201,-1.5375336933956119,1.2760701067019227,2.8136038000975345
2025-09-04T09:30:00-04:00,336.16,337.63,331.49,335.04,NaN,NaN,NaN,351.9162943434801,NaN,NaN,330.0293000000002,356.5764994010597,303.4821005989407,336.4700283315968,334.72,334.7200038146973,334.71999618530276,3580514,3027410.7333333334,49.242113152568606,55.47278965086431,NaN,NaN,NaN,NaN,7.721274404570107,15.143320298351624,1275529715,-1.4570338412376564,0.992311498550464,2.4493453397881204
2025-09-04T13:30:00-04:00,335.12,338.88,334.77,338.63,NaN,NaN,NaN,351.9162943434801,NaN,NaN,330.4195000000002,356.8872446904644,303.951755309536,334.4730226652774,335.5164524482128,336.7499007815014,334.2830041149242,1492874,3025250.8,52.254790810404735,54.64125554583939,NaN,NaN,NaN,NaN,7.463326232815101,14.111492657922101,1277022589,-1.1234227726729813,1.0450668739468938,2.168489646619875
2025-09-05T09:30:00-04:00,348.08,355.87,344.7,352.08,326.05123756032606,326.05123756032606,326.05123756032606,NaN,NaN,NaN,331.26370000000026,357.7484586215069,304.7789413784936,333.1081531765008,350.88333333333327,350.88333333333327,350.88333333333327,7638963,3123788.8,61.47951515633776,54.44906668511921,NaN,NaN,NaN,NaN,8.161660073328308,14.942205155406295,1284661552,-0.016852267737874627,2.147424311947532,2.1642765796854064
2025-09-05T13:30:00-04:00,352.04,352.28,347.87,350.79,326.3414085803113,NaN,NaN,NaN,NaN,NaN,332.1141000000002,358.3201109661818,305.90808903381856,333.1081531765008,350.7349283121205,350.9850618999145,350.48479472432643,2688980,3153915.8666666667,60.27662863153767,53.96567160226126,NaN,NaN,NaN,NaN,7.893684353804856,15.713581045927336,1281972572,0.5755520278664337,2.8837166145184483,2.3081645866520146
2025-09-08T09:30:00-04:00,354.7,358.48,344.84,347.44,327.14520819029707,NaN,NaN,NaN,NaN,NaN,332.99750000000023,358.2138739859555,307.78112601404496,335.32841803296054,350.25333333333333,350.25333333333333,350.25333333333333,4506190,3149593.466666667,57.1494952538689,53.32029915137855,NaN,NaN,NaN,NaN,8.304135471390227,16.94140173644553,1277466382,0.6818559054816071,3.1604844685040234,2.4786285630224163
2025-09-08T13:30:00-04:00,347.42,347.6,344.9,346.44,327.14520819029707,NaN,NaN,NaN,NaN,NaN,333.87370000000016,357.8210562473969,309.92634375260343,335.32841803296054,349.3066677883979,350.9900235419675,347.62331203482825,1425118,3135373.2666666666,56.21200575892386,52.7070485180019,NaN,NaN,NaN,NaN,7.903840080576643,18.08152094906957,1276041264,0.6263262559453855,3.261536382954148,2.6352101270087624
2025-09-09T09:30:00-04:00,348.44,350.77,343.83,346.91,327.14520819029707,NaN,NaN,NaN,NaN,NaN,334.6425000000002,357.7310129230875,311.5539870769129,335.32841803296054,347.17,347.17,347.17,3281754,3144609.7333333334,56.57258484420472,52.678417343387295,NaN,NaN,NaN,NaN,7.834994360535454,19.3994558603893,1279323018,0.5646578843961714,3.3410324825039766,2.776374598107805
2025-09-09T13:30:00-04:00,346.91,347.83,345.7,347.005,327.14520819029707,NaN,NaN,NaN,NaN,NaN,335.3967000000002,357.56945378566365,313.2239462143367,335.32841803296054,347.09041249140023,347.23016859590615,346.9506563868943,1064276,3140980.5,56.65028861978391,52.5164215394227,NaN,NaN,NaN,NaN,7.427494763354351,20.623252563757617,1280387294,0.47715604528601885,3.372819654715329,2.89566360942931
2025-09-10T09:30:00-04:00,350.37,356.33,346.08,354.27,327.9951572384791,NaN,NaN,NaN,NaN,NaN,336.3203000000002,357.6993203152424,314.941279684758,337.9581120263006,352.22666666666663,352.22666666666663,352.22666666666663,4305009,3121614.3,62.21781080295942,53.58758507377558,NaN,NaN,NaN,NaN,7.629102280257611,22.41242866658113,1284692303,0.834534394608883,3.9388316026904135,3.1042972080815305
2025-09-10T13:30:00-04:00,354.29,356.26,347.16,347.86,328.3142410003665,NaN,NaN,NaN,NaN,NaN,337.10390000000024,357.20715031330644,317.00064968669403,337.9581120263006,351.62462554935325,352.4738725712506,350.7753785274559,2163507,3150611.2666666666,55.45088628672875,54.16739412023313,NaN,NaN,NaN,NaN,7.734166403096351,24.073806476345812,1282528796,0.5774120382680641,3.826062255916611,3.248650217648547
2025-09-11T09:30:00-04:00,350.17,364.33,347.6,364.1,331.3513209548953,NaN,NaN,NaN,NaN,NaN,338.0153000000002,358.78840871390327,317.2421912860971,340.5669916968324,358.67666666666673,358.67666666666673,358.67666666666673,6670964,3204425.6666666665,65.64553878449075,55.717568459764856,NaN,NaN,NaN,NaN,8.376725945732323,26.147593064328934,1289199760,1.3927653699045655,4.989606930029254,3.5968415601246884
2025-09-11T13:30:00-04:00,364.07,368.99,363.66,368.88,342.10330636603646,NaN,NaN,NaN,NaN,NaN,338.9935000000002,360.85337861355947,317.13362138644095,347.314593357466,361.667905460928,365.7272182385952,357.60859268326084,3622311,3269029.8333333335,67.96897497701464,57.4615515102632,NaN,NaN,NaN,NaN,8.159102663894299,28.335956604154955,1292822071,2.1030586951506844,6.2256649290630435,4.122606233912359
2025-09-12T09:30:00-04:00,370.78,395.99,370.25,393.59,356.30247425848927,NaN,NaN,NaN,NaN,NaN,340.49690000000015,366.4471246533561,314.5466753466442,365.0946746859728,386.60999999999996,386.60999999999996,386.60999999999996,12063201,3576568.1333333333,76.73027263598999,59.018530021219966,NaN,NaN,NaN,NaN,9.51273818790185,31.382274530106518,1304885272,3.9773604376431466,9.094306780966292,5.1169463433231455
2025-09-12T13:30:00-04:00,393.58,396.61,391.98,396,368.0650890649216,NaN,NaN,NaN,NaN,NaN,341.9707000000002,371.7148133006103,312.2265866993901,369.5787397487782,388.6714693376907,392.2441906772505,385.09874799813093,4016225,3670300.3333333335,77.38012802076267,61.08793098111263,NaN,NaN,NaN,NaN,9.16397117448029,34.22770320779597,1308901497,5.0507869988883645,11.430430091933601,6.379643093045237
2025-09-15T09:30:00-04:00,423.2,425.69,414.25,417.55,390.88372138015245,NaN,NaN,NaN,NaN,NaN,343.7481000000002,380.0099629355909,307.48623706440947,389.2199917990226,419.16333333333336,419.16333333333336,419.16333333333336,8599441,3745815.6,82.17406796008682,63.44021346736393,NaN,NaN,NaN,NaN,10.63011609058884,37.46470447382323,1317500938,6.775928038195101,14.849553140789112,8.073625102594011
2025-09-15T13:30:00-04:00,417.49,418.19,402.43,410.26,390.88372138015245,NaN,NaN,NaN,NaN,NaN,345.35930000000013,385.8890118178713,304.829588182129,389.2199917990226,416.1779885129565,420.3693754982175,411.98660152769554,4362583,3804374.7333333334,76.28424506489935,65.15660305697068,NaN,NaN,NaN,NaN,10.996536369832494,39.028837492151155,1313138355,6.963171207472531,16.777589111934674,9.814417904462143
2025-09-16T09:30:00-04:00,414.47,422.12,411.5,418.77,390.88372138015245,NaN,NaN,NaN,NaN,NaN,346.8869000000002,392.3153979232144,301.458402076786,389.2199917990226,417.4633333333333,417.4633333333333,417.4633333333333,6139161,3857038.6333333333,78.24454421036125,66.35410513225807,NaN,NaN,NaN,NaN,11.058212343415889,40.59356073562647,1319277516,7.169122802142809,18.775821407140654,11.606698604997845
2025-09-16T13:30:00-04:00,418.8,423.24,417.5,421.65,390.88372138015245,NaN,NaN,NaN,NaN,NaN,348.53530000000023,398.4887881028285,298.581811897172,391.91015580109956,418.3579687756341,419.83504208674583,416.8808954645224,2252149,3867594.3333333335,78.88076974146534,67.68297235439577,NaN,NaN,NaN,NaN,10.678340033171898,42.07926560164496,1321529665,7.000370824171444,20.35716213521215,13.356791311040705
2025-09-17T09:30:00-04:00,415.78,420.42,409.67,419.72,390.88372138015245,NaN,NaN,NaN,NaN,NaN,350.15390000000014,403.84426003939393,296.46353996060634,391.91015580109956,416.6033333333333,416.6033333333333,416.6033333333333,4373397,3883772.566666667,77.25037411215534,69.11874941570194,NaN,NaN,NaN,NaN,10.771315745088188,42.52294060032461,1317156268,6.282689939516777,21.210153735436677,14.9274637959199
2025-09-17T13:30:00-04:00,419.77,428.3,411.77,425.63,390.88372138015245,NaN,NaN,NaN,NaN,NaN,351.8512000000002,409.4689982071476,294.23340179285276,395.19189971270373,419.2868457437075,421.93494541649096,416.638746070924,4491149,3956260.2666666666,78.70206520091925,70.72518223298732,NaN,NaN,NaN,NaN,11.18265033472475,43.23362838247066,1321647417,5.744584031658945,22.10819383549358,16.363609803834635
2025-09-18T09:30:00-04:00,428.82,432.21,420.84,423.43,395.6055938682964,NaN,NaN,NaN,NaN,NaN,353.4898000000002,414.40269528367173,292.5769047163286,400.03851977016296,425.4933333333333,425.4933409627278,425.49332570393875,5727951,4016136.5,76.7389945077622,72.16564006609858,NaN,NaN,NaN,NaN,11.196032453672982,44.03418275641047,1315919466,4.816586318600525,22.38434270208529,17.567756383484767
2025-09-18T13:30:00-04:00,423.44,424.84,416.57,416.66,395.6055938682964,NaN,NaN,NaN,NaN,NaN,355.0362000000002,418.31365243164885,291.7587475683515,400.03851977016296,423.7711554639543,426.5284249305394,421.0138859973692,2234585,4043737.7333333334,70.87998629333875,73.18204704278106,NaN,NaN,NaN,NaN,10.987030135553482,44.265078048643964,1313684881,3.390234450901797,21.805549447112014,18.415314996210217
2025-09-19T09:30:00-04:00,421.955,429.47,421.75,423.54,395.6055938682964,NaN,NaN,NaN,NaN,NaN,356.82780000000014,422.6387551415242,291.0168448584761,400.03851977016296,424.92,424.92,424.92,4971799,4072864.066666667,73.12558177997005,73.96117354113896,NaN,NaN,NaN,NaN,11.117242268728234,44.67329724304524,1318656680,2.589679656661925,21.652414567037624,19.0627349103757
2025-09-19T13:30:00-04:00,423.59,427,423.01,425.9,395.6055938682964,NaN,NaN,NaN,NaN,NaN,358.63420000000013,426.924678673383,290.34372132661724,400.7628021223234,425.02944603289984,425.2025814668301,424.85631059896957,1986743,4089159.6333333333,73.86995102891325,75.27682102272357,NaN,NaN,NaN,NaN,10.608153535247647,45.05235792356071,1320643423,1.928970505298544,21.47394804199888,19.544977536700337