time,open,high,low,close,Long Stop,Long Stop Start,Buy Label,Short Stop,Short Stop Start,Sell Label,Basis,Upper,Lower,ATR Trailing Stoploss,VWAP,Upper Band #1,Lower Band #1,Volume,Volume MA,RSI,RSI-based MA,Regular Bullish,Regular Bullish Label,Regular Bearish,Regular Bearish Label,ATR,ADX,OnBalanceVolume,Histogram,MACD,Signal
2025-09-22T10:30:00-04:00,444.33,444.98,442.64,442.9,438.2638450890041,NaN,NaN,NaN,NaN,NaN,429.1123999999982,443.43361255223954,414.7911874477569,438.97172624269564,439.58042439686216,442.92836928929796,436.23247950442635,126176,143247.43333333332,74.82422850222079,83.25837586576998,NaN,NaN,NaN,NaN,2.0908852030463625,56.61002166863119,106194480,0.4966334082668613,4.654340168931924,4.157706760665063
2025-09-22T10:35:00-04:00,442.91,443.41,442.52,443.235,438.2638450890041,NaN,NaN,NaN,NaN,NaN,429.50109999999825,444.272385562411,414.7298144375855,438.97172624269564,439.6845776638083,443.0347693645601,436.3343859630565,94493,144313.1,75.36482942643732,84.64140228088749,NaN,NaN,NaN,NaN,2.005107688543054,57.88030976478188,106288973,0.3138280634799244,4.549991840014968,4.236163776535044
2025-09-22T10:40:00-04:00,443.24,443.49,442.44,442.71,438.2638450890041,NaN,NaN,NaN,NaN,NaN,429.8720999999982,445.015287523313,414.72891247668343,438.97172624269564,439.74793811269643,443.09453076930896,436.4013454560839,63770,144733.43333333332,72.72909669960305,83.79700405075305,NaN,NaN,NaN,NaN,1.9368857107899795,59.05986299692181,106225203,0.11067325918914417,4.374505350521474,4.26383209133233
2025-09-22T10:45:00-04:00,442.71,442.88,441.86,442.53,438.2638450890041,NaN,NaN,NaN,NaN,NaN,430.22669999999823,445.7048414403141,414.74855855968235,438.97172624269564,439.8110568687189,443.14277409259427,436.4793396448435,77708,145864.66666666666,71.80191139625228,82.77194038008895,NaN,NaN,NaN,NaN,1.8713938743049796,59.53679664663858,106147495,-0.07282163427333721,4.172805048490659,4.245626682763996
2025-09-22T10:50:00-04:00,442.54,442.92,441.2,441.34,438.2638450890041,NaN,NaN,NaN,NaN,NaN,430.56909999999823,446.2566081120718,414.8815918879247,438.97172624269564,439.87059340684704,443.17020454745017,436.5709822662439,100595,146524.96666666667,65.82712513489818,81.20062670612698,NaN,NaN,NaN,NaN,1.8605800261403402,59.300793800305385,106046900,-0.2986648361991211,3.8722956375150943,4.170960473714215
2025-09-22T10:55:00-04:00,441.33,441.87,440.96,441.4,438.2638450890041,NaN,NaN,NaN,NaN,NaN,430.9168999999983,446.77744789614974,415.05635210384685,438.97172624269564,439.90565611821336,443.17554900199065,436.63576323443607,79115,147509.83333333334,65.98083403064837,79.55663762012145,NaN,NaN,NaN,NaN,1.7926814528446033,58.83654659914279,106126015,-0.4587592662660409,3.597511390881664,4.056270657147705
2025-09-22T11:00:00-04:00,441.4,442.01,439.92,440.19,438.2638450890041,NaN,NaN,NaN,NaN,NaN,431.2314999999982,447.1909797222957,415.27202027770073,438.97172624269564,439.93275778454995,443.1501185256033,436.7153970434966,121639,149485.1,60.108975107793206,77.45045676693528,NaN,NaN,NaN,NaN,1.8139184919271298,57.39077563129703,106004376,-0.6492540532127791,3.244703090631731,3.89395714384451
2025-09-22T11:05:00-04:00,440.16,441.9,439.98,441.66,438.2638450890041,NaN,NaN,NaN,NaN,NaN,431.59389999999826,447.6608602963989,415.52693970359763,438.97172624269564,439.95929083622065,443.1473293938979,436.7712522785434,78143,150275.96666666667,64.26920335772897,75.63888172190444,NaN,NaN,NaN,NaN,1.8214957425037606,56.04827401829739,106082519,-0.6763060230403597,3.0485746150440605,3.72488063808442
2025-09-22T11:10:00-04:00,441.65,442.07,441.04,441.44,438.2638450890041,NaN,NaN,NaN,NaN,NaN,431.94649999999825,448.0883224809415,415.804677519055,438.97172624269564,439.9795715963372,443.15170164416224,436.8074415485122,48466,150006.76666666666,63.20678469215193,73.64450059533156,NaN,NaN,NaN,NaN,1.7649603323249186,54.877627937990894,106034053,-0.705807506174192,2.84262125536668,3.548428761540872
2025-09-22T11:15:00-04:00,441.45,442.08,441.05,441.06,438.2638450890041,NaN,NaN,NaN,NaN,NaN,432.2946999999983,448.45673507130635,416.1326649286902,438.97172624269564,440.0107800309478,443.1546721624576,436.866887899438,83809,149758.53333333333,61.321187464875635,71.67561520148817,NaN,NaN,NaN,NaN,1.7124631657302796,53.795323018150185,105950244,-0.7438999284328327,2.618553850999831,3.3624537794326637
2025-09-22T11:20:00-04:00,441.05,441.36,440.4,441.17,438.2638450890041,NaN,NaN,NaN,NaN,NaN,432.63989999999825,448.80814498720434,416.47165501279216,438.76370479532517,440.0272625881845,443.1467237512592,436.9078014251098,66068,150335.83333333334,61.6775827089219,69.72598058948401,NaN,NaN,NaN,NaN,1.6587157967495478,52.07922216825624,106016312,-0.7524139634981175,2.4219363250600168,3.1743502885581343
2025-09-22T11:25:00-04:00,441.21,442.63,441.1,442.51,438.2638450890041,NaN,NaN,NaN,NaN,NaN,433.01609999999823,449.21010522311434,416.8220947768821,439.13253140217125,440.05670772483325,443.16331823714927,436.9500972125172,56344,150715.9,65.81042867866874,68.90784985731072,NaN,NaN,NaN,NaN,1.6495218112674352,51.13971544518044,106072656,-0.6617318885960826,2.347185427813031,3.0089173164091134
2025-09-22T11:30:00-04:00,442.52,442.77,441.72,441.81,438.2638450890041,NaN,NaN,NaN,NaN,NaN,433.37589999999824,449.5360093674013,417.2157906325952,439.447025121737,440.0830190916743,443.178147943613,436.98789023973563,51240,149346.43333333332,62.04609018534749,67.62552955636464,NaN,NaN,NaN,NaN,1.6066988247483296,50.33380674597869,106021416,-0.6423091312852671,2.2060309023025297,2.848340033587797
2025-09-22T11:35:00-04:00,441.84,442.12,441.035,441.65,438.2638450890041,NaN,NaN,NaN,NaN,NaN,433.72889999999825,449.825326844685,417.6324731553115,439.447025121737,440.1027425506165,443.1825101528171,437.0229749484159,52360,148943.13333333333,61.184614932628044,66.15377802272687,NaN,NaN,NaN,NaN,1.5694346229805904,48.84281014208895,105969056,-0.6326430158534384,2.0575362637709986,2.690179279624437
2025-09-22T11:40:00-04:00,441.68,441.69,440.79,441.13,438.2638450890041,NaN,NaN,NaN,NaN,NaN,434.04709999999824,450.0870483903862,418.0071516096103,439.447025121737,440.12282655193155,443.1779180485268,437.0677350553363,74937,149538.5,58.3491083827495,64.97698372847891,NaN,NaN,NaN,NaN,1.5216178641962608,47.20089710592632,105894119,-0.6511313258480236,1.8762651223144076,2.527396448162431
2025-09-22T11:45:00-04:00,441.15,441.76,440.93,441.47,438.2638450890041,NaN,NaN,NaN,NaN,NaN,434.36429999999825,450.35150313394627,418.37709686605024,439.447025121737,440.14287859753654,443.1777489754378,437.1080082196353,66204,149757,59.6653246270393,63.855590528521894,NaN,NaN,NaN,NaN,1.4722165881822409,45.72124043796944,105960323,-0.6299298456125002,1.739984141146806,2.369913986759306
2025-09-22T11:50:00-04:00,441.47,441.87,441.09,441.24,438.2638450890041,NaN,NaN,NaN,NaN,NaN,434.6730999999983,450.58295466828616,418.7632453317105,439.447025121737,440.156756947761,443.17768579729176,437.1358280982302,46580,145419.53333333333,58.322640895230876,62.82655797106674,NaN,NaN,NaN,NaN,1.4227725461692258,44.42167254377304,105913743,-0.6199033212436622,1.5950348352047286,2.2149381564483908
2025-09-22T11:55:00-04:00,441.26,441.39,440.5,440.71,438.2638450890041,NaN,NaN,NaN,NaN,NaN,434.9836999999983,450.745793872518,419.2216061274786,439.447025121737,440.1666165514841,443.1676441146442,437.165588988324,59425,142623.66666666666,55.2378804610361,61.64341290426558,NaN,NaN,NaN,NaN,1.3847173642999944,42.52583555601425,105854318,-0.6351390637753358,1.421014326729221,2.056153390504557
2025-09-22T12:00:00-04:00,440.72,440.95,439.9,440.83,438.2638450890041,NaN,NaN,NaN,NaN,NaN,435.2868999999983,450.90325743590705,419.67054256408954,439.447025121737,440.173702286082,443.1480395241415,437.1993650480225,78483,131115.63333333333,55.80780828748486,60.92774741516464,NaN,NaN,NaN,NaN,1.3608089811357098,40.12119859098164,105932801,-0.6224809311061066,1.2780522266219236,1.9005331577280302
2025-09-22T12:05:00-04:00,440.78,441.18,440.09,441.13,438.2638450890041,NaN,NaN,NaN,NaN,NaN,435.5960999999983,451.04992687770704,420.1422731222895,439.447025121737,440.18211182962966,443.13729208053877,437.22693157872055,59302,117608.83333333333,57.272484249292155,60.305722430782055,NaN,NaN,NaN,NaN,1.3414654824831616,38.08764240071881,105992103,-0.5800970786421624,1.1754118094253272,1.7555088880674896
2025-09-22T12:10:00-04:00,441.15,441.55,438.74,439.02,438.2638450890041,NaN,NaN,NaN,NaN,NaN,435.8632999999983,451.0808866170081,420.64571338298845,439.447025121737,440.1707054346185,443.08548625199546,437.2559246172416,125719,113903.9,45.77992029476373,59.28221851556566,NaN,NaN,NaN,NaN,1.446360805162936,35.82805622906017,105866384,-0.6737819636926878,0.9132814334516297,1.5870633971443175
2025-09-22T12:15:00-04:00,439.01,439.4,437.91,438.01,NaN,NaN,NaN,443.10479200069926,443.10479200069926,443.10479200069926,436.10689999999835,451.0619284374774,421.1518715625193,439.447025121737,440.1151186047047,442.9988988932989,437.23133831611057,150728,109174.93333333333,41.48831021781548,57.65501186271469,NaN,NaN,NaN,NaN,1.4494778905084371,34.37771088662867,105715656,-0.7761058652597381,0.6169310655696449,1.393036930829383
2025-09-22T12:20:00-04:00,437.92,438.91,437.79,438.38,NaN,NaN,NaN,442.75025600066755,NaN,NaN,436.3556999999983,451.03729936948275,421.67410063051386,439.2211494898635,440.08615792913946,442.9547737215108,437.21754213676815,78736,105465.26666666666,43.57511090908428,56.25274944963843,NaN,NaN,NaN,NaN,1.4259437554721206,33.12069610436609,105794392,-0.7886432686860085,0.4072328449718725,1.195876113657881
2025-09-22T12:25:00-04:00,438.39,438.79,437.94,438.14,NaN,NaN,NaN,442.68115345518265,NaN,NaN,436.6084999999983,450.9654052725885,422.2515947274081,439.2211494898635,440.05448382487185,442.9075054838296,437.2014621659141,85656,101226.1,42.51589651538897,54.90951438181795,NaN,NaN,NaN,NaN,1.384804915795542,31.953468092265112,105708736,-0.78137830051981,0.21915323800811848,1.0005315385279285
2025-09-22T12:30:00-04:00,438.17,438.52,437.01,437.14,NaN,NaN,NaN,442.0908737526743,NaN,NaN,436.8664999999983,450.78191192368854,422.9510880763081,439.2211494898635,440.00924625968133,442.85586950956525,437.1626230097974,89593,94249.36666666667,38.33461055807592,53.2421592281861,NaN,NaN,NaN,NaN,1.3937474218101455,31.570484634799488,105619143,-0.8088029364091242,-0.010472131983476629,0.7983308044256475
2025-09-22T12:35:00-04:00,437.17,437.47,436.36,436.53,NaN,NaN,NaN,441.19560676391643,NaN,NaN,437.1120999999983,450.5535427933164,423.6706572066802,439.2211494898635,439.9200570125775,442.7763587942459,437.0637552309091,140810,91477.96666666666,36.008259881569025,51.11343288553611,NaN,NaN,NaN,NaN,1.3734797488237074,31.642263887461684,105478333,-0.8298003849558552,-0.23891967676917147,0.5908807081866837
2025-09-22T12:40:00-04:00,436.5,436.86,435.46,435.87,NaN,NaN,NaN,440.436942820102,NaN,NaN,437.34469999999834,450.28008254733277,424.4093174526639,438.8259195918908,439.8304095869187,442.7125146567312,436.9483045171062,121076,89547.03333333334,33.63025332179376,49.08373025242514,NaN,NaN,NaN,NaN,1.3753740524791593,32.230845316444956,105357257,-0.8469682763042065,-0.4678296371935744,0.37913863911063206
2025-09-22T12:45:00-04:00,435.82,437.52,435.76,436.99,NaN,NaN,NaN,440.436942820102,NaN,NaN,437.58669999999836,450.0241581987592,425.1492418012375,438.5739885388101,439.7816606597131,442.6664925443867,436.8968287750395,83942,87948.53333333334,40.77775918608077,47.626097699100335,NaN,NaN,NaN,NaN,1.402847334444933,31.989654409669953,105441199,-0.7453100525372945,-0.5524989265609861,0.19281112597630842
2025-09-22T12:50:00-04:00,437.03,437.75,435.23,435.27,NaN,NaN,NaN,440.436942820102,NaN,NaN,437.77849999999836,449.763116180996,425.7938838190007,438.5739885388101,439.7101898458554,442.61202381342133,436.80835587828943,104299,88374.76666666666,34.61296874632859,45.93065915364169,NaN,NaN,NaN,NaN,1.4826439534131508,32.090058077176636,105336900,-0.7540464668042454,-0.7497469575289983,0.004299509275247054
2025-09-22T12:55:00-04:00,435.24,435.61,433.15,433.24,NaN,NaN,NaN,438.9819804148164,NaN,NaN,437.9268999999984,449.49194714931207,426.3618528506847,438.0601908310481,439.54134928185414,442.5591731592778,436.5235254044305,164444,87662,29.033998063000553,43.74270725621035,NaN,NaN,NaN,NaN,1.5524550995979283,33.19403159230131,105172456,-0.8495829755769517,-1.0576792101959427,-0.20809623461899093
2025-09-22T13:00:00-04:00,433.2,433.32,431.8,433.08,NaN,NaN,NaN,437.16007221414293,NaN,NaN,438.0738999999984,449.1933480603072,426.9544519396896,435.8631526648385,439.3870579486047,442.5378472855997,436.2362686116097,128964,87754.93333333333,28.642139525603767,41.62267144409413,NaN,NaN,NaN,NaN,1.5501368781980749,34.70359168105161,105043492,-0.8732405175387734,-1.2996468815424578,-0.4264063640036843
2025-09-22T13:05:00-04:00,433.06,433.83,432.27,432.79,NaN,NaN,NaN,437.16007221414293,NaN,NaN,438.21029999999837,448.891167083052,427.52943291694476,435.6534177054966,439.283549214335,442.5118157112628,436.0552827174072,93195,87711.66666666667,27.90695291680146,39.67046233379166,NaN,NaN,NaN,NaN,1.5508413868982127,35.55444055628402,104950297,-0.8569115527070705,-1.4975458048875225,-0.640634252180452
2025-09-22T13:10:00-04:00,432.8,432.99,430.15,430.41,NaN,NaN,NaN,436.3517186909856,NaN,NaN,438.2988999999984,448.6405960487982,427.9572039511986,435.6534177054966,439.1090229622154,442.5120217457066,435.70602417872425,127358,89831.26666666666,22.74666914114718,37.30895239476754,NaN,NaN,NaN,NaN,1.642924144976914,37.04162622023727,104822939,-0.9478016540183113,-1.825386319703341,-0.8775846656850298
2025-09-22T13:15:00-04:00,430.39,431.06,429.89,430.3,NaN,NaN,NaN,435.1989132959408,NaN,NaN,438.3984999999983,448.3259085745513,428.4710914254453,435.25573416439727,438.8946220248604,442.5157332388667,435.2735108108541,149485,92223.83333333333,22.539225292331963,34.82800532641325,NaN,NaN,NaN,NaN,1.6091438489071357,38.496049683154624,104673454,-0.9541036509537362,-2.0702142293772,-1.1161105784234637
2025-09-22T13:20:00-04:00,430.29,432.39,430.05,432.25,NaN,NaN,NaN,435.1989132959408,NaN,NaN,438.5322999999984,447.93017150612224,429.1344284938745,434.30358733151786,438.7377021652365,442.4736875587071,435.00171677176587,132557,93289.23333333334,34.02564122273995,33.98841396412583,NaN,NaN,NaN,NaN,1.6613478596994813,38.5541971721477,104806011,-0.7734181190371907,-2.082883227219952,-1.3094651081827613
2025-09-22T13:25:00-04:00,432.3,433.37,432.15,433,NaN,NaN,NaN,435.1989132959408,NaN,NaN,438.6748999999984,447.4987568645273,429.85104313546947,434.0534958921714,438.6378256376742,442.41939731148335,434.8562539638651,106685,94208.23333333334,37.84334039916964,33.7280589770797,NaN,NaN,NaN,NaN,1.6298230125780917,37.776408227619015,104912696,-0.5598226809798934,-2.009243459407628,-1.4494207784277346
2025-09-22T13:30:00-04:00,432.99,433.37,432.62,433.27,NaN,NaN,NaN,435.1989132959408,NaN,NaN,438.8120999999984,447.0636433929354,430.5605566070614,434.0534958921714,438.56224135963936,442.3726796273607,434.751803091918,86961,93052.3,39.20718830346109,33.41606450524948,NaN,NaN,NaN,NaN,1.5669785116796564,37.05417563627095,104999657,-0.3661535066391495,-1.9071126617266714,-1.540959155087522
2025-09-22T13:35:00-04:00,433.27,434.16,433.15,434.05,NaN,NaN,NaN,435.1989132959408,NaN,NaN,438.97509999999835,446.4889614550489,431.4612385449478,433.71679671373715,438.4952716646031,442.32034186293697,434.6702014662692,90837,93475.43333333333,43.091976102537814,33.45721304718868,NaN,NaN,NaN,NaN,1.52719433227397,35.72254669830777,105090494,-0.16174464004826516,-1.7431399551478535,-1.5813953150995883
2025-09-22T13:40:00-04:00,434.03,434.57,433.61,434.45,NaN,NaN,NaN,435.1989132959408,NaN,NaN,438.9624999999984,446.50450616584357,431.4204938341532,431.2012763116445,438.44927507777896,442.27930229704594,434.619247858512,70282,94202.63333333333,45.031861926359724,33.93558814492324,NaN,NaN,NaN,NaN,1.4866804513972565,34.15672297579407,105160776,0.014798143527824381,-1.5628976356898079,-1.5776957792176323
2025-09-22T13:45:00-04:00,434.5,435.05,434.12,434.13,NaN,NaN,NaN,435.1989132959408,NaN,NaN,438.9130999999984,446.54813946063666,431.2780605393601,431.89002104931564,438.37193609221697,442.20484861741,434.53902356702395,128574,95694.8,43.747088661158806,34.48836162917966,NaN,NaN,NaN,NaN,1.4469175620117387,32.322388983307185,105032202,0.11863789577662187,-1.429398409496855,-1.548036305273477
2025-09-22T13:50:00-04:00,434.12,434.84,433.73,433.95,NaN,NaN,NaN,435.1989132959408,NaN,NaN,438.82269999999835,446.582598249698,431.0628017502987,431.89002104931564,438.3272622288695,442.16398913592695,434.490535321812,71802,95885.93333333333,43.003862040215495,35.157905109066924,NaN,NaN,NaN,NaN,1.42285202186804,30.876212367787275,104960400,0.18012941825328954,-1.322874532456865,-1.5030039507101545
2025-09-22T13:55:00-04:00,433.94,434.13,433.33,433.74,NaN,NaN,NaN,435.1989132959408,NaN,NaN,438.6974999999984,446.57843554127135,430.81656445872545,431.89002104931564,438.2900057052581,442.13329295192403,434.4467184585922,55175,95846.96666666666,42.105113058419654,35.25271609994827,NaN,NaN,NaN,NaN,1.3783625917346094,29.794816568533435,104905225,0.20952932221708997,-1.241092297938792,-1.450621620155882
2025-09-22T14:00:00-04:00,433.69,433.8,432.98,433.01,NaN,NaN,NaN,435.1989132959408,NaN,NaN,438.5406999999984,446.5549343393092,430.5264656606876,431.89002104931564,438.24279454019523,442.0985970771188,434.38699200327164,64504,96289.1,39.04991549776612,35.5696408679081,NaN,NaN,NaN,NaN,1.338479549467851,29.01788671045042,104840721,0.1836108849741973,-1.2211080139381352,-1.4047188989123325
2025-09-22T14:05:00-04:00,433.01,433.85,432.95,433.34,NaN,NaN,NaN,435.1989132959408,NaN,NaN,438.38949999999835,446.5046084407826,430.2743915592141,431.89002104931564,438.2068664921133,442.07090438778306,434.34282859644355,51120,96247.76666666666,41.12950636419442,36.4336057465648,NaN,NaN,NaN,NaN,1.3071595816487211,28.24740254199315,104891841,0.19160690776493294,-1.1652102642061664,-1.3568171719710993
2025-09-22T14:10:00-04:00,433.29,433.7,432.73,432.83,NaN,NaN,NaN,435.1989132959408,NaN,NaN,438.1824999999983,446.3262289373936,430.038771062603,431.89002104931564,438.1553148236482,442.0336854328157,434.27694421448075,70371,96095.56666666667,38.919412182906726,37.167696650657874,NaN,NaN,NaN,NaN,1.283076754388096,27.68750933930538,104821470,0.16639714383727355,-1.1488207421745074,-1.315217886011781
2025-09-22T14:15:00-04:00,432.84,434.26,432.75,433.98,NaN,NaN,NaN,435.1989132959408,NaN,NaN,438.0058999999983,446.123495134383,429.8883048656136,431.89002104931564,438.1168151654162,442.00066595191333,434.23296437891906,60422,95902.83333333333,45.96970235275354,38.45789303894016,NaN,NaN,NaN,NaN,1.2992855576460887,26.582407757791977,104881892,0.22725424276758366,-1.0311500825523012,-1.2584043253198849
2025-09-22T14:20:00-04:00,433.99,434.29,433.04,433.14,NaN,NaN,NaN,435.1989132959408,NaN,NaN,437.81029999999834,445.9161375042728,429.7044624957239,431.89002104931564,438.0768395057058,441.9675117634902,434.18616724792133,61441,96398.2,42.143236854226735,39.84336216130299,NaN,NaN,NaN,NaN,1.2957651606713678,25.524900642555426,104820451,0.21135104487235412,-0.9942155192294422,-1.2055665641017963
2025-09-22T14:25:00-04:00,433.12,433.56,432.85,433.24,NaN,NaN,NaN,435.1989132959408,NaN,NaN,437.6562999999983,445.8108782996897,429.50172170030686,431.89002104931564,438.0413479393739,441.93981241604865,434.14288346269916,52312,96161.1,42.75414449559298,41.287284961535924,NaN,NaN,NaN,NaN,1.253924792051983,24.706622553809026,104872763,0.2076765441388111,-0.9459708839282825,-1.1536474280670936
2025-09-22T14:30:00-04:00,433.21,434.11,432.91,434.02,NaN,NaN,NaN,435.1989132959408,NaN,NaN,437.4796999999983,445.5588243118221,429.40057568817446,431.89002104931564,438.00810867512126,441.9101670145821,434.1060503356604,55015,95378.83333333333,47.41792823695028,42.243876891122376,NaN,NaN,NaN,NaN,1.2500730211911262,23.336422366553826,104927778,0.25478205182049973,-0.835169863291469,-1.0899519151119688
2025-09-22T14:35:00-04:00,434.03,434.65,433.77,434.27,NaN,NaN,NaN,435.1989132959408,NaN,NaN,437.27909999999827,445.1666942318115,429.391505768185,432.0297793087291,437.9674150064876,441.8679470083633,434.06688300461195,78597,96022,48.85612424767661,43.03050430887287,NaN,NaN,NaN,NaN,1.2236392339631883,21.82818257718792,105006375,0.29684207479723534,-0.7188993216154245,-1.0157413964126598
2025-09-22T14:40:00-04:00,434.19,434.21,433.53,433.57,NaN,NaN,NaN,435.1989132959408,NaN,NaN,437.09249999999827,444.8801759695037,429.30482403049285,432.0297793087291,437.94213970672826,441.84444516975566,434.03983424370085,44207,93304.93333333333,45.13371448794184,43.45382760776436,NaN,NaN,NaN,NaN,1.1890935743943898,20.35816957551053,104962168,0.27223148604263836,-0.6754520388593619,-0.9476835249020003
2025-09-22T14:45:00-04:00,433.55,433.98,433.29,433.32,NaN,NaN,NaN,435.1989132959408,NaN,NaN,436.8941999999983,444.54996393612896,429.23843606386765,432.0297793087291,437.91230259842604,441.8181653519008,434.0064398449513,49984,89946.8,43.848756005486514,43.50788331511784,NaN,NaN,NaN,NaN,1.1534440333662188,19.241863071528606,104912184,0.23522065530332525,-0.6536577057728437,-0.8888783610761689
2025-09-22T14:50:00-04:00,433.32,433.56,433.08,433.39,NaN,NaN,NaN,435.1989132959408,NaN,NaN,436.7077999999983,444.24094095486424,429.1746590451324,432.0297793087291,437.8918791008746,441.8009029065869,433.98285529516227,33188,88428.53333333334,44.32670075152477,43.457514659772485,NaN,NaN,NaN,NaN,1.105340888125776,18.42411642273031,104945372,0.21226329899334562,-0.6235492373344869,-0.8358125363278325
2025-09-22T14:55:00-04:00,433.41,434.03,433.35,433.49,NaN,NaN,NaN,435.1989132959408,NaN,NaN,436.5269999999983,443.9252400613838,429.12875993861275,432.0297793087291,437.86620255913004,441.77740350993906,433.955001608321,44931,87071.03333333334,45.04631830238867,43.5503167770032,NaN,NaN,NaN,NaN,1.0749593961167885,17.110953643148466,104990303,0.20074858966738407,-0.5848767992436024,-0.7856253889109864
2025-09-22T15:00:00-04:00,433.45,434.11,433.24,433.56,NaN,NaN,NaN,435.1989132959408,NaN,NaN,436.37139999999835,443.6849600199698,429.05783998002687,432.06261408388434,437.8378657756642,441.7511830575409,433.92454849378754,50381,85763.96666666666,45.576620005511735,43.73408520309578,NaN,NaN,NaN,NaN,1.060319439251304,16.01872901912124,105040684,0.19463745332240012,-0.5423285722579863,-0.7369660255803864
2025-09-22T15:05:00-04:00,433.53,434.22,433.5,434,NaN,NaN,NaN,435.1989132959408,NaN,NaN,436.22339999999826,443.4225306257057,429.02426937429084,432.2220912671075,437.809604192362,441.7229482700383,433.8962601146857,54452,82885.36666666667,48.91372437803543,44.22041458306834,NaN,NaN,NaN,NaN,1.0360109078762127,14.881391678107706,105095136,0.21540244518801033,-0.4677129690953734,-0.6831154142833837
2025-09-22T15:10:00-04:00,434.04,434.2,433.33,433.84,NaN,NaN,NaN,435.1989132959408,NaN,NaN,436.0963999999983,443.2349362761442,428.9578637238524,432.2220912671075,437.78294099930264,441.6969086172692,433.8689733813361,50578,80535.43333333333,47.76672873245735,44.843044099832,NaN,NaN,NaN,NaN,1.024152985885055,14.028677292510954,105044558,0.21314279431815508,-0.41668692138568986,-0.6298297157038449
2025-09-22T15:15:00-04:00,433.83,434.48,433.79,434.4,NaN,NaN,NaN,435.1989132959408,NaN,NaN,435.95119999999827,442.92459933217975,428.9778006678168,432.5083384109488,437.7500588942589,441.6607617862406,433.83935600227727,71092,80107.1,52.008507565867376,45.62011561423721,NaN,NaN,NaN,NaN,1.0002849154646938,13.192182632801133,105115650,0.242033120481832,-0.32728831510155487,-0.5693214355833869
2025-09-22T15:20:00-04:00,434.37,435.12,434.23,435,NaN,NaN,NaN,435.1989132959408,NaN,NaN,435.8223999999983,442.62123585371813,429.0235641462785,433.09767072875906,437.7177538253981,441.61927401044085,433.8162336403554,84725,79454.63333333333,56.12013698477695,46.84873881437079,NaN,NaN,NaN,NaN,0.9924074215029289,13.195112809108107,105200375,0.29093423425106,-0.20565364276956188,-0.4965878770206219
2025-09-22T15:25:00-04:00,435.05,436,434.95,435.775,432.14155755257536,432.14155755257536,432.14155755257536,NaN,NaN,NaN,435.7166999999983,442.34882352463046,429.08457647536613,433.8571365830072,437.6892265370205,441.572462115087,433.805990958954,104985,77472.66666666667,60.79266744161337,47.90752203500364,NaN,NaN,NaN,NaN,0.9965211771098633,14.077744675002817,105305360,0.3603192380273573,-0.04618882948642522,-0.40650806751378254
2025-09-22T15:30:00-04:00,435.8,436.3,435.4,435.48,432.54535039109464,NaN,NaN,NaN,NaN,NaN,435.6028999999983,442.0495009932456,429.15629900675094,434.1357092664058,437.6715480127382,441.54169872504355,433.8013973004328,71679,75563.16666666667,58.25000986029326,49.05800582115125,NaN,NaN,NaN,NaN,0.989626807316304,15.160779380323469,105233681,0.3697997299564796,0.05574159493181696,-0.3140581350246626
2025-09-22T15:35:00-04:00,435.46,435.6,434.13,434.21,432.54535039109464,NaN,NaN,NaN,NaN,NaN,435.4368999999982,441.58401408437464,429.2897859156218,434.1357092664058,437.643471877849,441.5065254445463,433.78041831115166,74550,74941.66666666667,48.78922829459327,49.489083235365555,NaN,NaN,NaN,NaN,1.0239391782222842,14.465604301017345,105159131,0.27817118074077307,0.03365584090130369,-0.24451533983946935
2025-09-22T15:40:00-04:00,434.15,434.7,433.65,434.04,432.54535039109464,NaN,NaN,NaN,NaN,NaN,435.2814999999983,441.1634392215447,429.39956077845187,434.1357092664058,437.60979519800986,441.46950138888525,433.7500890071345,77731,73287.43333333333,47.67304934457737,49.507306171624634,NaN,NaN,NaN,NaN,1.025800665492122,13.5699514114037,105081400,0.19753818511228693,0.002407391550889315,-0.19513079356139762
2025-09-22T15:45:00-04:00,434.05,434.56,433.69,434.51,432.54535039109464,NaN,NaN,NaN,NaN,NaN,435.1386999999982,440.73500549972306,429.54239450027336,434.1357092664058,437.5810019880661,441.436562940767,433.7254410353652,70170,70643.6,51.01000829981471,49.66115503249164,NaN,NaN,NaN,NaN,1.0146720465283992,12.738273728191027,105151570,0.16841697968514557,0.015390431045034347,-0.15302654864011123
2025-09-22T15:50:00-04:00,434.53,435.32,433.33,434.37,432.54535039109464,NaN,NaN,NaN,NaN,NaN,435.0034999999982,440.33464781319367,429.67235218680275,434.1357092664058,437.52302864798213,441.36802246984337,433.6780348261209,148981,71191.06666666667,49.987419534642044,50.00784825011308,NaN,NaN,NaN,NaN,1.0843383289192283,12.517525869349939,105002589,0.13379631682322318,0.014218847388917766,-0.11957746943430542
2025-09-22T15:55:00-04:00,434.36,434.63,433.76,434.07,432.54535039109464,NaN,NaN,NaN,NaN,NaN,434.8554999999982,439.86129514224416,429.8497048577522,434.1357092664058,437.47447275039883,441.3127285358363,433.63621696496136,121769,71693.86666666667,47.77715716384404,50.2884483328529,NaN,NaN,NaN,NaN,1.0690284482821408,12.312545714711787,104880820,0.08702779785747991,-0.010792722112455522,-0.09782051996993543
2025-09-23T09:30:00-04:00,439.99,440.97,434.93,435,433.76788540507164,NaN,NaN,NaN,NaN,NaN,434.7306999999982,439.3929320884097,430.0684679115867,435.28923936993266,436.9666666666667,436.9666666666667,436.9666666666667,280522,78145.9,54.49444427795646,51.01471572759802,NaN,NaN,NaN,NaN,1.4855264162619903,15.500725654690445,105161342,0.11339429361490214,0.043922347048692245,-0.06947194656620989
2025-09-23T09:35:00-04:00,434.96,436.54,434.55,435.06,433.76788540507164,NaN,NaN,NaN,NaN,NaN,434.61769999999814,438.95749778865877,430.2779022113375,435.28923936993266,436.30248502432255,437.08381957476604,435.52115047387906,202706,81874.86666666667,54.89752015553103,51.71837300282248,NaN,NaN,NaN,NaN,1.5215602436718487,18.094751606049712,105364048,0.1284384084101244,0.09107606394644563,-0.03736234446367879
2025-09-23T09:40:00-04:00,435.05,436.65,433.89,436.5,433.76788540507164,NaN,NaN,NaN,NaN,NaN,434.5310999999981,438.53108464577724,430.53111535421897,435.28923936993266,436.1262563156133,436.84479357112497,435.40771906010167,190829,85893.1,63.29963627465161,52.984302736332474,NaN,NaN,NaN,NaN,1.610020226266716,19.878708518998607,105554877,0.22337287576768144,0.24185375024592304,0.018480874478241587
2025-09-23T09:45:00-04:00,436.55,438.99,435.8,436.32,433.76788540507164,NaN,NaN,NaN,NaN,NaN,434.4348999999981,438.00354595702584,430.86625404297035,435.28923936993266,436.3112533536969,437.0498891634154,435.57261754397837,171900,87337.3,61.751078191505044,53.90125658015173,NaN,NaN,NaN,NaN,1.7228759243905218,22.26848613313484,105382977,0.25951071937507886,0.3428692736970902,0.08335855432201131
2025-09-23T09:50:00-04:00,436.3,437.9,435.62,436.11,433.76788540507164,NaN,NaN,NaN,NaN,NaN,434.3766999999981,437.73293456373176,431.02046543626443,435.28923936993266,436.33963781641273,437.0357967937308,435.64347883909466,117882,88873.3,59.909651017716406,54.768608171955954,NaN,NaN,NaN,NaN,1.7626705012197683,24.32636915975877,105265095,0.2543955654813371,0.4013530111736827,0.1469574456923456
2025-09-23T09:55:00-04:00,436.06,437.65,435.8,437.57,433.76788540507164,NaN,NaN,NaN,NaN,NaN,434.36789999999803,437.68809643498116,431.0477035650149,435.28923936993266,436.40849046146775,437.0982713477833,435.7187095751522,110942,90732.2,67.2268715917107,55.85563417380188,NaN,NaN,NaN,NaN,1.768908322561211,26.237260541623847,105376037,0.3296876563995782,0.5590670161918183,0.22937935979224014
2025-09-23T10:00:00-04:00,437.53,438.21,436.44,437.42,433.76788540507164,NaN,NaN,NaN,NaN,NaN,434.3486999999981,437.5859363594105,431.11146364058567,435.28923936993266,436.4843294613458,437.1941876261537,435.7744712965379,93439,91696.7,65.89614328828353,56.55392033833807,NaN,NaN,NaN,NaN,1.7689862995211232,28.187866295542946,105282598,0.3479326511942361,0.6642951737850353,0.3163625225907992
2025-09-23T10:05:00-04:00,437.4,437.41,436.1,436.69,433.76788540507164,NaN,NaN,NaN,NaN,NaN,434.319699999998,437.4445925816599,431.19480741833615,435.28923936993266,436.4971050244479,437.1906922190969,435.80351782979886,63179,92098.66666666667,59.7023823584707,56.4760428323993,NaN,NaN,NaN,NaN,1.7369158495553283,29.6490763286247,105219419,0.2916579446431524,0.6809349533947398,0.38927700875158733
2025-09-23T10:10:00-04:00,436.69,437.13,434.96,435.4,433.76788540507164,NaN,NaN,NaN,NaN,NaN,434.28489999999806,437.32087529087767,431.24892470911846,435.28923936993266,436.4476461441875,437.13753415269116,435.75775813568384,98606,93039.83333333333,50.643587283525136,55.93272693405872,NaN,NaN,NaN,NaN,1.7678504317299488,29.90867812484591,105120813,0.15522310689190455,0.583305892366468,0.42808278547456347
2025-09-23T10:15:00-04:00,435.41,435.42,433.66,433.95,NaN,NaN,NaN,439.4315399512636,439.4315399512636,439.4315399512636,434.2332999999981,437.20184012042915,431.26475987956707,435.28923936993266,436.24978449270236,437.1488993038872,435.3506696815175,138035,95626.93333333333,42.785171149513104,55.503865709410135,NaN,NaN,NaN,NaN,1.7672896866063803,29.077575839180327,104982778,-0.03486701956282301,0.3844990110210347,0.4193660305838577
2025-09-23T10:20:00-04:00,433.96,434.9,431.41,431.55,NaN,NaN,NaN,438.3001063171152,NaN,NaN,434.14689999999814,437.17081725524065,431.12298274475563,432.7456505574055,435.8998388025332,437.2703258486512,434.5293517564152,156634,98800.03333333334,33.51516793877896,54.49258846613882,NaN,NaN,NaN,NaN,1.8903404232773497,27.161058898551016,104826144,-0.30916971459971476,0.03290388733421423,0.342073601933929
2025-09-23T10:25:00-04:00,431.49,433.68,431.2,433.5,NaN,NaN,NaN,437.68941966633724,NaN,NaN,434.0770999999981,436.994531810103,431.1596681898932,432.7456505574055,435.66077176205374,437.2161500547243,434.10539346938316,135454,101571.43333333333,44.11071157213874,53.999781557019105,NaN,NaN,NaN,NaN,1.932458964471826,25.501110198951626,104961598,-0.3435643176927979,-0.08738179518206834,0.25618252251072954
2025-09-23T10:30:00-04:00,433.57,434.87,433.39,434.63,NaN,NaN,NaN,437.68941966633724,NaN,NaN,434.0642999999981,436.9662593461205,431.16234065387573,432.7456505574055,435.5927758947033,437.137684618685,434.04786717072164,92339,102815.56666666667,49.166397348094534,53.94113711512285,NaN,NaN,NaN,NaN,1.9001404670095539,24.10235920760781,105053937,-0.2773335863735858,-0.09048446045625269,0.1868491259173331
2025-09-23T10:35:00-04:00,434.6,435.15,433.24,433.5,NaN,NaN,NaN,437.68941966633724,NaN,NaN,434.06949999999813,436.9664599594364,431.17254004055985,432.6582930853916,435.51837195228967,437.065453081248,433.97129082333134,88635,103150.16666666667,44.80191488043677,53.72861980916519,NaN,NaN,NaN,NaN,1.9008447193660118,22.960982230354336,104965302,-0.2951005901440219,-0.1820266117626943,0.11307397838132761
2025-09-23T10:40:00-04:00,433.52,434.4,433.08,433.68,NaN,NaN,NaN,437.68941966633724,NaN,NaN,434.08149999999813,436.966913143132,431.19608685686427,432.6582930853916,435.46699534794965,437.0209700554973,433.913020640402,57085,103579.43333333333,45.62986377889389,53.09543548780358,NaN,NaN,NaN,NaN,1.8593558108398676,21.791352280932667,105022387,-0.2803106377271246,-0.23731431877757814,0.04299631894954646
2025-09-23T10:45:00-04:00,433.6,433.69,431.87,432.18,NaN,NaN,NaN,437.68941966633724,NaN,NaN,434.0692999999981,436.98148681519325,431.157113184803,432.6582930853916,435.3317258391393,436.9669369383358,433.69651473994287,98227,105187.53333333334,40.2162800887723,52.046775483035105,NaN,NaN,NaN,NaN,1.8565446814941622,20.554304950656356,104924160,-0.3524647202192896,-0.39758458132456553,-0.04511986110527595
2025-09-23T10:50:00-04:00,432.18,433.16,431.61,432.46,NaN,NaN,NaN,437.55136145706706,NaN,NaN,434.1102999999982,436.86893329320856,431.3516667067878,432.30863446831336,435.2465027863437,436.9310371529289,433.56196841975844,62987,106180.83333333333,41.60890374249337,50.497437445023806,NaN,NaN,NaN,NaN,1.8346486328160085,19.565602478571105,104987147,-0.36093242318423907,-0.4962853900855748,-0.13535296690133575
2025-09-23T10:55:00-04:00,432.4,433.17,432.07,432.17,NaN,NaN,NaN,437.55136145706706,NaN,NaN,434.14769999999817,436.744654533036,431.55074546696034,431.96390757465065,435.1674299268788,436.8908379077472,433.4440219460104,63301,106793.16666666667,40.5551917049961,48.98344555313031,NaN,NaN,NaN,NaN,1.7821737304720096,18.640126327661953,104923846,-0.3645922766646445,-0.5910933127321414,-0.22650103606749689
2025-09-23T11:00:00-04:00,432.19,432.57,431.35,432.01,NaN,NaN,NaN,436.97691198877396,NaN,NaN,434.1428999999981,436.7547117019899,431.53108829800635,430.40712605972055,435.044810569436,436.8426448695256,433.24697626934636,88831,108074.83333333333,39.95401415394338,47.558042920003665,NaN,NaN,NaN,NaN,1.7420184640097212,18.24748080603044,104835015,-0.3559195318203645,-0.6714004508429525,-0.315480919022588
2025-09-23T11:05:00-04:00,432.06,433.04,430.86,432.82,NaN,NaN,NaN,436.97691198877396,NaN,NaN,434.1392999999982,436.7578904694171,431.52070953057927,429.8626868340615,434.9326560285205,436.77790861253146,433.08740344450956,96280,109469.1,44.44392360254658,45.93068949220623,NaN,NaN,NaN,NaN,1.7733028594375988,18.185496729708767,104931295,-0.2772572463727235,-0.6620524769884923,-0.38479523061576887
2025-09-23T11:10:00-04:00,432.83,433.33,432.52,432.8,NaN,NaN,NaN,436.97691198877396,NaN,NaN,434.12989999999814,436.76423216709907,431.4955678328972,429.8626868340615,434.89042628069285,436.7396291490898,433.0412234122959,50661,109471.86666666667,44.35573082870391,44.39208860223625,NaN,NaN,NaN,NaN,1.7044955123349135,17.875144098444487,104880634,-0.21118721540489943,-0.6487792498718932,-0.43759203446699374
2025-09-23T11:15:00-04:00,432.84,433.33,432.34,433.33,NaN,NaN,NaN,436.97691198877396,NaN,NaN,434.1154999999981,436.7592762777553,431.47172372224094,429.8626868340615,434.8592263404448,436.7088538979506,433.00959878293907,41256,108477.33333333333,47.33801089757848,43.50891921217253,NaN,NaN,NaN,NaN,1.6534601185967062,17.708542673102336,104921890,-0.12089221230899727,-0.5887072998532403,-0.46781508754424306
2025-09-23T11:20:00-04:00,433.32,433.97,433.23,433.66,NaN,NaN,NaN,436.97691198877396,NaN,NaN,434.09969999999817,436.74473339234515,431.4546666076512,430.7422567820433,434.8317207027026,436.66979487455643,432.9936465308488,56743,107544.6,49.164909071249305,43.40329933986711,NaN,NaN,NaN,NaN,1.5882129672683707,16.973430377566554,104978633,-0.032634874224273414,-0.5086086803245848,-0.4759738061003114
2025-09-23T11:25:00-04:00,433.67,433.83,432.32,432.5,NaN,NaN,NaN,436.97691198877396,NaN,NaN,434.06709999999816,436.74974801392335,431.384451986073,430.7422567820433,434.7864234778909,436.6265799044355,432.94626705134624,60849,106073.4,43.457830435952324,43.451346431755624,NaN,NaN,NaN,NaN,1.5826263267492007,16.933740372848124,104917784,-0.04529523820181269,-0.5325928538525773,-0.48729761565076457
2025-09-23T11:30:00-04:00,432.46,433.72,432.4,433.51,NaN,NaN,NaN,436.97691198877396,NaN,NaN,434.0582999999982,436.7453099453822,431.37129005461424,430.7422567820433,434.7519163711894,436.58638116691526,432.91745157546353,58574,105636.56666666667,49.008028568823896,44.55797933390169,NaN,NaN,NaN,NaN,1.5638673034099757,16.896885368466727,104976358,0.018042381963258414,-0.46474463819669154,-0.48278702015994995
2025-09-23T11:35:00-04:00,433.495,433.6,432.81,433.15,NaN,NaN,NaN,436.97691198877396,NaN,NaN,434.0464999999981,436.74415843036724,431.348841569629,430.7422567820433,434.73008503497874,436.56093701119136,432.89923305876613,37850,104413.23333333334,47.22849598631524,44.78067822062859,NaN,NaN,NaN,NaN,1.5085910674521217,16.86266286439829,104938508,0.03822248188548916,-0.4350089178030885,-0.47323139968857764
2025-09-23T11:40:00-04:00,433.13,433.78,432.69,433.55,NaN,NaN,NaN,436.97691198877396,NaN,NaN,434.0572999999981,436.7425688592992,431.37203114069706,430.7879563779249,434.69650172670003,436.5176532196243,432.87535023377575,67185,104061.7,49.42589580546685,44.799213824726614,NaN,NaN,NaN,NaN,1.478691705491254,16.63584712204219,105005693,0.0787087177692613,-0.374845502477001,-0.4535542202462623
2025-09-23T11:45:00-04:00,433.56,434.71,433.36,434.54,NaN,NaN,NaN,436.97691198877396,NaN,NaN,434.0812999999982,436.76194231978644,431.4006576802099,431.64136510233993,434.6836873058604,436.482734364837,432.88464024688386,74187,104195.6,54.478194077088766,45.49037662448747,NaN,NaN,NaN,NaN,1.4694994408133049,15.487812515689631,105079880,0.1672731194566166,-0.24446282092549154,-0.41173594038210815
2025-09-23T11:50:00-04:00,434.55,434.59,433.77,434.26,NaN,NaN,NaN,436.97691198877396,NaN,NaN,434.10989999999816,436.76694082898535,431.45285917101097,431.72509208187194,434.67508742339453,436.45897327923177,432.8912015675573,52418,100976.83333333333,52.86949984356768,46.00749348624988,NaN,NaN,NaN,NaN,1.423106623612354,14.4217803812194,105027462,0.19989960943506146,-0.16186142858828134,-0.3617610380233428
2025-09-23T11:55:00-04:00,434.23,434.36,433.02,433.22,NaN,NaN,NaN,436.97691198877396,NaN,NaN,434.0946999999981,436.7632100050402,431.426189994956,431.72509208187194,434.6526041212553,436.42594817711534,432.8792600653953,58405,98864.7,47.28442604955559,46.51236105487725,NaN,NaN,NaN,NaN,1.4171704362114739,14.124025615966096,104969057,0.1467979293875804,-0.17826362628886727,-0.3250615556764477
2025-09-23T12:00:00-04:00,433.24,434.2,433.24,433.97,NaN,NaN,NaN,436.97691198877396,NaN,NaN,434.1112999999981,436.7661392129995,431.4564607869967,431.72509208187194,434.639567795573,436.4023436166222,432.87679197452377,46237,91055.2,51.28139832561098,47.20325352509993,NaN,NaN,NaN,NaN,1.3859439764820802,13.847539048230887,105015294,0.15664620707126947,-0.12925379683736082,-0.2859000039086303
2025-09-23T12:05:00-04:00,433.95,434.39,433.11,433.14,NaN,NaN,NaN,436.97691198877396,NaN,NaN,434.1092999999981,436.76691096605464,431.45168903394153,431.72509208187194,434.6243279466846,436.37945514002735,432.8692007533419,42597,85718.23333333334,47.03146411038554,47.66584441119919,NaN,NaN,NaN,NaN,1.3783765495905012,13.37160376514849,104972697,0.10424509850381064,-0.155593630778867,-0.25983872928267765
2025-09-23T12:10:00-04:00,433.17,433.56,432.78,433.34,NaN,NaN,NaN,436.97691198877396,NaN,NaN,434.0956999999981,436.76194530885147,431.4294546911447,431.72509208187194,434.5945524108243,436.3425727656353,432.8465320560133,66495,81573.76666666666,48.14662106484183,48.251030619120506,NaN,NaN,NaN,NaN,1.3356353674768962,13.25773607047635,105039192,0.08106883137099924,-0.1585026900689286,-0.23957152143992783
2025-09-23T12:15:00-04:00,433.36,435.46,433.33,434.95,NaN,NaN,NaN,436.97691198877396,NaN,NaN,434.1092999999981,436.78587991605673,431.43272008393944,432.2093149733878,434.59417765084424,436.3195448524538,432.8688104492347,82505,78593.93333333333,56.14991911850912,49.08717315597497,NaN,NaN,NaN,NaN,1.3923756983714033,13.34410278168687,105121697,0.1672232006079415,-0.030542520680000962,-0.19776572128794245
2025-09-23T12:20:00-04:00,434.97,434.97,433.89,434.58,NaN,NaN,NaN,436.97691198877396,NaN,NaN,434.1294999999981,436.80473924298167,431.4542607570145,432.2093149733878,434.5922064058759,436.3026794297948,432.881733381957,56284,76540.66666666667,54.083963573254486,49.78204692344287,NaN,NaN,NaN,NaN,1.3700631484877346,13.424300442096637,105065413,0.19064743037736687,0.04054356668376613,-0.15010386369360074
2025-09-23T12:25:00-04:00,434.63,434.88,433.92,434.15,NaN,NaN,NaN,436.97691198877396,NaN,NaN,434.1460999999981,436.8113229112811,431.48087708871515,432.2093149733878,434.58885306336373,436.28915434799336,432.8885517787341,40164,74181.4,51.703072093386005,50.09383700885769,NaN,NaN,NaN,NaN,1.3407729235957522,13.49876969819142,105025249,0.1692621032951358,0.061473765425319016,-0.10778833786981679
2025-09-23T12:30:00-04:00,434.15,435.3,434.15,435.12,NaN,NaN,NaN,436.97691198877396,NaN,NaN,434.1806999999981,436.8506752895565,431.5107247104398,432.3310492663745,434.5930126828725,436.28038295329185,432.9056424124531,52067,72802.33333333333,56.36915717754862,50.60842615930765,NaN,NaN,NaN,NaN,1.327146286196058,13.939848461394488,105077316,0.20987101504007058,0.15455043093027143,-0.05532058410979914
2025-09-23T12:35:00-04:00,435.08,435.72,434.3,435.33,NaN,NaN,NaN,436.97691198877396,NaN,NaN,434.2174999999981,436.8990773356227,431.5359226643735,432.63483941309966,434.6036747084423,436.27541519521026,432.9319342216744,69674,73018.83333333333,57.3302936218249,51.59931638686998,NaN,NaN,NaN,NaN,1.3337786943249121,14.702433243065851,105146990,0.2382281653998848,0.24246462264005686,0.004236457240172055
2025-09-23T12:40:00-04:00,435.34,436.05,434.72,434.94,NaN,NaN,NaN,436.97691198877396,NaN,NaN,434.2450999999981,436.9274471003743,431.5627528996219,432.91687153047974,434.61870618641655,436.27328764144744,432.96412473138565,83237,72506.53333333334,54.91104155965746,52.02096017192952,NaN,NaN,NaN,NaN,1.3335087875874174,15.67700014130037,105063753,0.21858605193159203,0.27746902215466207,0.058882970223070055
2025-09-23T12:45:00-04:00,434.94,435.4,434.76,435.26,NaN,NaN,NaN,436.97691198877396,NaN,NaN,434.2702999999981,436.96660147554155,431.5739985244546,432.91687153047974,434.62411683555604,436.2709369083336,432.97729676277845,36763,69130.8,56.531873300025566,52.68548712290883,NaN,NaN,NaN,NaN,1.2839724456168866,16.581955118232422,105100516,0.21470094132396045,0.3272591468780206,0.11255820555406017
2025-09-23T12:50:00-04:00,435.27,435.78,435.07,435.55,NaN,NaN,NaN,436.97691198877396,NaN,NaN,434.30449999999814,437.0214028335144,431.5875971664819,433.163797779507,434.63480966513384,436.27386212380253,432.99575720646516,45529,65427.3,58.005189808821044,53.29829383743412,NaN,NaN,NaN,NaN,1.2429744137871075,17.739538139517872,105146045,0.2184918019741124,0.38567295802170065,0.16718115604758826
2025-09-23T12:55:00-04:00,435.5,435.55,434.71,435,NaN,NaN,NaN,436.97691198877396,NaN,NaN,434.3164999999982,437.04027550589166,431.59272449410474,433.163797779507,434.64114716906806,436.2695319929195,433.01276234521663,51032,62613.23333333333,54.24965746745917,53.281969793889154,NaN,NaN,NaN,NaN,1.2141905270880307,18.25025689235609,105095013,0.17279026490106317,0.38316898717391723,0.21037872227285406
2025-09-23T13:00:00-04:00,435,435.04,432.95,433.05,NaN,NaN,NaN,436.97691198877396,NaN,NaN,434.27749999999816,437.0168095857721,431.53819041422423,433.163797779507,434.61946916704073,436.2356984603171,433.00323987376436,83958,62333.86666666667,43.49690565374796,52.6124987803306,NaN,NaN,NaN,NaN,1.2767483465817453,17.29628291631344,105011055,0.008725048543393649,0.22128503295209612,0.21255998440870247
2025-09-23T13:05:00-04:00,433.12,434.27,432.98,434.24,NaN,NaN,NaN,436.97691198877396,NaN,NaN,434.2467999999982,436.9524901239234,431.541109876073,433.163797779507,434.607089536643,436.21359364939866,433.00058542388734,59302,61356.1,50.00887788653057,52.80710248297167,NaN,NaN,NaN,NaN,1.2776948932544752,16.410449938559555,105070357,-0.020560080920952628,0.18685988325751168,0.2074199641784643
2025-09-23T13:10:00-04:00,434.19,435.09,433.65,434.97,NaN,NaN,NaN,436.97691198877396,NaN,NaN,434.2365999999982,436.92742176418,431.5457782358164,433.163797779507,434.6065296317035,436.20086812564887,433.0121911377581,57965,61385.433333333334,53.54580286774543,52.9688456645527,NaN,NaN,NaN,NaN,1.2892881151648699,15.743950758993508,105128322,0.006858247060306605,0.21599277300384756,0.20913452594354096
2025-09-23T13:15:00-04:00,435.02,435.51,434.82,435.13,NaN,NaN,NaN,436.97691198877396,NaN,NaN,434.2549999999982,436.95739967559524,431.5526003244011,433.163797779507,434.61417896114773,436.1986284304151,433.02972949188035,54477,59927.1,54.30884221255235,53.488658386136045,NaN,NaN,NaN,NaN,1.246481821224522,15.518222245139787,105182799,0.03198818987213975,0.24911976328371566,0.2171315734115759
2025-09-23T13:20:00-04:00,435.19,435.84,435,435.1,NaN,NaN,NaN,436.97691198877396,NaN,NaN,434.2761999999982,436.98813477918634,431.56426522081006,433.163797779507,434.6229145368957,436.19934853905426,433.0464805347371,49272,59469.933333333334,54.12931080881606,53.91599336784849,NaN,NaN,NaN,NaN,1.2174474054227686,15.606649130704456,105133527,0.04216820038503949,0.26984182389287525,0.22767362350783577
2025-09-23T13:25:00-04:00,435.09,435.2,433.64,433.67,NaN,NaN,NaN,436.97691198877396,NaN,NaN,434.2593999999982,436.9757369758682,431.54306302412823,433.163797779507,434.6162337589549,436.18195017399614,433.0505173439136,59040,59327.9,46.276427055516365,53.21074393477759,NaN,NaN,NaN,NaN,1.2419154478925711,14.752874023566495,105074487,-0.04699660921461013,0.1689278619895731,0.21592447120418323
2025-09-23T13:30:00-04:00,433.66,434.77,433.35,433.74,NaN,NaN,NaN,436.97691198877396,NaN,NaN,434.24679999999825,436.9668101188152,431.5267898811813,433.163797779507,434.6066226246427,436.16296573210093,433.05027951718444,58885,58329.7,46.68418218421395,52.682188121274685,NaN,NaN,NaN,NaN,1.2546357730430988,14.22567815225644,105133372,-0.09792105026936665,0.09352315836747493,0.19144420863684158
2025-09-23T13:35:00-04:00,433.79,433.91,427.85,428,NaN,NaN,NaN,435.45651469744354,NaN,NaN,434.1253999999982,437.3594073232176,430.89139267677876,433.163797779507,434.31155215755456,436.1998103215083,432.4232939936008,272889,64216.666666666664,27.950512579014344,50.985576727391,NaN,NaN,NaN,NaN,1.597876074968592,16.652551555010884,104860483,-0.49276507071023434,-0.4245121297509513,0.06825294095928301
2025-09-23T13:40:00-04:00,427.98,428.56,424.72,425.58,NaN,NaN,NaN,431.53212766574154,NaN,NaN,433.93699999999825,437.9491739750884,429.9248260249081,433.1014806851111,433.9089926255323,436.44968122135225,431.3683040297123,228909,70158.26666666666,23.642854969475735,48.64798371252865,NaN,NaN,NaN,NaN,1.758027783899405,19.693001381844926,104631574,-0.8694750895335459,-1.0185909209576494,-0.14911583142410345
2025-09-23T13:45:00-04:00,425.54,428.59,424.85,428.53,NaN,NaN,NaN,431.53212766574154,NaN,NaN,433.8063999999982,438.0804234167222,429.53237658327413,433.1014806851111,433.7410734450971,436.45551077526585,431.0266361149283,119396,72762.93333333333,36.49192465466373,47.15952878630286,NaN,NaN,NaN,NaN,1.8995972279065867,22.49136339559181,104750970,-0.8703887414798099,-1.237101758273866,-0.366713016794056
2025-09-23T13:50:00-04:00,428.42,429.76,427.54,427.69,NaN,NaN,NaN,431.53212766574154,NaN,NaN,433.6301999999981,438.16401515355943,429.0963848464368,433.1014806851111,433.6015741647686,436.414685776142,430.78846255339516,123914,75001.96666666666,34.70127984324584,45.71597437798774,NaN,NaN,NaN,NaN,1.922483140198971,24.13375912284837,104627056,-0.8755977697739089,-1.4612102290114422,-0.5856124592375332
2025-09-23T13:55:00-04:00,427.73,428.9,427.59,428.21,NaN,NaN,NaN,431.53212766574154,NaN,NaN,433.46799999999814,438.18199278813546,428.7540072118608,433.1014806851111,433.5170463127048,436.3868217463821,430.6472708790275,76894,75536.8,36.769736439080226,44.3043931736345,NaN,NaN,NaN,NaN,1.8787343444704732,25.6588408695866,104703950,-0.7944383036522292,-1.5786603388028198,-0.7842220351505905
2025-09-23T14:00:00-04:00,428.22,429.27,427.55,428.47,NaN,NaN,NaN,431.53212766574154,NaN,NaN,433.31519999999824,438.16992180936325,428.46047819063324,433.1014806851111,433.44265951491445,436.3560869017486,430.5292321280803,72469,75999.96666666666,37.83015234584863,42.86331906913647,NaN,NaN,NaN,NaN,1.8673961770082943,26.763501147348776,104776419,-0.6781811587905516,-1.63194848363878,-0.9537673248482285
2025-09-23T14:05:00-04:00,428.53,428.67,426.97,427.13,NaN,NaN,NaN,431.53212766574154,NaN,NaN,433.1063999999982,438.1070203781679,428.1057796218285,433.1014806851111,433.36303858661915,436.33494711782123,430.3911300554171,68351,77016.66666666667,34.60869355059462,41.46039307507473,NaN,NaN,NaN,NaN,1.8554393072219868,27.991807375700123,104708068,-0.6465824105545841,-1.7619953380414586,-1.1154129274868745
2025-09-23T14:10:00-04:00,427.18,427.21,425.49,425.95,NaN,NaN,NaN,431.5310331184214,NaN,NaN,432.87699999999813,438.11190783173055,427.6420921682657,432.2291845480889,433.24591994818024,436.32987022707766,430.1619696692828,83712,77567.56666666667,32.022662026987945,40.64080424459187,NaN,NaN,NaN,NaN,1.845765070991843,29.600253213347337,104624356,-0.6580178455002266,-1.9379352343621576,-1.279917388861931
2025-09-23T14:15:00-04:00,426,426.14,424.27,424.44,NaN,NaN,NaN,430.4055316130386,NaN,NaN,432.63199999999813,438.2618916514206,427.00210834857563,431.6833476384711,433.0493133664032,436.3474538401707,429.75117289263574,123993,79227.76666666666,29.033012161658277,39.142528121386704,NaN,NaN,NaN,NaN,1.8474961373495689,31.426128824294018,104500363,-0.7153868816440432,-2.174150990916985,-1.4587641092729418
2025-09-23T14:20:00-04:00,424.41,425.22,423.73,424.7,NaN,NaN,NaN,429.6423256306278,NaN,NaN,432.4179999999982,438.4124040576685,426.4235959423279,428.4106781107769,432.86127690804784,436.3541121111228,429.3684417049729,118369,81426.13333333333,30.240676497914265,37.47787623782733,NaN,NaN,NaN,NaN,1.8219606989674575,33.258944658346614,104618732,-0.683951053096217,-2.313702925643213,-1.629751872546996
2025-09-23T14:25:00-04:00,424.65,426.43,424.65,425.59,NaN,NaN,NaN,429.6423256306278,NaN,NaN,432.2507999999982,438.52479565242135,425.97680434757507,423.6297102033394,432.7534791405026,436.3305810558721,429.1763772251331,80140,82150.63333333333,34.35851766439342,36.05285305581598,NaN,NaN,NaN,NaN,1.8189635061840697,33.90849427002919,104698872,-0.5567379828692944,-2.325674351133614,-1.7689363682643195
2025-09-23T14:30:00-04:00,425.57,426.6,425.35,426.53,NaN,NaN,NaN,429.6423256306278,NaN,NaN,432.1503999999983,438.6235457087198,425.67725429127677,423.6297102033394,432.6584022854328,436.2955707634357,429.02123380742995,79452,83257.8,38.488482039845096,34.93565100088948,NaN,NaN,NaN,NaN,1.7783232557423503,34.36937579460079,104778324,-0.37170251075206195,-2.233564506704397,-1.861861995952335
2025-09-23T14:35:00-04:00,426.55,426.78,425.8,426.12,NaN,NaN,NaN,429.6423256306278,NaN,NaN,432.0027999999982,438.6794770662158,425.32612293378065,423.6297102033394,432.56091011079445,436.25484442873494,428.86697579285396,84894,84667.7,37.38366469224038,34.300453689226906,NaN,NaN,NaN,NaN,1.7213001660464653,34.63989078151406,104693430,-0.2454316034851587,-2.1686515003087834,-1.9232198968236247
2025-09-23T14:40:00-04:00,426.15,427.32,425.63,427.21,NaN,NaN,NaN,429.6423256306278,NaN,NaN,431.8543999999982,438.62015395405484,425.0886460459415,423.6297102033394,432.49572627626367,436.21988477667946,428.77156777584787,63142,84555.93333333333,42.1389171967283,33.975791904406506,NaN,NaN,NaN,NaN,1.7190644399002892,34.414574866221386,104756572,-0.06632663262281535,-2.006128187602144,-1.9398015549793286
2025-09-23T14:45:00-04:00,427.16,427.56,426.87,427.03,NaN,NaN,NaN,429.6423256306278,NaN,NaN,431.72499999999826,438.6064094491164,424.8435905508801,423.9716414702306,432.43271462982364,436.17950457054087,428.6859246891064,67530,84056.76666666666,41.57738610289159,34.94914001325488,NaN,NaN,NaN,NaN,1.6455598370502684,33.99319665886406,104689042,0.05560746596951516,-1.8702922225174348,-1.92589968848695
2025-09-23T14:50:00-04:00,427.07,427.36,426.29,426.56,NaN,NaN,NaN,429.6423256306278,NaN,NaN,431.5825999999982,438.58981777645437,424.575382223542,423.9716414702306,432.3816214552357,436.1500335459649,428.6132093645065,51822,83908.03333333334,40.075691903641406,36.12291407998101,NaN,NaN,NaN,NaN,1.6044484201181057,33.88543626921239,104637220,0.11668211930178773,-1.7800470393597152,-1.896729158661503
2025-09-23T14:55:00-04:00,426.59,426.95,425.66,425.74,NaN,NaN,NaN,429.6423256306278,NaN,NaN,431.45379999999824,438.6466485488255,424.26095145117097,423.9716414702306,432.30427025205364,436.1127101375101,428.4958303665972,72222,84976.63333333333,37.52891442611252,36.19698477794163,NaN,NaN,NaN,NaN,1.5819878186810956,34.07950333778937,104564998,0.11380749265125778,-1.7544697928474307,-1.8682772854986884
2025-09-23T15:00:00-04:00,425.74,427.41,425.63,426.7,NaN,NaN,NaN,429.6423256306278,NaN,NaN,431.3385999999983,438.6468747735915,424.03032522640507,423.9716414702306,432.24230696793717,436.07611268747024,428.4085012484041,64012,85374.8,42.16293819985265,36.729960374842115,NaN,NaN,NaN,NaN,1.5961315459181622,33.813176382978,104629010,0.18433744018886644,-1.6378554852626053,-1.8221929254514717
2025-09-23T15:05:00-04:00,426.62,427.41,426.4,427.03,NaN,NaN,NaN,429.6423256306278,NaN,NaN,431.2357999999982,438.638396399003,423.83320360099344,424.03648834620645,432.19196709750577,436.04195353523414,428.3419806597774,56753,84944.1,43.70871836958007,37.22560194130639,NaN,NaN,NaN,NaN,1.5542650069240111,33.565872782081726,104685763,0.25655338583060017,-1.5015011931632216,-1.7580545789938218
2025-09-23T15:10:00-04:00,427.02,427.75,426.98,427.66,NaN,NaN,NaN,429.6423256306278,NaN,NaN,431.14879999999823,438.6149311431275,423.682668856869,424.6661906769652,432.14141722840856,436.00152321967755,428.28131123713956,64513,84319.96666666666,46.64071075765647,37.85492754214982,NaN,NaN,NaN,NaN,1.4982460778580091,32.984764319985544,104750276,0.34460096530259565,-1.3273033723655772,-1.6719043376681728
2025-09-23T15:15:00-04:00,427.7,429.14,427.7,428.89,NaN,NaN,NaN,429.6423256306278,NaN,NaN,431.0701999999981,438.5470404989508,423.5933595010454,425.93295254157215,432.0949187938033,435.951037456684,428.2388001309226,79758,85753.13333333333,51.90752580570495,39.090558417514835,NaN,NaN,NaN,NaN,1.4969427865824343,31.168357744509557,104830034,0.47546108952713473,-1.0775779757592545,-1.5530390652863892
2025-09-23T15:20:00-04:00,428.93,428.94,427.15,427.97,NaN,NaN,NaN,429.6423256306278,NaN,NaN,430.9735999999982,438.4832830936128,423.46391690638364,425.93295254157215,432.0368473402037,435.8957343156202,428.17796036478717,88398,87182.1,48.08447304215375,40.23783063288382,NaN,NaN,NaN,NaN,1.5178754446836904,29.859731399575207,104741636,0.48800373423091914,-0.9430343974977404,-1.4310381317286596
2025-09-23T15:25:00-04:00,427.95,428.37,427.58,428.19,NaN,NaN,NaN,429.6423256306278,NaN,NaN,430.8707999999982,438.3893592666726,423.3522407333238,425.93295254157215,432.0121198186929,435.8717549761337,428.1524846612521,38680,86770.36666666667,49.05082789428346,41.667674613785614,NaN,NaN,NaN,NaN,1.4658843414919998,28.64457836499331,104780316,0.4973696463292103,-0.8093260738171466,-1.306695720146357
2025-09-23T15:30:00-04:00,428.22,429.06,427.87,428.75,NaN,NaN,NaN,429.6423256306278,NaN,NaN,430.7725999999982,438.271107382567,423.2740926174294,425.93419170128493,431.9711573109829,435.8259918555485,428.1163227664173,74952,86470.16666666667,51.524335042322036,43.18793593838617,NaN,NaN,NaN,NaN,1.4461783170997138,26.89642251347574,104855268,0.5248178670518362,-0.6506733863315617,-1.1754912533833979
2025-09-23T15:35:00-04:00,428.69,429.44,428.38,429.2,NaN,NaN,NaN,429.6423256306278,NaN,NaN,430.7065999999982,438.2012195211262,423.21198047887026,426.40935336102797,431.92497599227585,435.76724526187064,428.08270672268105,99958,87825.36666666667,53.4788355403227,44.55367292952398,NaN,NaN,NaN,NaN,1.4185941515925915,25.00189415972261,104955226,0.5539447383226381,-0.4830603304801002,-1.0370050688027384
2025-09-23T15:40:00-04:00,429.22,429.42,428.25,428.92,NaN,NaN,NaN,429.6423256306278,NaN,NaN,430.61479999999824,438.08221212511324,423.14738787488324,426.41048268882236,431.89964275826287,435.73602093851736,428.0632645780084,53536,87677.73333333334,52.071990100547126,45.5239235052884,NaN,NaN,NaN,NaN,1.4008374264788361,23.302783187165442,104901690,0.5347474298172614,-0.36857078153116163,-0.903318211348423
2025-09-23T15:45:00-04:00,428.95,429.2,428.15,429.12,NaN,NaN,NaN,429.6423256306278,NaN,NaN,430.5341999999982,437.9773736138898,423.09102638610653,426.41048268882236,431.8602673194009,435.6876680908879,428.03286654791395,83888,88658.1,53.02261659883002,46.64099149861624,NaN,NaN,NaN,NaN,1.3757776103017771,21.81628344079991,104985578,0.5156814973285941,-0.2587163396876804,-0.7743978370162745
2025-09-23T15:50:00-04:00,429.16,429.32,428.21,428.9,NaN,NaN,NaN,429.6423256306278,NaN,NaN,430.4411999999982,437.84743266218607,423.0349673378104,426.41890892084626,431.8023092114842,435.6159793287072,427.9886390942612,126944,91247.16666666667,51.80538616171059,47.33145356754354,NaN,NaN,NaN,NaN,1.3567934952802225,20.315631130655092,104858634,0.46971861522063774,-0.18724956799047732,-0.656968183211115
2025-09-23T15:55:00-04:00,428.92,428.92,425.54,425.81,NaN,NaN,NaN,429.6423256306278,NaN,NaN,430.2665999999982,437.6896835753432,422.8435164246532,426.41890892084626,431.65610518023084,435.50824275126536,427.8039676091963,199365,95924.66666666667,38.452920730319825,47.1082774695027,NaN,NaN,NaN,NaN,1.501308245617349,20.924184944263047,104659269,0.22507941750686367,-0.37561891132753544,-0.6006983288343991
2025-09-24T09:30:00-04:00,429.81,433.23,429.04,433.17,425.78371825990985,425.78371825990985,425.78371825990985,NaN,NaN,NaN,430.24479999999824,437.6271348506023,422.86246514939415,426.41890892084626,431.81333333333333,431.81333333333333,431.81333333333333,315720,104485.83333333333,62.9487935709065,48.74207044573592,NaN,NaN,NaN,NaN,1.924071942358968,20.40127065310763,104974989,0.5351197305356676,0.06820133433518549,-0.46691839620048214
2025-09-24T09:35:00-04:00,433.17,436,433.08,433.82,429.03377652082304,NaN,NaN,NaN,NaN,NaN,430.2567999999982,437.66036070053565,422.8532392994607,429.00504136747327,433.19266833381994,434.4285410312676,431.95679563637225,393273,108498.63333333333,64.30015652266451,50.65430202406106,NaN,NaN,NaN,NaN,1.9952096607618999,21.06145470940181,105368262,0.7471334191178004,0.46699837769676833,-0.28013504142103207
2025-09-24T09:40:00-04:00,433.74,435.29,432.76,434.05,429.03377652082304,NaN,NaN,NaN,NaN,NaN,430.2583999999981,437.6652037483681,422.8515962516281,429.00504136747327,433.3796488388093,434.52415213634345,432.2351455412752,202801,107628.36666666667,64.78953023509767,52.270487169435704,NaN,NaN,NaN,NaN,2.0334089707074807,21.465417595745066,105571063,0.8580855237014011,0.7924718632057193,-0.06561366049568182
2025-09-24T09:45:00-04:00,434.12,435.07,433.41,434.5,429.03377652082304,NaN,NaN,NaN,NaN,NaN,430.28559999999817,437.7443389394397,422.82686106055667,429.00504136747327,433.5016803068027,434.6160284036613,432.38733220994413,134872,108144.23333333334,65.7779683295021,53.846862166573,NaN,NaN,NaN,NaN,2.0067369013712297,21.840525990206665,105705935,0.9119620282195766,1.074338874778789,0.16237684655921236
2025-09-24T09:50:00-04:00,434.54,437.74,434.42,436.23,430.3078619796528,NaN,NaN,NaN,NaN,NaN,430.34339999999816,437.9394480360964,422.7473519638999,431.0249811801463,434.0502608658181,435.50748241798505,432.5930393136511,276083,113216.53333333334,69.3412516055443,55.46832936999356,NaN,NaN,NaN,NaN,2.100541408416141,23.127374476628713,105982018,1.0068484207146295,1.4209373724524994,0.4140889517378698
2025-09-24T09:55:00-04:00,436.22,438.6,435.99,437.41,431.4293227987594,NaN,NaN,NaN,NaN,NaN,430.3925999999981,438.137762939989,422.6474370600072,431.9229849441171,434.4830926738683,436.2372914685045,432.72889387923215,200870,117349.06666666667,71.51952495070128,56.86918645177901,NaN,NaN,NaN,NaN,2.136931307814989,24.573843288775326,106182888,1.0850703886981226,1.770426937610523,0.6853565489124005
2025-09-24T10:00:00-04:00,437.39,437.39,435.1,435.32,431.4293227987594,NaN,NaN,NaN,NaN,NaN,430.40739999999806,438.1872630429568,422.62753695703935,431.9229849441171,434.620620230032,436.34313597260444,432.89810448745953,159219,120240.73333333334,62.983880222158724,57.93342982177936,NaN,NaN,NaN,NaN,2.149293357256776,25.28962970215502,106023669,0.9375900378371697,1.8573440962088625,0.9197540583716929
2025-09-24T10:05:00-04:00,435.38,435.95,434.42,435.65,431.4293227987594,NaN,NaN,NaN,NaN,NaN,430.43739999999815,438.28602363518706,422.58877636480923,431.9229849441171,434.66068357382875,436.34265744401273,432.97870970364477,99247,121270.6,63.72013762995563,58.98123766004166,NaN,NaN,NaN,NaN,2.1050581174527183,25.49295795486225,106122916,0.8086767988844497,1.930600056977255,1.1219232580928054
2025-09-24T10:10:00-04:00,435.66,438.43,435.66,438.25,431.4293227987594,NaN,NaN,NaN,NaN,NaN,430.4999999999982,438.5445022224207,422.45549777757566,432.27016829138796,434.8726979916942,436.650186051142,433.09520993224646,146788,123373.13333333333,68.95881000983475,60.22655730057827,NaN,NaN,NaN,NaN,2.1532682519203834,26.495779801276996,106269704,0.8411818698389661,2.173400595391513,1.3322187255525468
2025-09-24T10:15:00-04:00,438.19,438.7,436.5,437.95,431.60434465809004,NaN,NaN,NaN,NaN,NaN,430.55239999999816,438.7546509694925,422.3501490305038,432.6721346331103,435.04766408312736,436.90024952780556,433.19507863844916,126447,123454.93333333333,67.74331097752454,61.245448403235535,NaN,NaN,NaN,NaN,2.156606233926069,27.505810649839084,106143257,0.7861683920132607,2.314929215569123,1.528760823555862
2025-09-24T10:20:00-04:00,437.95,439.52,437.88,438.92,432.75323808272225,NaN,NaN,NaN,NaN,NaN,430.63199999999824,439.07669253474967,422.1873074652468,433.87770770648825,435.32229383442694,437.3537571077631,433.2908305610908,163560,124961.3,69.60861859084703,62.49806472397125,NaN,NaN,NaN,NaN,2.1197057886456347,28.682583463779487,106306817,0.7584404769987783,2.476811419804335,1.7183709428055567
2025-09-24T10:25:00-04:00,438.9,440.55,438.83,440.45,433.7789999880531,NaN,NaN,NaN,NaN,NaN,430.7357999999982,439.52600554062144,421.945594459375,435.17616616519064,435.78426245256566,438.1582127077536,433.4103121973777,246462,130505.36666666667,72.32689118313763,63.87694147999322,NaN,NaN,NaN,NaN,2.0911553751709486,30.058649340971133,106553279,0.7832774197425407,2.6974677174837325,1.9141902977411918
2025-09-24T10:30:00-04:00,440.39,440.44,438.4,438.95,433.7789999880531,NaN,NaN,NaN,NaN,NaN,430.8037999999982,439.792289430739,421.8153105692574,435.17616616519064,435.939777878095,438.368890741844,433.51066501434605,115358,131702.23333333334,66.08613218424723,64.89699476731728,NaN,NaN,NaN,NaN,2.0882157055158816,31.01036670689748,106437921,0.644606234351063,2.7199480906800204,2.0753418563289574
2025-09-24T10:35:00-04:00,438.945,440.4,438.11,438.58,433.7789999880531,NaN,NaN,NaN,NaN,NaN,430.87539999999825,440.0515283429625,421.699271657034,435.17616616519064,436.0605300332173,438.5158488273271,433.60521123910746,104943,132370.53333333333,64.60531645164093,66.76502303312591,NaN,NaN,NaN,NaN,2.1026288694076016,31.6696264226159,106332978,0.4813654667201863,2.6770486897291903,2.195683223009004
2025-09-24T10:40:00-04:00,438.6,439.7,437.9,439.57,433.7789999880531,NaN,NaN,NaN,NaN,NaN,431.00579999999826,440.48222809534985,421.52937190464667,435.17616616519064,436.181585334306,438.6580861450396,433.70508452357245,113079,134035.1,66.75202942338774,67.03668273687458,NaN,NaN,NaN,NaN,2.0810125215927737,32.1134535342887,106446057,0.3969772052384841,2.691904729557109,2.294927524318625
2025-09-24T10:45:00-04:00,439.54,440.17,438.59,439.7,433.7789999880531,NaN,NaN,NaN,NaN,NaN,431.11499999999825,440.8600149310454,421.3699850689511,435.20127766126205,436.2866919078263,438.7915580128679,433.78182580278474,91927,134848.33333333334,67.03476790774249,67.23201212152301,NaN,NaN,NaN,NaN,2.0452259129075787,32.69830168118601,106537984,0.3106479568619638,2.6832374703960795,2.3725895135341157
2025-09-24T10:50:00-04:00,439.705,440.29,438.8,438.98,433.7789999880531,NaN,NaN,NaN,NaN,NaN,431.1951999999983,441.12995534908544,421.26044465091115,435.57002212900966,436.36954675711047,438.889966257518,433.84912725670296,80179,135793.56666666668,63.7987864146974,67.16124470578013,NaN,NaN,NaN,NaN,2.0055669191284666,33.28653454351802,106457805,0.17267461357870983,2.588432780507503,2.4157581669287933
2025-09-24T10:55:00-04:00,438.95,439.61,438.02,438.24,433.7789999880531,NaN,NaN,NaN,NaN,NaN,431.2573999999983,441.32793191077917,421.18686808921746,435.57002212900966,436.42423645163785,438.9379258169452,433.9105470863305,73882,135848.9,60.56287722598249,66.78873819838587,NaN,NaN,NaN,NaN,1.9758835677621498,33.13798298274902,106383923,0.007894629116222074,2.425626453324071,2.417731824207849
2025-09-24T11:00:00-04:00,438.29,438.6,437.76,438.4,433.7789999880531,NaN,NaN,NaN,NaN,NaN,431.3233999999983,441.53605302289714,421.11074697709944,435.57002212900966,436.47689860934327,438.97294811580036,433.98084910288617,90260,136723.83333333334,61.02320060006083,66.19459169799418,NaN,NaN,NaN,NaN,1.8947490272077128,32.77346491145238,106474183,-0.10763129565569951,2.2831927046382248,2.3908240002939243
2025-09-24T11:05:00-04:00,438.38,439.9,438.35,439.75,433.7789999880531,NaN,NaN,NaN,NaN,NaN,431.44499999999834,441.9082318145916,420.9817681854051,435.86357133005293,436.53505427760103,439.03828293241713,434.03182562278494,65153,137003.83333333334,64.76071879741457,65.71181982990228,NaN,NaN,NaN,NaN,1.870124096692873,33.02707732550842,106539336,-0.11004133671183869,2.253272329404126,2.363313666115965
2025-09-24T11:10:00-04:00,439.8,439.87,438.57,439.08,433.7789999880531,NaN,NaN,NaN,NaN,NaN,431.5517999999983,442.213680277226,420.8899197227706,435.99085706404236,436.5761922231531,439.0812447915163,434.0711396547899,50689,136543.03333333333,61.60347533327139,65.61321948069603,NaN,NaN,NaN,NaN,1.829400946929097,33.26257456713188,106488647,-0.17008706938540374,2.1507048293842104,2.320791898769614
2025-09-24T11:15:00-04:00,439.07,439.5,438.44,438.83,433.7789999880531,NaN,NaN,NaN,NaN,NaN,431.7683999999983,442.57194487036503,420.96485512963153,435.99085706404236,436.6084781668643,439.1112179338652,434.1057383998634,45340,135395.76666666666,60.41981874471471,65.37748241746455,NaN,NaN,NaN,NaN,1.7744437364341616,33.35288578471984,106443307,-0.2359189588086119,2.0258932002588494,2.2618121590674614
2025-09-24T11:20:00-04:00,438.81,439.76,438.75,439.53,433.964142499992,NaN,NaN,NaN,NaN,NaN,432.04739999999833,442.9175844034875,421.17721559650914,436.3483485209871,436.66547366680317,439.1726918436007,434.1582554900056,70068,134784.76666666666,62.58742700980193,64.92238363174792,NaN,NaN,NaN,NaN,1.7198406124031496,33.56586563256802,106513375,-0.24076199510504992,1.960859665186149,2.201621660291199
2025-09-24T11:25:00-04:00,439.55,439.63,438.77,439.33,434.03236329544694,NaN,NaN,NaN,NaN,NaN,432.26339999999834,443.2737323185874,421.2530676814093,436.47067881678964,436.70200643938637,439.2099735606735,434.1940393180992,48391,135108.46666666667,61.55025798923583,64.48002270401301,NaN,NaN,NaN,NaN,1.6584234258029256,33.76363263414133,106464984,-0.2640116719945498,1.8716070702980119,2.1356187422925617
2025-09-24T11:30:00-04:00,439.31,440.23,438.84,439,434.41271041838115,NaN,NaN,NaN,NaN,NaN,432.4895999999983,443.5792354929254,421.39996450707116,437.00754305343173,436.7649739114257,439.2757302811455,434.25421754170594,82961,135375.43333333332,59.78967201800568,63.77866937738148,NaN,NaN,NaN,NaN,1.6392503239598626,34.26018277994298,106382023,-0.305274048422846,1.7540261817640044,2.0593002301868504
2025-09-24T11:35:00-04:00,439.07,440.51,438.67,438.75,434.4496326720912,NaN,NaN,NaN,NaN,NaN,432.70039999999835,443.8571235049422,421.5436764950545,437.0120344427454,436.8327937822895,439.3435536380359,434.3220339265431,95755,135235.33333333334,58.42620146336781,62.785762968826496,NaN,NaN,NaN,NaN,1.6535895865341563,34.862806802091974,106286268,-0.34986219959045073,1.621972480698787,1.9718346802892377
2025-09-24T11:40:00-04:00,438.73,439.17,438.21,438.26,434.4496326720912,NaN,NaN,NaN,NaN,NaN,432.8961999999984,444.0926350686111,421.69976493138563,437.0120344427454,436.85948664498545,439.3596406088732,434.3593326810977,56850,135345.8,55.743015308156295,62.04696890624858,NaN,NaN,NaN,NaN,1.6040474732102905,34.85328522763214,106229418,-0.4087163299646277,1.460939267833453,1.8696555977980807
2025-09-24T11:45:00-04:00,438.24,438.28,435.8,436.11,434.4496326720912,NaN,NaN,NaN,NaN,NaN,433.07579999999837,444.1842422600882,421.96735773990855,437.0120344427454,436.8555088603417,439.3170627633658,434.39395495731753,115686,136405.73333333334,45.803430907585714,60.7039770816732,NaN,NaN,NaN,NaN,1.6666155108381242,32.5390401702279,106113732,-0.5784326437079765,1.1466147931631099,1.7250474368710864
2025-09-24T11:50:00-04:00,436.06,436.47,434.96,436,434.4496326720912,NaN,NaN,NaN,NaN,NaN,433.27679999999833,444.2247586702699,422.32884132972674,437.0120344427454,436.8306904889116,439.2680547615179,434.39332621630535,91568,135226.53333333333,45.35780675279048,59.17581831948769,NaN,NaN,NaN,NaN,1.6554286886354046,30.643308090789994,106022164,-0.6772320174325213,0.8785074150804348,1.555739432512956
2025-09-24T11:55:00-04:00,436.04,436.22,434.51,435.1,434.4496326720912,NaN,NaN,NaN,NaN,NaN,433.4899999999983,444.1527756239148,422.8272243760818,437.0120344427454,436.7915927193725,439.2103757422674,434.3728096964776,99554,131899.5,41.77653226564195,57.37165863076622,NaN,NaN,NaN,NaN,1.659326639447164,29.18805108839556,105922610,-0.7752752062720945,0.5866454246728381,1.3619206309449325
2025-09-24T12:00:00-04:00,435.11,435.73,434.65,434.84,434.4496326720912,NaN,NaN,NaN,NaN,NaN,433.69279999999833,444.06077688297347,423.3248231170232,437.0120344427454,436.7628213593295,439.1713803496958,434.3542623689632,67386,123621.7,40.77493222787831,55.727097617422,NaN,NaN,NaN,NaN,1.6179461652009408,27.836741014743588,105855224,-0.82509453324736,0.3305524643857325,1.1556469976330925
2025-09-24T12:05:00-04:00,434.82,435.06,433.5,434,NaN,NaN,NaN,439.29778710934414,439.29778710934414,439.29778710934414,433.8609999999983,443.9672802259755,423.75471977402105,437.0120344427454,436.69684542229544,439.1089396999226,434.2847511446683,105774,114038.4,37.635505712247856,54.08942822358381,NaN,NaN,NaN,NaN,1.6138071534008738,27.342607533803235,105749450,-0.8772101540884314,0.059134305022553235,0.9363444591109846
2025-09-24T12:10:00-04:00,433.99,434.63,433.27,434.35,NaN,NaN,NaN,438.9251604225558,NaN,NaN,434.01739999999825,443.90469998362636,424.13010001637014,437.0120344427454,436.64957114080084,439.0649953023032,434.2341469792985,76084,109814.5,39.71815921638257,52.56763955332108,NaN,NaN,NaN,NaN,1.595678071015098,27.02456002562626,105825534,-0.850090701151044,-0.12626891732782042,0.7238217838232236
2025-09-24T12:15:00-04:00,434.31,436.65,434.01,436.52,NaN,NaN,NaN,438.9251604225558,NaN,NaN,434.2253999999983,443.8740875462969,424.57671245369966,437.0120344427454,436.62881157032336,439.02083318366095,434.2367899569858,96791,108545.13333333333,50.70884897585802,51.56393456606703,NaN,NaN,NaN,NaN,1.6702724945140184,25.133787373881223,105922325,-0.6566442087317322,-0.09698347709144173,0.5596607316402905
2025-09-24T12:20:00-04:00,436.53,437.61,436.38,437.1,NaN,NaN,NaN,438.9251604225558,NaN,NaN,434.4231999999983,443.8923325392519,424.9540674607447,437.0120344427454,436.6360745766109,439.00694849981176,434.26520065341003,79337,101986.93333333333,53.166649406791535,50.961304142747046,NaN,NaN,NaN,NaN,1.6388244591915897,24.009922527339654,106001662,-0.46906139553611714,-0.02666601277985592,0.4423953827562612
2025-09-24T12:25:00-04:00,437.09,437.77,436.39,437.09,NaN,NaN,NaN,438.9251604225558,NaN,NaN,434.6243999999983,443.8817613176813,425.36703868231524,435.8916275541963,436.6434021173045,438.99545993137855,434.29134430323046,72993,97724.36666666667,53.11747130765423,50.43970789724273,NaN,NaN,NaN,NaN,1.6203369978207616,23.068031516725064,105928669,-0.33157055976383953,0.027932183051461834,0.35950274281530137
2025-09-24T12:30:00-04:00,437.13,437.41,436.7,436.9,NaN,NaN,NaN,438.9251604225558,NaN,NaN,434.83119999999826,443.81669821913556,425.84570178086096,434.41730204335704,436.64794144334707,438.9854656337513,434.31041725294284,56907,94313.96666666666,52.130816452145815,49.692807143124426,NaN,NaN,NaN,NaN,1.5553129265478527,22.193418435440094,105871762,-0.2434153649132722,0.055233536673711114,0.2986489015869833
2025-09-24T12:35:00-04:00,436.96,437.57,436.73,437.27,NaN,NaN,NaN,438.9251604225558,NaN,NaN,435.06179999999836,443.68678110408376,426.43681889591295,434.3687734556073,436.65612493178054,438.9768786228707,434.3353712406904,69166,93311.26666666666,53.92563293754334,49.148191068003534,NaN,NaN,NaN,NaN,1.5042191460801473,21.495291616022488,105940928,-0.1545113503934633,0.10550971359515415,0.26002106398861746
2025-09-24T12:40:00-04:00,437.35,437.75,436.78,437.3,NaN,NaN,NaN,438.9251604225558,NaN,NaN,435.2737999999983,443.5814898260658,426.96611017393076,434.70401876448585,436.6612967318891,438.97304767259135,434.3495457911868,38504,89701.8,54.075984552738454,48.74007053477016,NaN,NaN,NaN,NaN,1.466060635645853,20.979811329363923,105979432,-0.091144328636108,0.14609065319348247,0.23723498182959046
2025-09-24T12:45:00-04:00,437.33,438.39,436.85,438.21,NaN,NaN,NaN,438.9251604225558,NaN,NaN,435.4973999999984,443.5018115939824,427.4929884060144,435.1832150115887,436.67595656971474,438.97663159931915,434.37528154011034,59373,87466,58.499861949788304,48.74533199808591,NaN,NaN,NaN,NaN,1.4713420188140038,20.961379214121457,106038805,0.00926207732305534,0.24881257848340965,0.2395505011603543
2025-09-24T12:50:00-04:00,438.19,438.53,437.86,438.27,NaN,NaN,NaN,438.9251604225558,NaN,NaN,435.7095999999984,443.429152277545,427.9900477224518,435.62957200927093,436.6905088479572,438.98517152196655,434.3958461739478,44521,83498.03333333334,58.78179555092951,48.96238772971257,NaN,NaN,NaN,NaN,1.4141033031844292,21.042788973155766,106083326,0.07335445762096043,0.33124357318655484,0.2578891155655944
2025-09-24T12:55:00-04:00,438.23,438.5,437.93,438.25,NaN,NaN,NaN,438.9251604225558,NaN,NaN,435.89679999999834,443.3966031338201,428.39699686617655,435.8946576074168,436.7041418276238,438.9931380430379,434.4151456122097,42298,76692.56666666667,58.63879235500144,49.87919926167083,NaN,NaN,NaN,NaN,1.3538102100998266,21.118383749401907,106041028,0.10605347891865519,0.3904559642139134,0.2844024852952582
2025-09-24T13:00:00-04:00,438.35,438.95,438.22,438.7,434.25876124431176,434.25876124431176,434.25876124431176,NaN,NaN,NaN,436.1113999999983,443.2992185957985,428.9235814041981,436.5007260859334,436.7218452530054,439.0076350842437,434.43605542176715,44374,74326.43333333333,60.94123391724428,50.99230120198896,NaN,NaN,NaN,NaN,1.3092523379498362,21.527490471918327,106085402,0.14711419891994104,0.46829523394518446,0.3211810350252434
2025-09-24T13:05:00-04:00,438.69,439.3,438.23,439.2,434.48949936957024,NaN,NaN,NaN,NaN,NaN,436.3315999999984,443.2028483411567,429.46035165884007,436.80558086874674,436.7525921161033,439.036832009445,434.4683522227616,68558,73113.6,63.38045162146769,52.53543829883366,NaN,NaN,NaN,NaN,1.2921628852391331,22.161018954557708,106153960,0.19411897905692177,0.5638297588463956,0.36971077978947386
2025-09-24T13:10:00-04:00,439.2,440.08,439.07,439.42,435.3561130345898,NaN,NaN,NaN,NaN,NaN,436.5449999999983,443.1174044311127,429.97259556888395,437.5794646949974,436.807852873745,439.10213849077405,434.51356725671593,99290,72653.96666666666,64.43294014740258,54.22529600737111,NaN,NaN,NaN,NaN,1.2720083934363373,23.268055468137025,106253250,0.22407393039641016,0.6498031927849865,0.4257292623885764
2025-09-24T13:15:00-04:00,439.4,439.64,438.69,438.92,435.3561130345898,NaN,NaN,NaN,NaN,NaN,436.73939999999834,442.99884586732406,430.4799541326726,437.5794646949974,436.8272930080934,439.12133625155434,434.5332497646325,42898,71019.66666666667,60.198262565796256,55.83692149691028,NaN,NaN,NaN,NaN,1.2490077939051696,23.785665001963835,106210352,0.1953126635466637,0.669870091821906,0.47455742827524233
2025-09-24T13:20:00-04:00,438.88,439.36,438.18,439.36,435.3561130345898,NaN,NaN,NaN,NaN,NaN,436.94819999999834,442.83583407881275,431.0605659211839,437.5794646949974,436.84611187768945,439.1387628334926,434.5534609218863,44561,69832.4,62.531940689984566,57.46647731645328,NaN,NaN,NaN,NaN,1.2440786657690865,23.615754860864442,106254913,0.190800368712841,0.7130578891662935,0.5222575204534525
2025-09-24T13:25:00-04:00,439.33,439.67,438.91,439.49,435.3561130345898,NaN,NaN,NaN,NaN,NaN,437.1555999999983,442.64254619675785,431.6686538032387,437.5794646949974,436.86462875538274,439.15888792082416,434.5703695899413,37641,68624.36666666667,63.218136423121884,58.3599978484007,NaN,NaN,NaN,NaN,1.2095016182141511,23.70321577215781,106292554,0.18150505329060562,0.7491388370667096,0.567633783776104
2025-09-24T13:30:00-04:00,439.5,440.41,439.5,440.18,435.9687854060518,NaN,NaN,NaN,NaN,NaN,437.38119999999833,442.3994030893615,432.36299691063516,438.00098073907094,436.89917042234237,439.20445362069154,434.5938872239932,56305,67492.53333333334,66.70370147617743,59.32693013907112,NaN,NaN,NaN,NaN,1.1888229311988556,24.32645005177864,106348859,0.2050233140269927,0.8239129263098448,0.6188896122828521
2025-09-24T13:35:00-04:00,440.2,440.39,439.46,439.76,435.99315879668575,NaN,NaN,NaN,NaN,NaN,437.6601999999984,441.48280118843894,433.8375988115578,438.00098073907094,436.9211966672866,439.23201477383526,434.61037856073796,38541,66605.46666666666,62.80247548421503,60.01871615168261,NaN,NaN,NaN,NaN,1.1703355789703664,24.849898848186026,106310318,0.17657072606287239,0.8396030198614426,0.6630322937985702
2025-09-24T13:40:00-04:00,439.72,440.43,439.6,440,436.14869703320005,NaN,NaN,NaN,NaN,NaN,437.7967999999983,441.4522976468617,434.1413023531349,438.1012276730054,436.9530854996292,439.27304946161325,434.63312153764514,54227,66723.4,64.09475282798502,60.87328303567113,NaN,NaN,NaN,NaN,1.1460258947581963,25.366484251995917,106364545,0.15875256637112511,0.8614730017624765,0.7027204353913514
2025-09-24T13:45:00-04:00,440.03,440.06,438.46,438.71,436.14869703320005,NaN,NaN,NaN,NaN,NaN,437.8945999999984,441.37682965439177,434.412370345605,438.1012276730054,436.97105997675806,439.28936183669884,434.65275811681727,44838,66706.66666666667,53.36352627172346,60.833132559541134,NaN,NaN,NaN,NaN,1.178452616561184,24.32707291084115,106319707,0.050531062819360706,0.7658842639155523,0.7153532010961916
2025-09-24T13:50:00-04:00,438.7,440,438.68,439.95,436.14869703320005,NaN,NaN,NaN,NaN,NaN,438.0125999999984,441.3630813036023,434.66211869639443,438.1012276730054,436.9922732539758,439.31268630096974,434.6718602069818,44050,65839.4,60.252484241460934,61.274311108735596,NaN,NaN,NaN,NaN,1.1885631439496704,23.361905236911724,106363757,0.05266316372882396,0.7811821557572216,0.7285189920283976
2025-09-24T13:55:00-04:00,439.93,440.5,439.09,439.37,436.14869703320005,NaN,NaN,NaN,NaN,NaN,438.1099999999984,441.3268481477755,434.89315185222137,438.1012276730054,437.0265982277624,439.35146964406886,434.70172681145596,69799,66553,56.07971275436529,61.101443309062525,NaN,NaN,NaN,NaN,1.2043800622389813,22.94793760863405,106293958,0.007582819606250846,0.7379975165362112,0.7304146969299603
2025-09-24T14:00:00-04:00,439.36,439.42,438.71,438.93,436.14869703320005,NaN,NaN,NaN,NaN,NaN,438.16399999999834,441.34322758008824,434.98477241990844,438.1012276730054,437.04170306606403,439.3641915608662,434.7192145712619,41316,65164.833333333336,53.07666238873975,60.69393379747754,NaN,NaN,NaN,NaN,1.1690672006504852,22.073579045948915,106252642,-0.05580899411991547,0.6606534542800659,0.7164624483999814
2025-09-24T14:05:00-04:00,438.9,439.41,438.67,439.32,436.14869703320005,NaN,NaN,NaN,NaN,NaN,438.20219999999836,441.3901580684063,435.0142419315904,438.1012276730054,437.05857656033135,439.3792332304946,434.7379198901681,44344,63451.13333333333,55.358537460486694,60.45962987644077,NaN,NaN,NaN,NaN,1.1384195434611655,21.209716901565553,106296986,-0.07425911766077986,0.6236385513240066,0.6978976689847864
2025-09-24T14:10:00-04:00,439.27,439.29,437.72,438.86,436.14869703320005,NaN,NaN,NaN,NaN,NaN,438.2729999999984,441.35732748033655,435.1886725196602,438.1012276730054,437.0800059654686,439.39188097418605,434.7681309567512,76325,64100.3,52.13795188517382,59.83082401700717,NaN,NaN,NaN,NaN,1.17138957607108,20.11215953136504,106220661,-0.11764923719009024,0.5508361224971736,0.6684853596872639
2025-09-24T14:15:00-04:00,438.87,439.91,438.74,439.87,436.14869703320005,NaN,NaN,NaN,NaN,NaN,438.3573999999983,441.3803464048031,435.33445359519345,438.1012276730054,437.09950320916994,439.412240993866,434.78676542447386,45141,61748.8,57.92576722438929,59.44120370293014,NaN,NaN,NaN,NaN,1.1712903206374325,18.95244959865768,106265802,-0.08031656905085094,0.5680896483737001,0.6484062174245511
2025-09-24T14:20:00-04:00,439.84,440.51,439.41,439.61,436.17986646717077,NaN,NaN,NaN,NaN,NaN,438.38459999999833,441.4275990742841,435.34160092571256,438.1012276730054,437.14205476514763,439.4616992838693,434.822410246426,88502,61646.6,56.046834903961745,58.84219618554151,NaN,NaN,NaN,NaN,1.1661981548776137,18.47530968570294,106177300,-0.07521083695568243,0.5543926712299481,0.6296035081856305
2025-09-24T14:25:00-04:00,439.55,439.62,439.11,439.28,436.17986646717077,NaN,NaN,NaN,NaN,NaN,438.4111999999983,441.46178064084154,435.36061935915507,438.1012276730054,437.1545859503846,439.4735018142927,434.8356700864765,32773,59420.566666666666,53.66739294208292,58.375705498133414,NaN,NaN,NaN,NaN,1.1193268581006406,17.672008756090317,106144527,-0.09486779070291973,0.5110187698069808,0.6058865605099005
2025-09-24T14:30:00-04:00,439.23,439.85,439.04,439.44,436.17986646717077,NaN,NaN,NaN,NaN,NaN,438.4215999999983,441.48257594996085,435.36062405003577,437.6826472365519,437.17114281686605,439.48978273694865,434.85250289678345,41823,58568.46666666667,54.67219256295595,57.814294917631365,NaN,NaN,NaN,NaN,1.0972320825220236,17.163064826037854,106186350,-0.09752818805075014,0.48397632544646285,0.581504513497213
2025-09-24T14:35:00-04:00,439.39,440.03,439.1,439.97,436.17986646717077,NaN,NaN,NaN,NaN,NaN,438.4119999999982,441.45039694685414,435.3736030531423,437.6826472365519,437.1912658895751,439.5115665012653,434.8709652778849,46374,56588.46666666667,57.927079828896225,57.43636230375811,NaN,NaN,NaN,NaN,1.085286933770447,16.87742408880028,106232724,-0.06556118861933946,0.49955302772303867,0.5651142163423781
2025-09-24T14:40:00-04:00,439.98,440.45,439.92,440.07,436.692251811701,NaN,NaN,NaN,NaN,NaN,438.4343999999982,441.50467858124176,435.3641214187547,438.26515630809166,437.21958492559656,439.5466214178099,434.89254843338324,56383,55931.76666666667,58.53213053976942,56.85267866544324,NaN,NaN,NaN,NaN,1.0456235813582702,17.036981278694537,106289107,-0.04085833889509871,0.5140412927235047,0.5548996316186035
2025-09-24T14:45:00-04:00,440.12,442.57,440.11,442.31,437.6651040020783,NaN,NaN,NaN,NaN,NaN,438.5089999999982,441.76542073549535,435.25257926450104,439.57212504647333,437.39846537935773,439.83978034518213,434.9571504135333,246799,60932.03333333333,69.21268202912819,57.310550561508485,NaN,NaN,NaN,NaN,1.149507611261251,18.752593473189634,106535906,0.11465944330951172,0.6982239357554931,0.5835644924459814
2025-09-24T14:50:00-04:00,442.36,443.34,441.91,443.15,438.9221447292565,NaN,NaN,NaN,NaN,NaN,438.58059999999824,442.0758571531056,435.0853428468909,440.22670003717866,437.5306976887388,440.0823415688935,434.9790538085841,153856,63416,72.11332720985152,57.883305874498944,NaN,NaN,NaN,NaN,1.1695427818854438,20.749575520043336,106689762,0.25441093035311035,0.9015781553873694,0.647167225034259
2025-09-24T14:55:00-04:00,443.17,443.48,442.43,442.57,439.27727451429035,NaN,NaN,NaN,NaN,NaN,438.63799999999827,442.29540673241297,434.9805932675836,440.464360029743,437.59276989990474,440.1926649361553,434.99287486365415,74536,63467.433333333334,67.39199607693769,58.88533943201425,NaN,NaN,NaN,NaN,1.1610040117507698,22.674098393212912,106615226,0.2857534685610462,1.0043590607355668,0.7186055921745206
2025-09-24T15:00:00-04:00,442.64,442.79,441,441.71,439.27727451429035,NaN,NaN,NaN,NaN,NaN,438.69259999999827,442.4489701849389,434.93622981505763,440.464360029743,437.6486579333743,440.2762503683969,435.0210654983517,84932,64401.6,61.01334423512896,58.939686574419106,NaN,NaN,NaN,NaN,1.2059322966257164,22.682311834860762,106530294,0.22898411439937738,1.0048357351737423,0.7758516207743649
2025-09-24T15:05:00-04:00,441.715,442.76,441.69,442.28,439.27727451429035,NaN,NaN,NaN,NaN,NaN,438.7733999999983,442.65893339534165,434.8878666046549,440.464360029743,437.70086006921275,440.35847679650215,435.04324334192336,74058,64564.666666666664,63.480552784348745,59.46831800513222,NaN,NaN,NaN,NaN,1.196222846866736,22.689938602105197,106604352,0.21070123460739,1.0392281640336023,0.8285269294262123
2025-09-24T15:10:00-04:00,442.24,443,442.15,442.6,439.27727451429035,NaN,NaN,NaN,NaN,NaN,438.8573999999983,442.8859755505602,434.82882444943635,440.464360029743,437.75433392549496,440.4457642621086,435.06290358888134,72181,65687.23333333334,64.82631268130527,60.30757874031547,NaN,NaN,NaN,NaN,1.1714926435191135,22.872278004057637,106676533,0.20106470342454252,1.0798578087068904,0.8787931052823479
2025-09-24T15:15:00-04:00,442.55,442.82,442.05,442.68,439.27727451429035,NaN,NaN,NaN,NaN,NaN,438.9159999999983,443.0778419006996,434.754158099297,440.464360029743,437.79942389464867,440.5174954549753,435.08135233432205,62996,65808,65.17185277835567,61.008529834448964,NaN,NaN,NaN,NaN,1.1428145975534612,22.91582390433712,106739529,0.18157819248398843,1.1057658458873334,0.924187653403345
2025-09-24T15:20:00-04:00,442.65,443.65,442.12,443.535,439.27727451429035,NaN,NaN,NaN,NaN,NaN,439.00509999999827,443.3632915935881,434.64690840640844,440.67632309454615,437.87232070416985,440.64135382419386,435.10328758414585,92750,67415.63333333333,68.70978794297848,62.19223241000644,NaN,NaN,NaN,NaN,1.1704706977282118,23.56641405979095,106832279,0.2059842561890538,1.1816679736396623,0.9756837174506084
2025-09-24T15:25:00-04:00,443.55,443.93,442.92,443.5,439.7950559255884,NaN,NaN,NaN,NaN,NaN,439.09849999999824,443.6342267341186,434.56277326587787,441.046058475637,437.96570897889893,440.80319617074616,435.1282217870517,114878,69834.96666666666,68.40346170877612,62.940639158891216,NaN,NaN,NaN,NaN,1.159008505033339,24.359780741072562,106717401,0.1993547285691184,1.2248771281620066,1.0255223995928882
2025-09-24T15:30:00-04:00,443.47,443.85,442.98,443.74,439.83141701987984,NaN,NaN,NaN,NaN,NaN,439.1826999999983,443.90001330806547,434.46538669193114,441.1078467805096,438.0331878640428,440.9183301066677,435.1480456214179,84330,71166.83333333333,69.41054458105515,63.89518985011217,NaN,NaN,NaN,NaN,1.1383650403881007,25.096478373691205,106801731,0.19071571215667893,1.263917039788737,1.073201327632058
2025-09-24T15:35:00-04:00,443.71,444.05,443.35,443.72,440.1838526098853,NaN,NaN,NaN,NaN,NaN,439.27049999999826,444.15593150667917,434.38506849331736,441.50627742440764,438.13706137347987,441.095131437319,435.1789913096407,129534,73199.36666666667,69.21256786980939,65.0055594878069,NaN,NaN,NaN,NaN,1.1070532517889498,25.92650470181561,106672197,0.1642427863366076,1.2785048105528176,1.11426202421621
2025-09-24T15:40:00-04:00,443.74,444.21,442.82,442.85,440.1838526098853,NaN,NaN,NaN,NaN,NaN,439.34749999999826,444.33377085170315,434.3612291482934,441.50627742440764,438.20589074479227,441.20314627858136,435.2086352110032,95720,73080.36666666667,61.05461667197521,65.46144692416543,NaN,NaN,NaN,NaN,1.1272637338040237,25.896977065880826,106576477,0.07336030933806192,1.2059624108887874,1.1326021015507255
2025-09-24T15:45:00-04:00,442.86,443.79,442.24,443.55,440.1838526098853,NaN,NaN,NaN,NaN,NaN,439.4434999999983,444.5631047705227,434.3238952294739,441.50627742440764,438.28926484412244,441.3293696021884,435.24916008605646,121910,75714.1,64.66357766630735,65.94262534112337,NaN,NaN,NaN,NaN,1.1574591813894515,25.07997334172995,106698387,0.046897912311082646,1.191224491939579,1.1443265796284963
2025-09-24T15:50:00-04:00,443.56,444.02,442.56,443.02,440.1838526098853,NaN,NaN,NaN,NaN,NaN,439.5386999999983,444.74305925416587,434.33434074583073,441.50627742440764,438.38165087832846,441.4660487449961,435.2972530116608,139828,78889.66666666667,60.12087792538947,66.0561072972391,NaN,NaN,NaN,NaN,1.1790692398616318,24.542806903056082,106558559,-0.016402640359170828,1.1238232791795326,1.1402259195387034
2025-09-24T15:55:00-04:00,443.07,443.34,442.18,442.87,440.1838526098853,NaN,NaN,NaN,NaN,NaN,439.67389999999824,444.866160121238,434.4816398787585,441.50627742440764,438.4709929655507,441.5866726499509,435.3553132811505,153510,82751.96666666666,58.860563829532985,65.31667028298229,NaN,NaN,NaN,NaN,1.1777071513000845,23.53524766090949,106405049,-0.07518621855684526,1.046243146342647,1.1214293648994922
2025-09-25T09:30:00-04:00,435.16,435.35,426.63,426.66,NaN,NaN,NaN,436.66457669117915,436.66457669117915,436.66457669117915,439.48709999999824,445.755202772498,433.21899722749845,441.50627742440764,429.5466666666667,429.5466666666667,429.5466666666667,523967,98340.7,17.112303214918256,61.38802571191563,NaN,NaN,NaN,NaN,2.2535852119215076,26.847616282609422,105881082,-1.1527974286700167,-0.3195674209380286,0.8332300077319881
2025-09-25T09:35:00-04:00,426.72,428.41,425.6,425.86,NaN,NaN,NaN,432.80482320521645,NaN,NaN,439.3022999999983,446.54582157768357,432.058778422313,441.50627742440764,428.2788158117058,429.727575583205,426.83005604020656,401280,110432,16.49065660213317,57.752215749429595,NaN,NaN,NaN,NaN,2.2933291253556862,30.02943015972529,105479802,-1.8264422422372861,-1.4498227950646196,0.37661944717266654
2025-09-25T09:40:00-04:00,425.87,425.88,423.4,424.78,NaN,NaN,NaN,430.5143766958884,NaN,NaN,439.10109999999827,447.3221391780242,430.88006082197234,441.50627742440764,427.1201022246042,429.1795971768015,425.06060727240686,440569,123310.06666666667,15.663401169789921,54.51293410190538,NaN,NaN,NaN,NaN,2.306662759258853,33.1922264902902,105039233,-2.225281284854357,-2.4049821588952796,-0.17970087404092278
2025-09-25T09:45:00-04:00,424.84,428.64,424.79,427.11,NaN,NaN,NaN,430.5143766958884,NaN,NaN,438.9632999999983,447.7343176402949,430.1922823597017,441.50627742440764,427.0701675855956,428.9351330368672,425.20520213432394,305151,131987.16666666666,24.46690956500653,51.72624530052379,NaN,NaN,NaN,NaN,2.417615419311793,34.622201506198465,105344384,-2.208279492653488,-2.940050239857783,-0.7317707472042949
2025-09-25T09:50:00-04:00,426.96,428.51,425.15,426.1,NaN,NaN,NaN,430.5143766958884,NaN,NaN,438.7982999999983,448.1981088515883,429.39849114840825,441.50627742440764,427.02064339594966,428.79358809792257,425.24769869397676,190686,136875.03333333333,23.330053280502554,48.76222677189503,NaN,NaN,NaN,NaN,2.484928603646666,35.95003544954185,105153698,-2.139645864904002,-3.4063280783342975,-1.2666822134302955
2025-09-25T09:55:00-04:00,426.16,426.88,424.02,425.14,NaN,NaN,NaN,430.5143766958884,NaN,NaN,438.5706999999982,448.70272250523567,428.4386774947608,441.4800219395261,426.8636111883178,428.6205040898054,425.1067182868302,192716,140972.26666666666,22.270807001306963,45.697866359248685,NaN,NaN,NaN,NaN,2.5117194176719053,37.36464861157348,104960982,-2.034180722162982,-3.8094081161340227,-1.775227393971041
2025-09-25T10:00:00-04:00,425.14,428.83,425.11,427.61,NaN,NaN,NaN,430.5143766958884,NaN,NaN,438.38089999999823,448.961623168411,427.8001768315855,440.9228140412967,426.8925446978212,428.5705659455819,425.21452345006054,204410,146408.73333333334,30.956676654699493,43.001215552943044,NaN,NaN,NaN,NaN,2.5980251735524815,37.65766740316967,105165392,-1.6876280601927949,-3.884762469212035,-2.19713440901924
2025-09-25T10:05:00-04:00,427.54,430.27,427.45,429.74,NaN,NaN,NaN,430.5143766958884,NaN,NaN,438.2338999999982,449.08310113035213,427.38469886964424,440.9228140412967,427.15743724434685,428.8936792522777,425.421195236416,299782,154923.33333333334,37.448060123374304,40.79011543970006,NaN,NaN,NaN,NaN,2.6138805182987324,37.24271799092372,105465174,-1.225984834979569,-3.729615452743701,-2.503630617764132
2025-09-25T10:10:00-04:00,429.73,431.09,428.88,429.26,423.2739861102798,423.2739861102798,423.2739861102798,NaN,NaN,NaN,438.0810999999982,449.2126722684057,426.94952773159065,440.28225123303736,427.31206900112414,429.1037786158456,425.5203593864027,162728,157803.43333333332,36.61266255322048,38.44740958056901,NaN,NaN,NaN,NaN,2.5850319098488215,36.48044712701443,105302446,-0.8801750102291965,-3.6038493805506278,-2.7236743703214312
2025-09-25T10:15:00-04:00,429.34,430.56,429.19,429.85,423.282214014358,NaN,NaN,NaN,NaN,NaN,437.93269999999825,449.29893336230646,426.56646663769004,424.7838009864299,427.4059209716216,429.22889396405037,425.5829479791928,103789,159758.36666666667,38.430784299417695,36.24871075411246,NaN,NaN,NaN,NaN,2.498243916288192,35.7726241819558,105406235,-0.554804242085801,-3.4171796729286825,-2.8623754308428815
2025-09-25T10:20:00-04:00,429.92,431.22,429.5,430.47,423.83234065006894,NaN,NaN,NaN,NaN,NaN,437.7960999999982,449.35204864849544,426.24015135150097,424.7761389776023,427.5331401413978,429.41626619100543,425.6500140917901,125511,160992,40.36647211118723,34.7709861426276,NaN,NaN,NaN,NaN,2.4426550651247516,34.78973056081812,105531746,-0.2561217109615255,-3.1825275695447885,-2.926405858583263
2025-09-25T10:25:00-04:00,430.4,430.95,428.18,429.1,423.83234065006894,NaN,NaN,NaN,NaN,NaN,437.6138999999982,449.4225082654455,425.80529173455085,424.7761389776023,427.63442405049557,429.5144862412111,425.75436185978003,168310,165509.9,37.55669047320494,32.834779914548854,NaN,NaN,NaN,NaN,2.466036846187268,34.27807955744897,105363436,-0.11623767940456187,-3.0717029578389656,-2.9554652784344038
2025-09-25T10:30:00-04:00,429.08,430.33,428.64,430.22,423.83234065006894,NaN,NaN,NaN,NaN,NaN,437.4528999999982,449.43950453868626,425.4662954613101,424.7761389776023,427.6910783590106,429.5764398666743,425.80571685134686,86663,167004.56666666668,41.16238533777729,31.480601872576557,NaN,NaN,NaN,NaN,2.4106056428881777,33.80297505432047,105450099,0.0759524890699943,-2.860524667096911,-2.936477156166905
2025-09-25T10:35:00-04:00,430.29,430.29,428.7,429.79,423.83234065006894,NaN,NaN,NaN,NaN,NaN,437.28369999999813,449.4578918519031,425.10950814809314,424.7761389776023,427.73431825401616,429.61956963841374,425.8490668696186,74560,167944.1,40.202560705457515,30.147887363714027,NaN,NaN,NaN,NaN,2.351990954110453,33.36180658712971,105375539,0.1917617146120305,-2.696775012901867,-2.8885367275138973
2025-09-25T10:40:00-04:00,429.6,430.25,429.1,429.1,423.83234065006894,NaN,NaN,NaN,NaN,NaN,437.0916999999982,449.47155680234766,424.7118431976487,425.14967452522586,427.7691360682884,429.6514495701082,425.8868225664686,66624,168285.46666666667,38.64532745833661,31.68596052395819,NaN,NaN,NaN,NaN,2.2661344573882762,32.95215015330973,105308915,0.2365962775705177,-2.59279138055075,-2.829387658121268
2025-09-25T10:45:00-04:00,429.09,429.43,427.85,428.99,423.83234065006894,NaN,NaN,NaN,NaN,NaN,436.8874999999981,449.4568863417076,424.3181136582886,425.14967452522586,427.80568199745255,429.66222117142854,425.94914282347656,128614,164345.96666666667,38.39002988953522,33.25020147305833,NaN,NaN,NaN,NaN,2.217124853289113,33.00597245538062,105180301,0.2710699893926103,-2.490550171380505,-2.7616201607731155
2025-09-25T10:50:00-04:00,429.01,429.07,427.6,427.84,423.83234065006894,NaN,NaN,NaN,NaN,NaN,436.6558999999981,449.45474427466314,423.85705572533305,425.14967452522586,427.8120810287358,429.6528656766804,425.9712963807912,62134,161288.56666666668,35.732358913359036,34.683698454741844,NaN,NaN,NaN,NaN,2.1637587923398884,33.14009619005531,105118167,0.2302543577986249,-2.4738022135248343,-2.7040565713234592
2025-09-25T10:55:00-04:00,427.87,429.58,427.87,429,423.83234065006894,NaN,NaN,NaN,NaN,NaN,436.4574999999981,449.41635400052786,423.49864599946835,425.14967452522586,427.8398360438841,429.6624665135969,426.01720557417127,100512,162154.43333333332,40.227362237491576,35.809445074205065,NaN,NaN,NaN,NaN,2.133490307172754,32.90264771952896,105218679,0.2912824543629058,-2.339953503369827,-2.631235957732733
2025-09-25T11:00:00-04:00,429.01,429.41,427.73,427.835,423.83234065006894,NaN,NaN,NaN,NaN,NaN,436.2269999999981,449.37968854672243,423.07431145327376,425.14967452522586,427.8485685542845,429.65587307124963,426.04126403731937,66681,161546.06666666668,37.398302201636255,36.81431999714318,NaN,NaN,NaN,NaN,2.1010981423747004,32.73723097781357,105151998,0.2639050730199122,-2.301354616457843,-2.565259689477755
2025-09-25T11:05:00-04:00,427.86,428.15,426.15,426.51,423.83234065006894,NaN,NaN,NaN,NaN,NaN,435.96739999999807,449.3623796926723,422.57242030732385,425.14967452522586,427.823931871853,429.612775781353,426.03508796235303,102868,162506.4,34.43236408293774,37.683002645831095,NaN,NaN,NaN,NaN,2.0938768464907933,33.16763068039242,105049130,0.17173969913758302,-2.3505850655557765,-2.5223247646933595
2025-09-25T11:10:00-04:00,426.54,427.82,426.2,427.82,423.83234065006894,NaN,NaN,NaN,NaN,NaN,435.7201999999981,449.2506020578465,422.1897979421497,425.14967452522586,427.8136182968467,429.5869741743338,426.0402624193596,73591,162553.4,39.53781534944887,38.29594112402748,NaN,NaN,NaN,NaN,2.0600285003128795,33.56728754707278,105122721,0.21156604252439104,-2.257867211537871,-2.469433254062262
2025-09-25T11:15:00-04:00,427.83,429.1,427.31,427.41,423.83234065006894,NaN,NaN,NaN,NaN,NaN,435.4731999999981,449.1497090226696,421.7966909773266,425.14967452522586,427.8163894450528,429.5702931938048,426.06248569630077,87009,163353.83333333334,38.526693280001105,38.37298634950082,NaN,NaN,NaN,NaN,2.0407407502905324,32.95079374897226,105035712,0.2217858908880732,-2.1922008904521704,-2.4139867813402436
2025-09-25T11:20:00-04:00,427.43,427.93,426.83,427,423.83234065006894,NaN,NaN,NaN,NaN,NaN,435.2131999999981,449.0291601565416,421.3972398434546,425.14967452522586,427.80724632911506,429.548306556334,426.0661861018961,65500,162445.5,37.494078611815155,38.43594463940044,NaN,NaN,NaN,NaN,1.9735449824126388,32.585741405065384,104970212,0.21240772549765685,-2.1484771244681724,-2.3608848499658293
2025-09-25T11:25:00-04:00,427,427.07,425.95,426.83,423.83234065006894,NaN,NaN,NaN,NaN,NaN,434.9755999999981,448.9505409503996,421.0006590495966,425.14967452522586,427.78005548584076,429.5102851354552,426.0498258362263,94275,161758.73333333334,37.05065159232673,38.33736373175109,NaN,NaN,NaN,NaN,1.9125774836688794,32.61248631056539,104875937,0.20606964283338236,-2.1032977964241013,-2.3093674392574837
2025-09-25T11:30:00-04:00,426.87,427.95,426.79,427.4,423.83234065006894,NaN,NaN,NaN,NaN,NaN,434.724599999998,448.78371004890994,420.6654899510861,425.00503335691565,427.7713527639044,429.48365422052404,426.0590513072848,91795,162007.56666666668,39.62875433890943,38.28466960515982,NaN,NaN,NaN,NaN,1.8588219491211,31.963130873024188,104967732,0.2487246747175602,-1.9984615958605332,-2.2471862705780934
2025-09-25T11:35:00-04:00,427.43,428.14,426.75,428.015,423.83234065006894,NaN,NaN,NaN,NaN,NaN,434.497499999998,448.6158354899692,420.37916451002684,425.00503335691565,427.76895799753873,429.46625075881104,426.0716652362664,75436,160204.3,42.371172700845214,38.62856119284841,NaN,NaN,NaN,NaN,1.8253346670410207,31.216890046347455,105043168,0.3221564954171834,-1.8444906513066144,-2.1666471467237978
2025-09-25T11:40:00-04:00,428,429.36,428,428.79,423.83234065006894,NaN,NaN,NaN,NaN,NaN,434.294699999998,448.4438047648729,420.1455952351231,425.77050431708943,427.7899727717811,429.4741334538869,426.1058120896753,97402,160260.36666666667,45.717545477161856,38.953929774233025,NaN,NaN,NaN,NaN,1.7920964765380916,29.647731571899094,105140570,0.4205057601116615,-1.641014946584221,-2.0615207066958825
2025-09-25T11:45:00-04:00,428.74,429.23,428.1,429.17,423.83234065006894,NaN,NaN,NaN,NaN,NaN,434.091699999998,448.2378317131997,419.94556828679634,425.79340345367154,427.80452345970497,429.48136893541476,426.12767798399517,62125,158267.53333333333,47.332440544642495,39.46320690560338,NaN,NaN,NaN,NaN,1.7448038710710847,28.190655845625617,105202695,0.5031507701064091,-1.4325822440628713,-1.9357330141692803
2025-09-25T11:50:00-04:00,429.14,429.32,428.17,428.96,423.83234065006894,NaN,NaN,NaN,NaN,NaN,433.89369999999803,448.044461083674,419.7429389163221,425.99572276293725,427.81591174753027,429.486710989027,426.1451125060335,50693,155296.36666666667,46.50898143059051,40.024896475050085,NaN,NaN,NaN,NaN,1.7023178802802914,26.77083577275891,105152002,0.5328210654745422,-1.2697066823261025,-1.8025277478006447
2025-09-25T11:55:00-04:00,428.97,429.47,428.7,429.43,423.89615242517766,NaN,NaN,NaN,NaN,NaN,433.68489999999804,447.7847697145447,419.58503028545135,426.4255782103498,427.83211488173606,429.4997641256827,426.1644656377894,53368,151958.3,48.66170292878721,40.75858740642523,NaN,NaN,NaN,NaN,1.635723745974559,25.335322866940007,105205370,0.5699140745036906,-1.0901351546710316,-1.6600492291747222
2025-09-25T12:00:00-04:00,429.41,430.16,428.82,429.2,424.35428186039684,NaN,NaN,NaN,NaN,NaN,433.476699999998,447.5278045276588,419.4255954723372,427.05446256827986,427.86222421012366,429.527613008499,426.19683541174834,89648,137481,47.65106805330642,41.609923773564326,NaN,NaN,NaN,NaN,1.614600621262093,23.580468647227807,105115722,0.5637437056971559,-0.9553695970532772,-1.519113302750433
2025-09-25T12:05:00-04:00,429.1,429.45,428.6,428.9,424.35428186039684,NaN,NaN,NaN,NaN,NaN,433.269099999998,447.2777608484644,419.26043915153156,427.05446256827986,427.87465829349725,429.5349427390752,426.2143738479193,52133,125842.76666666666,46.30033594944741,42.04370761013261,NaN,NaN,NaN,NaN,1.5599862911719409,22.009700489206487,105063589,0.5250280283368678,-0.8628282673293484,-1.3878562956662162
2025-09-25T12:10:00-04:00,428.85,429.45,428.43,429.1,424.35428186039684,NaN,NaN,NaN,NaN,NaN,433.06229999999806,447.005600357049,419.11899964294713,427.05446256827986,427.88320320612047,429.53999973979444,426.2264066724465,36181,112363.16666666667,47.37139125430232,42.756071113894464,NaN,NaN,NaN,NaN,1.5214158418025152,20.685346262208352,105099770,0.4986553086943375,-0.7645371597982944,-1.263192468492632
2025-09-25T12:15:00-04:00,429.11,429.47,428.76,429.23,424.35428186039684,NaN,NaN,NaN,NaN,NaN,432.84749999999804,446.6890564517469,419.00594354824915,427.05446256827986,427.89102429666366,429.5456978699337,426.2363507233936,29348,103169.73333333334,48.09605862264786,43.732049295302325,NaN,NaN,NaN,NaN,1.4634575673880525,19.43775307042051,105129118,0.4757976445856218,-0.6684454127606045,-1.1442430573462263
2025-09-25T12:20:00-04:00,429.2,429.76,428.24,428.78,424.35428186039684,NaN,NaN,NaN,NaN,NaN,432.62169999999804,446.35251011619346,418.89088988380263,427.05446256827986,427.9026527057108,429.55162513499283,426.2536802764288,54122,98617.6,45.74782597741842,44.17562148301444,NaN,NaN,NaN,NaN,1.467496312574619,18.71682766207103,105074996,0.4182427016203829,-0.6214396803207478,-1.0396823819411307
2025-09-25T12:25:00-04:00,428.84,429.09,428.33,428.67,424.35428186039684,NaN,NaN,NaN,NaN,NaN,432.348899999998,445.83881064341045,418.8589893565856,427.05446256827986,427.9081573410774,429.5527241049482,426.2635905772066,33650,93315.4,45.16730137296644,44.64995063251197,NaN,NaN,NaN,NaN,1.4169608616764313,18.047396925746515,105041346,0.36270204766042047,-0.5863048223656051,-0.9490068700260256
2025-09-25T12:30:00-04:00,428.82,429.38,428.78,429.11,424.5189535601203,NaN,NaN,NaN,NaN,NaN,432.068099999998,445.22744768775004,418.908752312246,427.05446256827986,427.9171224104116,429.55864565598296,426.27559916484023,37101,87738.43333333333,48.00927919255349,45.401036388278996,NaN,NaN,NaN,NaN,1.3664636572709703,17.11861272240598,105078447,0.34560848764889474,-0.5169962604649072,-0.862604748113802
2025-09-25T12:35:00-04:00,429.11,429.5,428.69,428.95,424.6308193073876,NaN,NaN,NaN,NaN,NaN,431.795699999998,444.63416704428334,418.9572329557127,427.1034655963993,427.923872127041,429.5627971524698,426.28494710161226,29402,78725.76666666666,47.05421710583927,46.115576782101314,NaN,NaN,NaN,NaN,1.3267162531801868,16.12693645109678,105049045,0.31443058399839197,-0.46956651811581196,-0.7839971021142039
2025-09-25T12:40:00-04:00,428.81,428.87,427.5,427.92,424.6308193073876,NaN,NaN,NaN,NaN,NaN,431.5198999999981,444.0841425146541,418.95565748534204,427.1034655963993,427.9263663724325,429.5535501955672,426.29918254929777,72064,75703.63333333333,41.351294767317896,46.23861538413049,NaN,NaN,NaN,NaN,1.3355222350958869,16.279936838119998,104976981,0.2198212654174806,-0.5092205203423532,-0.7290417857598338
2025-09-25T12:45:00-04:00,427.94,428.51,427.79,428.19,424.6308193073876,NaN,NaN,NaN,NaN,NaN,431.2380999999981,443.4515034391216,419.0246965608746,427.1034655963993,427.9278166283106,429.5501188385685,426.3055144180527,30742,73268.73333333334,43.29154586138162,46.30435632416881,NaN,NaN,NaN,NaN,1.2915563611604644,16.422008626070127,105007723,0.17287588747714233,-0.5129469264134059,-0.6858228138905482
2025-09-25T12:50:00-04:00,428.19,429.1,428.19,428.86,424.6308193073876,NaN,NaN,NaN,NaN,NaN,430.96329999999807,442.75270924927935,419.1738907507168,427.1034655963993,427.93331212133353,429.55128449431083,426.3153397483562,35239,70259.66666666667,47.897833096860666,46.46009115414729,NaN,NaN,NaN,NaN,1.26430233536329,15.861134864183482,105042962,0.18339934482184683,-0.4565736328632397,-0.6399729776850865
2025-09-25T12:55:00-04:00,428.95,429.42,428.77,428.84,424.9202880810739,NaN,NaN,NaN,NaN,NaN,430.68649999999803,442.0029431252557,419.3700568747404,427.14777950828517,427.9415693435881,429.5560601132639,426.32707857391233,39093,65952.43333333333,47.7730871653143,46.4915659127667,NaN,NaN,NaN,NaN,1.2204235971230575,14.985831138683059,105003869,0.18493930550480087,-0.40879884580408543,-0.5937381513088863
2025-09-25T13:00:00-04:00,428.83,429.35,428.25,428.36,424.9202880810739,NaN,NaN,NaN,NaN,NaN,430.38299999999805,441.1030619404465,419.6629380595496,427.14777950828517,427.9481128845408,429.55660028310473,426.3396254859769,47298,64640.26666666667,44.760098598005015,46.36664571043917,NaN,NaN,NaN,NaN,1.2118219116142692,14.683037389432203,104956571,0.1509902177929482,-0.40500037906770103,-0.5559905968606492
2025-09-25T13:05:00-04:00,428.32,429.14,428.23,429.1,424.9202880810739,NaN,NaN,NaN,NaN,NaN,430.0949999999981,440.1426456947283,420.0473543052679,427.14777950828517,427.9540971127371,429.5586978397802,426.34949638569395,35419,63335.566666666666,49.996028695424144,46.46195469377039,NaN,NaN,NaN,NaN,1.1902632036418193,14.421371078940878,104991990,0.17409036196947614,-0.338377644398804,-0.5124680063682802
2025-09-25T13:10:00-04:00,429.08,429.69,428.7,428.94,425.1739587639768,NaN,NaN,NaN,NaN,NaN,429.79899999999805,439.0627227941586,420.5352772058375,427.315623108242,427.96365590167835,429.5650331844722,426.3622786188845,43195,62554.6,48.916414690897504,46.55233659645546,NaN,NaN,NaN,NaN,1.1759586890959757,13.51974568930759,104948795,0.17390422715174048,-0.2950877224286046,-0.46899194958034507
2025-09-25T13:15:00-04:00,428.9,429.28,427.85,428.8,425.1739587639768,NaN,NaN,NaN,NaN,NaN,429.50059999999803,437.86939265887486,421.1318073411212,427.315623108242,427.96921826497504,429.56520454015515,426.37323198979493,43100,59704.13333333333,47.94090416951637,46.66952004074609,NaN,NaN,NaN,NaN,1.1941044970176882,13.534405716249085,104905695,0.1600124516507912,-0.26897638501685606,-0.42898883666764726
2025-09-25T13:20:00-04:00,428.85,428.9,425.93,426.28,425.1739587639768,NaN,NaN,NaN,NaN,NaN,429.169199999998,436.663908096198,421.674491903798,427.315623108242,427.9502233745274,429.5353550539239,426.3650916951309,109502,61283.066666666666,34.57503609018174,45.75549467188034,NaN,NaN,NaN,NaN,1.320954175802137,14.953418831879409,104796193,-0.013992264711721936,-0.44647916755729966,-0.4324869028455777
2025-09-25T13:25:00-04:00,426.34,427.18,426.27,426.97,425.1739587639768,NaN,NaN,NaN,NaN,NaN,428.8375999999981,435.12831863677206,422.5468813632241,427.315623108242,427.94125470288515,429.52337734958945,426.35913205618084,42496,59349.2,39.54503355828751,45.14470716728317,NaN,NaN,NaN,NaN,1.291600306101986,16.271073867821855,104838689,-0.07434446368594438,-0.5254174824530082,-0.45107301876706385
2025-09-25T13:30:00-04:00,426.91,427.6,426.11,426.32,425.1739587639768,NaN,NaN,NaN,NaN,NaN,428.503599999998,433.3556865786807,423.6515134213153,427.315623108242,427.92537552579654,429.50382712929866,426.3469239222944,68904,59423.3,36.71552284789221,44.4995426580313,NaN,NaN,NaN,NaN,1.3057717128089876,16.973460440341594,104769785,-0.14564392802346732,-0.633127928796398,-0.4874840007729307
2025-09-25T13:35:00-04:00,426.41,426.57,424.85,426.08,NaN,NaN,NaN,429.9522497537821,429.9522497537821,429.9522497537821,428.167799999998,430.82300783501324,425.5125921649828,427.315623108242,427.86391757619657,429.4586313135359,426.26920383885727,166082,61530.433333333334,35.69981700182241,43.82329377437816,NaN,NaN,NaN,NaN,1.3353594476083435,18.41829296344591,104603703,-0.19357009633155808,-0.7294466211873782,-0.5358765248558202
2025-09-25T13:40:00-04:00,426.14,426.23,424.01,424.53,NaN,NaN,NaN,429.47214749224656,NaN,NaN,428.1251999999981,430.9393925745827,425.31100742541344,427.315623108242,427.8247347076411,429.44427492842186,426.2051944868603,76349,61622.36666666667,29.939260465188937,42.53257815099497,NaN,NaN,NaN,NaN,1.3985480584934638,20.196463461151268,104527354,-0.30749392076387705,-0.9202439258106665,-0.6127500050467894
2025-09-25T13:45:00-04:00,424.62,424.73,422.37,422.52,NaN,NaN,NaN,428.0261407880535,NaN,NaN,428.0583999999981,431.22143679506496,424.8953632049312,427.315623108242,427.6796160420559,429.4655601479895,425.8936719361223,185896,64918.6,24.433335852262644,40.91680091859664,NaN,NaN,NaN,NaN,1.467223197172503,22.53541397122208,104341458,-0.48546700685192434,-1.2195837636116948,-0.7341167567597705
2025-09-25T13:50:00-04:00,422.45,423.89,422.34,422.9,NaN,NaN,NaN,427.5990434795056,NaN,NaN,428.02079999999813,431.37759034893094,424.6640096510653,427.315623108242,427.6018432879185,429.47016321657435,425.7335233592626,100928,66099.53333333334,27.160603457137185,39.90318011072659,NaN,NaN,NaN,NaN,1.4731358259458962,24.718506911209744,104442386,-0.5406245920133566,-1.4098974967764661,-0.8692729047631096
2025-09-25T13:55:00-04:00,422.97,423.22,421.2,421.88,NaN,NaN,NaN,426.76567786680084,NaN,NaN,427.91619999999807,431.68112579569413,424.151274204302,427.315623108242,427.4669270855455,429.49894770748705,425.4349064636039,151249,67998.66666666667,24.594700111968464,38.567691128625654,NaN,NaN,NaN,NaN,1.5121975526640494,27.147985547637127,104291137,-0.604024885310285,-1.624304011400966,-1.020279126090681
2025-09-25T14:00:00-04:00,421.88,422.21,419.14,419.33,NaN,NaN,NaN,425.4422379637644,NaN,NaN,427.78079999999807,432.22324003302094,423.3383599669752,426.6654984865936,427.1510535546693,429.628188234739,424.6739188745996,281364,74317.63333333333,19.60758240206775,36.54695893614044,NaN,NaN,NaN,NaN,1.6234691560451882,29.96233114610912,104009773,-0.765532330985869,-1.9771945398230173,-1.2116622088371483
2025-09-25T14:05:00-04:00,419.29,422,419.1,421.94,NaN,NaN,NaN,425.4422379637644,NaN,NaN,427.71679999999805,432.39549416043377,423.0381058395623,425.3233987892749,427.02578524443635,429.6265791056307,424.424991383242,134369,76282.06666666667,34.29350952914788,35.58413196212856,NaN,NaN,NaN,NaN,1.7146499306133873,32.58507955698874,104144142,-0.649021003607543,-2.022938463346577,-1.373917459739034
2025-09-25T14:10:00-04:00,421.95,423.31,421.79,422.49,NaN,NaN,NaN,425.4422379637644,NaN,NaN,427.61439999999806,432.51673399176997,422.71206600822615,424.2019752251359,426.9463020137577,429.5912149146877,424.3013891128277,118490,76985,36.90904287436003,35.02334226758249,NaN,NaN,NaN,NaN,1.7007463641410012,33.566093133385266,104262632,-0.4943457490184522,-1.9918496460120991,-1.497503896993647
2025-09-25T14:15:00-04:00,422.53,423.75,422.49,423.67,NaN,NaN,NaN,425.4422379637644,NaN,NaN,427.492999999998,432.4786931320676,422.50730686792843,424.2019752251359,426.89109256553536,429.5533517921357,424.22883333893503,103134,78351.96666666666,42.22292081279703,34.468120275966264,NaN,NaN,NaN,NaN,1.669264480988072,34.03476538840779,104365766,-0.2825265744830534,-1.8506621150974638,-1.5681355406144104
2025-09-25T14:20:00-04:00,423.67,424.01,423.03,423.67,NaN,NaN,NaN,425.4422379637644,NaN,NaN,427.38119999999805,432.4533378379383,422.3090621620578,422.99158018010877,426.86021977229797,429.52917389097166,424.19126565362427,63855,78790.7,42.22292081279703,33.99001357038766,NaN,NaN,NaN,NaN,1.6200313037746397,34.20749491939454,104365766,-0.12065551722309609,-1.7189549371432804,-1.5982994199201843
2025-09-25T14:25:00-04:00,423.63,424.4,423.6,424.04,NaN,NaN,NaN,425.4422379637644,NaN,NaN,427.26499999999805,432.3716685820568,422.1583314179393,422.257264144087,426.81972241021816,429.4909837721533,424.148461048283,99124,80315.9,43.93998584873072,33.70423369033154,NaN,NaN,NaN,NaN,1.5614576392193051,33.971799071437935,104464890,0.02531101342597397,-1.566660653137717,-1.591971666563691
2025-09-25T14:30:00-04:00,423.98,424.54,423.09,423.24,NaN,NaN,NaN,425.4422379637644,NaN,NaN,427.12039999999814,432.2651755409175,421.9756244590788,420.7432350005402,426.7746770232162,429.45367519047596,424.09567885595646,99604,80647.76666666666,41.09614558161396,34.17002722543384,NaN,NaN,NaN,NaN,1.5534963792750724,34.020090450772464,104365286,0.07893273259626055,-1.4933057508183651,-1.5722384834146257
2025-09-25T14:35:00-04:00,423.2,424.255,423,423.97,NaN,NaN,NaN,425.4422379637644,NaN,NaN,427.0177999999981,432.2050058612401,421.83059413875606,420.7432350005402,426.7509301782728,429.43277644306875,424.0690839134769,55774,80769.13333333333,44.61845809804674,34.5324146925595,NaN,NaN,NaN,NaN,1.5321752093268528,34.1124660222231,104421060,0.1693246958003125,-1.360582613664235,-1.5299073094645474
2025-09-25T14:40:00-04:00,424.04,426.17,424.01,425.78,420.3763697810658,420.3763697810658,420.3763697810658,NaN,NaN,NaN,426.92899999999804,432.04542531529313,421.81257468470295,422.1380704003457,426.72162313565013,429.3835905510732,424.05965572022706,148950,84528.1,52.24372446741079,35.64157195109654,NaN,NaN,NaN,NaN,1.5798769800892196,32.36967432546331,104570010,0.34656219122040244,-1.0967045704390443,-1.4432667616594468
2025-09-25T14:45:00-04:00,425.71,425.94,424.79,425.5,420.7088075182901,NaN,NaN,NaN,NaN,NaN,426.8431999999981,431.90846396615535,421.77793603384083,422.13945632027657,426.70919791167097,429.361571532027,424.0568242913149,69553,85868.26666666666,51.072233440223876,36.73960169669664,NaN,NaN,NaN,NaN,1.5491714815114166,30.751367749900638,104500457,0.4347728986599029,-0.8998006383345682,-1.3345735369944711
2025-09-25T14:50:00-04:00,425.57,426.59,425.45,426.41,421.4199980856405,NaN,NaN,NaN,NaN,NaN,426.78939999999807,431.8146246285099,421.76417537148626,422.97956505622125,426.7046294242207,429.3466258274677,424.0626330209737,60477,86080.1,54.632767676264415,38.503423640344884,NaN,NaN,NaN,NaN,1.519944947117743,28.705469465268063,104560934,0.537511273644897,-0.6626844449383498,-1.2001957185832468
2025-09-25T14:55:00-04:00,426.52,427.02,425.99,426.39,421.9736345362932,NaN,NaN,NaN,NaN,NaN,426.7373999999981,431.72412407166473,421.7506759283315,423.616652044977,426.7010741342263,429.323418754503,424.0787295139496,112276,88700.96666666666,54.538830201845386,40.65381609388651,NaN,NaN,NaN,NaN,1.4849488794664738,26.847659355917525,104448658,0.5833940695454669,-0.47095313165141306,-1.05434720119688
2025-09-25T15:00:00-04:00,426.32,426.42,425.47,426.07,421.9736345362932,NaN,NaN,NaN,NaN,NaN,426.70199999999807,431.68203815316855,421.7219618468276,423.616652044977,426.69540665510823,429.3080976948865,424.08271561532996,60093,89467.36666666667,52.96949338785024,42.497308231794584,NaN,NaN,NaN,NaN,1.4467382452188677,25.160970591573538,104388565,0.5707606657344432,-0.34089636902882603,-0.9116570347632692
2025-09-25T15:05:00-04:00,426.03,426.21,424.62,425.07,421.9736345362932,NaN,NaN,NaN,NaN,NaN,426.6233999999981,431.5798783633981,421.66692163659815,423.616652044977,426.6803657683654,429.28292955465395,424.07780198207683,82539,91238.6,48.292912531533915,44.19003769033497,NaN,NaN,NaN,NaN,1.4569712277032327,24.232526738400058,104306026,0.4774158150885367,-0.3148872659025983,-0.792303080991135
2025-09-25T15:10:00-04:00,425.09,426.08,424.8,425.74,421.9736345362932,NaN,NaN,NaN,NaN,NaN,426.58149999999813,431.53171706661703,421.6312829333792,423.616652044977,426.66932572223607,429.2616668265753,424.0769846178968,74858,91331.73333333334,51.389559327488485,46.46017889929359,NaN,NaN,NaN,NaN,1.4443304257244285,23.370400303310397,104380884,0.44386325588470954,-0.23747401113524802,-0.6813372670199576
2025-09-25T15:15:00-04:00,425.73,426.03,424.55,424.84,421.9736345362932,NaN,NaN,NaN,NaN,NaN,426.54809999999816,431.52227365666926,421.57392634332706,423.616652044977,426.6526929179045,429.2357732697147,424.06961256609435,85021,93141.03333333334,47.29237839734755,47.38866953273642,NaN,NaN,NaN,NaN,1.4468782524583952,22.76130200710397,104295863,0.3483408408457779,-0.24591121596273524,-0.5942520568085131
2025-09-25T15:20:00-04:00,424.84,425.1,424.5,424.95,421.9736345362932,NaN,NaN,NaN,NaN,NaN,426.4906999999982,431.4710734846429,421.5103265153535,423.616652044977,426.6405925045011,429.2191936320013,424.06199137700094,52828,93727.33333333333,47.83975313040422,48.16943455102529,NaN,NaN,NaN,NaN,1.3863869487113687,22.23542635364103,104348691,0.28264626478213484,-0.24094422583084452,-0.5235904906129794
2025-09-25T15:25:00-04:00,424.93,425.92,424.9,425.74,421.9736345362932,NaN,NaN,NaN,NaN,NaN,426.45729999999816,431.4349633922701,421.4796366077262,423.616652044977,426.6331133357649,429.20471406307723,424.0615126084526,52881,94186.93333333333,51.717836481377084,48.84764281306673,NaN,NaN,NaN,NaN,1.360216452374845,20.894851297943966,104401572,0.28184282194445504,-0.17128696318241055,-0.4531297851268656
2025-09-25T15:30:00-04:00,425.81,426.55,425.63,426.04,421.9736345362932,NaN,NaN,NaN,NaN,NaN,426.43809999999814,431.4146477558972,421.4615522440991,423.7502182029428,426.62100962528893,429.1659592068918,424.0760600436861,175101,98447.03333333334,53.14257372814441,49.62761802130582,NaN,NaN,NaN,NaN,1.3287724200623572,19.737112717397093,104576673,0.28984096999102194,-0.09082857263808819,-0.3806695426291101
2025-09-25T15:35:00-04:00,426.03,426.28,424.68,424.92,421.9736345362932,NaN,NaN,NaN,NaN,NaN,426.3998999999982,431.3931228036084,421.406677196388,423.7502182029428,426.604876290748,429.13849526609613,424.07125731539986,99616,100586.93333333333,47.50643182422999,49.88236416241291,NaN,NaN,NaN,NaN,1.3481458186293291,18.840950770868115,104477057,0.2116548197312137,-0.11610101796509298,-0.3277558376963067
2025-09-25T15:40:00-04:00,424.97,425.2,424.44,424.99,421.9736345362932,NaN,NaN,NaN,NaN,NaN,426.3516999999982,431.3518990407069,421.35150095928947,423.7502182029428,426.59095088921055,429.11906738033895,424.06283439808215,66592,101366.83333333333,47.87849865324569,50.36681795324375,NaN,NaN,NaN,NaN,1.306135403012948,18.207300763988158,104543649,0.15900928394893715,-0.12899423276013522,-0.28800351670907237
2025-09-25T15:45:00-04:00,424.99,425.15,423.7,424.12,421.9736345362932,NaN,NaN,NaN,NaN,NaN,426.2737999999982,431.2892591262097,421.25834087378666,423.7502182029428,426.55879385340216,429.08319929899267,424.03438840781166,118883,103892.93333333333,43.72991904788294,50.30335087823205,NaN,NaN,NaN,NaN,1.3164114456548794,18.20047518302001,104424766,0.0647808581845799,-0.2070274439783475,-0.2718083021629274
2025-09-25T15:50:00-04:00,424.07,425.16,422.88,423.41,421.9736345362932,NaN,NaN,NaN,NaN,NaN,426.1661999999982,431.1919463372841,421.1404536627123,423.7502182029428,426.51706768177206,429.04458224266295,423.98955312088117,129537,104560.76666666666,40.63543931127129,49.47418765279351,NaN,NaN,NaN,NaN,1.3852391995366757,18.763893466007893,104295229,-0.04050813011126325,-0.3224434648020065,-0.2819353346907432
2025-09-25T15:55:00-04:00,423.42,424.09,422.92,423.38,421.9736345362932,NaN,NaN,NaN,NaN,NaN,426.0503999999982,431.06075880617647,421.04004119381995,423.7502182029428,426.45665730048336,428.994920645788,423.9183939551787,171803,108871,40.505012963072524,48.71938619013985,NaN,NaN,NaN,NaN,1.3698649709983388,19.287067585925215,104123426,-0.1037219043563597,-0.41158771513619286,-0.30786581077983316